CommittedName,ID,UiTextureAtlasID,Width,Height,CommittedLeft,CommittedRight,CommittedTop,CommittedBottom,UiTextureAtlasElementID,OverrideWidth,OverrideHeight,CommittedFlags,UiCanvasID
MainPet-PetFamilyFrame,2009,88,34,34,881,915,987,1021,3517,0,0,0,0
Timer-Frame,2010,88,339,17,521,860,671,688,3518,0,0,0,0
MainPet-HealthBarBG,2011,88,155,47,743,898,767,814,3519,0,0,0,0
Timer-BG,2012,88,473,27,521,994,644,671,3520,0,0,0,0
BackupPet-DeadFrame,2014,88,47,47,943,990,853,900,3521,0,0,0,0
MainPet-HealthBarFrame,2015,88,155,47,217,372,880,927,3522,0,0,0,0
Start-VersusSplash,2016,88,217,212,0,217,644,856,3523,0,0,0,0
BackupPet-Frame,2017,88,47,47,950,997,970,1017,3524,0,0,0,0
BattleHUD-Top,2019,88,574,118,0,574,395,513,3525,0,0,0,0
BattleBar-ButtonBG-EndCap,2021,88,24,78,27,51,856,934,3526,0,0,0,0
BattleBar-SwapPetFrame-DeadIcon,2022,88,33,33,915,948,987,1020,3527,0,0,0,0
MainPet-HealthBarFill,2023,88,145,37,406,551,913,950,3528,0,0,0,0
BattleBar-EndCap,2024,88,127,125,551,678,853,978,3529,0,0,0,0
BattleBar-Button-Highlight,2026,88,93,93,788,881,918,1011,3530,0,0,0,0
BattleBar-SwapPetFrame,2029,88,192,86,551,743,767,853,3531,0,0,0,0
Timer-Fill,2030,88,339,17,521,860,688,705,3532,0,0,0,0
BattleBar-SwapPetIcon,2031,88,44,42,724,768,962,1004,3533,0,0,0,0
MainPet-Frame,2034,88,110,109,678,788,853,962,3534,0,0,0,0
BattleBar-Countdown-Shadow,2035,88,53,52,950,1003,918,970,3535,0,0,0,0
BattleBar-ButtonBG-Divider,2036,88,27,81,0,27,856,937,3536,0,0,0,0
BattleBar-SwapPetShadow,2037,88,145,146,406,551,767,913,3537,0,0,0,0
BattleBar-SwapPetFrame-Highlight,2038,88,169,42,217,386,927,969,3538,0,0,0,0
MainPet-PetFamilyActivate,2040,88,46,46,678,724,962,1008,3539,0,0,0,0
MainPet-LevelBubble,2041,88,24,24,997,1021,970,994,3540,0,0,0,0
BattleHUD-Versus,2042,88,155,65,788,943,853,918,3541,0,0,0,0
_BattleBar-ButtonBGMid,2043,88,256,78,0,256,124,202,3547,0,0,4,0
_BattleBar-Mid,2044,88,256,124,0,256,0,124,3548,0,0,4,0
backarrow-brown,2102,103,9,17,1144,1153,870,887,3549,0,0,0,0
mapcornershadow-left,2105,103,182,30,960,1142,870,900,3552,0,0,0,0
mapcornershadow-right,2106,103,46,53,868,914,962,1015,3553,0,0,0,0
noquestsbackground,2107,103,287,510,1,288,1,511,3554,0,0,0,0
optionsicon-brown,2108,103,16,16,1127,1143,902,918,3555,0,0,0,0
questcollapse-hide-down,2109,103,32,32,916,948,962,994,3556,0,0,0,0
questcollapse-hide-up,2110,103,32,32,1012,1044,956,988,3557,0,0,0,0
questcollapse-show-down,2111,103,32,32,1012,1044,990,1022,3558,0,0,0,0
questcollapse-show-up,2112,103,32,32,1046,1078,956,988,3559,0,0,0,0
questdetails-rewardsbottomoverlay,2113,103,287,46,868,1155,744,790,3560,0,0,0,0
questdetails-rewardsoverlay,2114,103,287,275,868,1155,467,742,3561,0,0,0,0
questdetails-topoverlay,2115,103,287,51,579,866,933,984,3562,0,0,0,0
questdetailsbackgrounds,2116,103,287,464,290,577,1,465,3563,0,0,0,0
questionmarkcontinent-icon,2117,103,20,27,841,861,986,1013,3564,0,0,0,0
questionmarkcontinent-iconhighlight,2118,103,20,27,1130,1150,792,819,3565,0,0,0,0
questlogbackground,2119,103,287,510,1,288,513,1023,3566,0,0,0,0
storyheader-bg,2120,103,608,138,1157,1765,281,419,3567,0,0,0,2
storyheader-cheevoicon,2121,103,50,43,960,1010,956,999,3568,0,0,0,0
storyheader-shadow,2122,103,252,9,1767,2019,21,30,3569,0,0,0,0
taskpoi-icon,2123,103,19,19,1064,1083,902,921,3570,0,0,0,0
taskpoi-iconhighlight,2124,103,19,19,1085,1104,902,921,3571,0,0,0,0
taskpoi-iconselect,2125,103,19,19,1106,1125,902,921,3572,0,0,0,0
ui-outerborderbuttonpatch,2126,103,18,22,940,958,996,1018,3573,0,0,0,0
ui-squarebuttonbrown-down,2127,103,32,32,1046,1078,990,1022,3574,0,0,0,0
ui-squarebuttonbrown-up,2128,103,32,32,1080,1112,956,988,3575,0,0,0,0
questitemborder-small,2130,103,134,20,960,1094,934,954,3576,0,0,0,0
questitemborder,2131,103,102,30,960,1062,902,932,3577,0,0,0,0
Talent-Separator,2158,110,68,50,1,69,258,308,3662,0,0,0,0
Talent-BottomLeftCurlies,2159,110,65,55,134,199,944,999,3663,0,0,0,0
Talent-Highlight,2160,110,200,53,1,201,466,519,3664,0,0,0,0
Talent-TopRightCurlies,2161,110,64,55,1,65,201,256,3665,0,0,0,0
Talent-TopLeftCurlies,2162,110,63,55,138,201,310,365,3666,0,0,0,0
Talent-Background,2164,110,32,43,0,32,19,62,3668,0,0,4,0
Talent-Selection,2165,110,190,45,1,191,104,149,3669,0,0,0,0
Talent-RingWithDot,2166,110,121,120,134,255,822,942,3670,0,0,0,0
Talent-BottomRightCurlies,2167,110,65,55,71,136,310,365,3671,0,0,0,0
PetJournal-BattleSlot-Active,2168,111,404,106,1,405,174,280,3550,0,0,0,0
PetJournal-BattleSlot-Locked,2169,111,404,106,1,405,282,388,3551,0,0,0,0
PetJournal-PetCard-BG,2170,111,408,171,1,409,1,172,3578,0,0,0,0
PetJournal-BattleSlotFrame-Corner,2172,112,17,17,238,255,98,115,3579,0,0,0,0
PetJournal-ExpBar-Left,2173,112,11,11,238,249,130,141,3580,0,0,0,0
PetJournal-BattleSlotTitle-Right,2175,112,40,40,1,41,330,370,3581,0,0,0,0
PetJournal-ExpBar-Background,2176,112,11,11,238,249,117,128,3582,0,0,0,0
PetJournal-PetBattleAchievementGlow,2177,112,235,49,1,236,98,147,3583,0,0,0,0
PetJournal-HealthBar-Left,2179,112,11,7,167,178,214,221,3584,0,0,0,0
PetJournal-PetCard-Abilities,2180,112,57,105,1,58,223,328,3585,0,0,0,0
PetJournal-BattleSlot-AbilityBorder,2182,112,33,33,1,34,372,405,3586,0,0,0,0
PetJournal-ExpBar-Divider,2183,112,7,7,238,245,149,156,3587,0,0,0,0
PetJournal-ExpBar-Right,2184,112,11,11,154,165,205,216,3588,0,0,0,0
PetJournal-BattleSlot-IconBorder,2185,112,53,54,141,194,149,203,3589,0,0,0,0
PetJournal-LevelBubble,2187,112,21,21,36,57,372,393,3591,0,0,0,0
PetJournal-ExpBar-Mid,2188,112,11,11,141,152,205,216,3592,0,0,0,0
PetJournal-PetBattleAchievementBG,2189,112,50,22,196,246,191,213,3593,0,0,0,0
PetJournal-BattleSlot-Shadow,2191,112,138,72,1,139,149,221,3595,0,0,0,0
PetJournal-BattleSlotTitle-Left,2192,112,40,40,196,236,149,189,3596,0,0,0,0
PetJournal-HealthBar-Mid,2193,112,11,7,180,191,205,212,3597,0,0,0,0
PetJournal-HealthBar-Right,2194,112,11,7,180,191,214,221,3598,0,0,0,0
PetJournal-HealthBar-Background,2195,112,11,7,167,178,205,212,3599,0,0,0,0
_BattleSlotTitle-BG,2198,112,64,24,0,64,43,67,3602,0,0,4,0
_BattleSlotFrame-Top,2199,112,64,16,0,64,69,85,3603,0,0,4,0
_BattleSlotFrame-Divider,2200,112,64,9,0,64,87,96,3604,0,0,4,0
_BattleSlotTitle-Mid,2201,112,64,40,0,64,1,41,3605,0,0,4,0
MountJournalIcons-Alliance,2233,114,46,44,1,47,1,45,3542,0,0,0,0
MountJournalIcons-Horde,2234,114,46,44,49,95,1,45,3543,0,0,0,0
_Talent-blue-glow,2240,110,16,16,0,16,1,17,3628,0,0,4,0
_Talent-Bottom-Tile,2241,110,64,5,0,64,79,84,3629,0,0,4,0
_Talent-Top-Tile,2242,110,64,13,0,64,64,77,3630,0,0,4,0
bluemenu-Ring,2245,116,102,103,1,103,1,104,3667,0,0,0,0
petlist-buttonbackground,2246,117,209,46,1,210,193,239,3673,0,0,0,0
petlist-buttonhighlight,2247,117,209,46,212,421,193,239,3674,0,0,0,0
petlist-buttonselect,2248,117,209,46,1,210,241,287,3675,0,0,0,0
PetJournal-FavoritesIcon,2249,118,25,25,1,26,1,26,3672,0,0,0,0
NewCharacter-Alliance,2257,120,112,58,1,113,1,59,3631,0,0,0,0
NewCharacter-Horde,2258,120,112,58,1,113,61,119,3632,0,0,0,0
Garr_InfoBox-Corner,2266,121,128,128,1,129,277,405,3609,0,0,0,0
Garr_InfoBoxBorder-BigBottomCorner,2267,121,44,46,187,231,277,323,3610,0,0,0,0
Garr_InfoBoxBorder-Corner,2268,121,30,30,90,120,407,437,3611,0,0,0,0
Garr_InfoBoxBorder-FiligreeCorner,2269,121,87,101,1,88,407,508,3612,0,0,0,0
Garr_WoodFrameCorner,2304,121,54,54,131,185,277,331,3641,0,0,0,0
_Garr_InfoBox-Top,2307,121,256,135,0,256,1,136,3643,0,0,4,0
_Garr_InfoBoxBorder-BigBottom,2308,121,256,34,0,256,138,172,3644,0,0,4,0
_Garr_InfoBoxBorder-Top,2309,121,256,18,0,256,257,275,3645,0,0,4,0
_Garr_WoodFrameTile-Bottom,2310,121,256,28,0,256,174,202,3646,0,0,4,0
_Garr_WoodFrameTile-Top,2311,121,256,28,0,256,204,232,3647,0,0,4,0
_Garr_XPBar_Mid,2312,121,32,21,0,32,234,255,3648,0,0,4,0
!Garr_InfoBox-Left,2316,122,135,256,1,136,0,256,3590,0,0,2,0
!Garr_InfoBoxBorder-Left,2317,122,18,256,168,186,0,256,3594,0,0,2,0
!Garr_WoodFrameTile-Left,2318,122,28,256,138,166,0,256,3600,0,0,2,0
Garr_BuildingIconRing_,2319,123,36,37,93,129,349,386,3601,0,0,0,0
Garr_BuildingPlacementExplosion,2320,123,97,63,1,98,443,506,3606,0,0,0,0
Garr_CostBar,2321,123,175,44,341,516,126,170,3607,0,0,0,0
Garr_FollowerPortrait_Bg,2322,123,58,58,351,409,453,511,3608,0,0,0,0
Garr_FollowerPortrait_Ring,2323,123,58,58,476,534,232,290,3613,0,0,0,0
Garr_FollowerPortrait_TimerBG,2324,123,45,45,961,1006,1,46,3614,0,0,0,0
Garr_FollowerPortrait_TimerFill,2325,123,45,45,961,1006,48,93,3615,0,0,0,0
Garr_LevelBadge_1,2326,123,58,49,531,589,173,222,3616,0,0,0,0
Garr_LevelBadge_2,2327,123,58,49,591,649,173,222,3617,0,0,0,0
Garr_LevelBadge_3,2328,123,58,49,651,709,173,222,3618,0,0,0,0
Garr_LevelUpgradeArrow,2329,123,33,39,93,126,388,427,3619,0,0,0,0
Garr_LevelUpgradeLocked,2330,123,33,39,814,847,126,165,3620,0,0,0,0
Garr_ListButton-Highlight,2331,123,208,45,751,959,48,93,3621,0,0,0,0
Garr_ListButton-Selection,2332,123,208,45,131,339,126,171,3622,0,0,0,0
Garr_ListButton,2333,123,208,45,751,959,1,46,3623,0,0,0,0
Garr_ListTab-Highlight,2334,123,77,36,608,685,126,162,3624,0,0,0,0
Garr_ListTab-Select,2335,123,91,50,384,475,173,223,3625,0,0,0,0
Garr_ListTab,2336,123,91,50,291,382,173,223,3626,0,0,0,0
Garr_MaterialIcon,2337,123,12,11,606,618,63,74,3627,0,0,0,0
Garr_MonumentLocked,2338,123,58,58,476,534,292,350,3651,0,0,0,0
Garr_MonumentOpen,2339,123,58,58,476,534,352,410,3652,0,0,0,0
Garr_PlanIcon-List,2340,123,38,38,566,604,63,101,3653,0,0,0,0
Garr_PlansRequiredIcon,2341,123,90,92,1,91,349,441,3654,0,0,0,0
Garr_Plot_Glow_3,2342,123,108,70,131,239,376,446,3655,0,0,0,0
Garr_Plot_Glow_2,2343,123,108,70,131,239,304,374,3656,0,0,0,0
Garr_Plot_Glow_1,2344,123,108,70,131,239,232,302,3657,0,0,0,0
Garr_Plot_Glow_4,2345,123,108,70,241,349,232,302,3658,0,0,0,0
Garr_Specialization_FrameLeft,2346,123,52,57,477,529,173,230,3659,0,0,0,0
Garr_Specialization_FrameMid,2347,123,43,57,919,962,173,230,3660,0,0,0,0
Garr_Specialization_IconBorder,2348,123,45,45,767,812,126,171,3661,0,0,0,0
Garr_Specialization_IconSelected,2349,123,49,49,964,1013,173,222,3633,0,0,0,0
Garr_TownHallBanner_Left,2351,123,36,33,849,885,126,159,3634,0,0,0,0
Garr_TownHallBanner_LevelFiligree,2352,123,88,38,518,606,126,164,3635,0,0,0,0
Garr_TownHallBanner_Mid,2353,123,78,34,687,765,126,160,3636,0,0,0,0
Garr_TownHallBanner_Right,2354,123,36,33,887,923,126,159,3637,0,0,0,0
Garr_TreasureIcon,2355,123,66,63,351,417,306,369,3638,0,0,0,0
Garr_XPBar_Left,2356,123,32,21,635,667,92,113,3639,0,0,0,0
Garr_XPBar_Nub,2357,123,11,11,620,631,63,74,3640,0,0,0,0
Garr_Map_Shadowmoon1_A,2369,125,672,468,1,673,1,469,3642,0,0,0,0
Garr_Map_Shadowmoon2_A,2370,126,672,468,1,673,1,469,3649,0,0,0,0
Garr_Map_Shadowmoon3_A,2371,127,672,468,1,673,1,469,3650,0,0,0,0
Garr_Plot_Shadowmoon_A_4,2372,128,108,70,111,219,73,143,3676,0,0,0,0
Garr_Plot_Shadowmoon_A_1,2373,128,108,70,1,109,1,71,3677,0,0,0,0
Garr_Plot_Shadowmoon_A_2,2374,128,108,70,111,219,1,71,3678,0,0,0,0
Garr_Plot_Shadowmoon_A_3,2375,128,108,70,1,109,73,143,3679,0,0,0,0
Garr_InfoBox-BackgroundTile,2376,129,256,256,0,256,0,256,3544,0,0,6,0
Garr_WoodFrame-BackgroundTile,2378,130,256,256,0,256,0,256,3545,0,0,6,0
Garr_InfoBox-CornerShadow,2379,121,8,8,90,98,439,447,3546,0,0,0,0
GarrBuilding_Default_Info,2382,124,250,162,1,251,165,327,3705,0,0,0,0
GarrBuilding_Default_Map,2383,124,108,80,269,377,1,81,3706,0,0,0,0
GarrBuilding_EmptyPlot_1_A_Info,2384,124,266,162,1,267,1,163,3707,0,0,0,0
GarrBuilding_Armory_1_A_Info,2398,134,250,162,1,251,1,163,3714,0,0,0,0
GarrBuilding_Armory_2_A_Info,2399,135,250,162,1,251,1,163,3715,0,0,0,0
GarrBuilding_Armory_3_A_Info,2400,136,250,162,1,251,1,163,3716,0,0,0,0
GarrBuilding_Armory_1_A_Map,2404,140,108,83,1,109,1,84,3680,0,0,0,0
GarrBuilding_Armory_2_A_Map,2405,141,108,86,1,109,1,87,3681,0,0,0,0
GarrBuilding_Armory_3_A_Map,2406,142,108,103,1,109,1,104,3682,0,0,0,0
GarrBuilding_Alchemy_1_A_Info,2407,143,250,162,1,251,1,163,3683,0,0,0,0
GarrBuilding_Alchemy_2_A_Info,2408,144,250,162,1,251,1,163,3684,0,0,0,0
GarrBuilding_Alchemy_3_A_Info,2409,145,250,162,1,251,1,163,3685,0,0,0,0
GarrBuilding_Alchemy_1_A_Map,2410,146,108,81,1,109,1,82,3686,0,0,0,0
GarrBuilding_Alchemy_2_A_Map,2411,147,108,82,1,109,1,83,3687,0,0,0,0
GarrBuilding_Alchemy_3_A_Map,2412,148,108,91,1,109,1,92,3688,0,0,0,0
DruidEclipse-LunarCover,2413,149,60,35,1,61,76,111,3701,0,0,0,0
DruidEclipse-SolarCover,2414,149,74,32,112,186,40,72,3702,0,0,0,0
DruidEclipse-Arrow,2415,149,24,24,188,212,40,64,3689,0,0,0,0
DruidEclipse-BaseBar,2416,149,140,37,1,141,1,38,3690,0,0,0,0
DruidEclipse-BaseMoon,2417,149,23,23,214,237,40,63,3691,0,0,0,0
DruidEclipse-BaseSun,2418,149,23,23,152,175,76,99,3692,0,0,0,0
DruidEclipse-Diamond,2419,149,24,22,202,226,76,98,3693,0,0,0,0
DruidEclipse-Line,2420,149,12,22,239,251,40,62,3694,0,0,0,0
DruidEclipse-LunarBar,2421,149,110,37,143,253,1,38,3695,0,0,0,0
DruidEclipse-LunarMoon,2422,149,42,45,108,150,76,121,3696,0,0,0,0
DruidEclipse-LunarSun,2423,149,23,23,152,175,101,124,3697,0,0,0,0
DruidEclipse-SolarBar,2424,149,109,34,1,110,40,74,3698,0,0,0,0
DruidEclipse-SolarMoon,2425,149,23,23,177,200,76,99,3699,0,0,0,0
DruidEclipse-SolarSun,2426,149,43,45,63,106,76,121,3700,0,0,0,0
Garr_BuildIcon,2427,123,46,46,241,287,463,509,3717,0,0,0,0
Garr_BuildingConfirmation,2428,123,271,123,1,272,1,124,3718,0,0,0,0
Garr_BuildingIconTimerBG,2429,123,34,34,925,959,126,160,3719,0,0,0,0
Garr_BuildingIconTimerFill,2430,123,34,34,961,995,126,160,3720,0,0,0,0
Garr_BuildingTimerBG,2431,123,50,50,711,761,173,223,3721,0,0,0,0
Garr_BuildingTimerFill,2432,123,50,50,763,813,173,223,3722,0,0,0,0
Garr_BuildingTimerGlow,2433,123,72,72,241,313,389,461,3723,0,0,0,0
Garr_BuildingUpgradeExplosion,2434,123,97,63,131,228,448,511,3724,0,0,0,0
Garr_LevelBadgeGlow,2435,123,96,91,1,97,256,347,3725,0,0,0,0
Garr_NotificationGlow,2437,123,359,60,274,633,1,61,3726,0,0,0,0
Garr_UpgradeBanner,2439,123,114,89,635,749,1,90,3728,0,0,0,0
Garr_UpgradeIcon,2440,123,46,46,425,471,314,360,3729,0,0,0,0
Garr_UpgradeIconTimerBG,2441,123,34,34,311,345,304,338,3730,0,0,0,0
Garr_UpgradeIconTimerFill,2442,123,34,34,311,345,340,374,3731,0,0,0,0
Garr_UpgradeTimerBG,2443,123,50,50,815,865,173,223,3732,0,0,0,0
Garr_UpgradeTimerFill,2444,123,50,50,867,917,173,223,3733,0,0,0,0
Garr_UpgradeTimerGlow,2445,123,72,72,351,423,232,304,3734,0,0,0,0
Garr_Toast,2446,150,317,82,1,318,85,167,3735,0,0,0,0
Garr_BuildingShadowOverlay,2447,123,128,128,1,129,126,254,3727,0,0,0,0
GarrMission_Bg-DarkEdgeCorner,2454,152,46,256,269,315,642,898,3778,0,0,0,0
GarrMission_CounterCheck,2469,152,25,22,505,530,289,311,3793,0,0,0,0
GarrMission_EncounterAbilityBorder,2470,152,32,32,691,723,435,467,3794,0,0,0,0
GarrMission_EncounterBar-BG,2471,152,32,13,646,678,289,302,3795,0,0,0,0
GarrMission_EncounterBar-End,2472,152,17,17,714,731,289,306,3796,0,0,0,0
GarrMission_EncounterBar-Fill,2473,152,32,13,680,712,289,302,3797,0,0,0,0
GarrMission_EncounterBar-PortraitRing,2474,152,64,61,892,956,811,872,3798,0,0,0,0
GarrMission_EncounterBar-Spark,2475,152,27,27,845,872,435,462,3799,0,0,0,0
GarrMission_EncounterBar-Xbg,2476,152,93,96,433,526,920,1016,3800,0,0,0,0
GarrMission_EncounterBar-Xleft,2477,152,93,96,655,748,774,870,3801,0,0,0,0
GarrMission_FollowerAbilityRollout,2479,152,243,75,1,244,885,960,3802,0,0,0,0
GarrMission_FollowerPartyBox_Lg,2484,152,232,72,433,665,628,700,3807,0,0,0,0
GarrMission_FollowerPartyBox_Sm,2485,152,169,72,433,602,774,846,3808,0,0,0,0
GarrMission_ItemFrame,2487,152,109,41,914,1023,702,743,3810,0,0,0,0
GarrMission_LevelUpBanner,2488,152,140,70,433,573,848,918,3811,0,0,0,0
GarrMission_LocationCover-Side,2491,152,49,230,365,414,642,872,3814,0,0,0,0
GarrMission_ParchmentHeader-End,2498,152,65,41,948,1013,941,982,3820,0,0,0,0
GarrMission_PartyBuffsBG,2499,152,256,33,505,761,254,287,3821,0,0,0,0
GarrMission_PortraitRing,2501,152,59,62,958,1017,811,873,3823,0,0,0,0
GarrMission_PortraitRing_Empty,2502,152,59,62,826,885,941,1003,3824,0,0,0,0
GarrMission_PortraitRing_Enemy,2503,152,53,53,967,1020,395,448,3825,0,0,0,0
GarrMission_PortraitRing_LevelBorder,2504,152,58,24,861,919,287,311,3826,0,0,0,0
GarrMission_RareGlowBG,2505,152,128,35,826,954,774,809,3827,0,0,0,0
GarrMission_RewardsBanner-Desaturate,2507,152,233,70,433,666,702,772,3829,0,0,0,0
GarrMission_RewardsBanner,2508,152,233,70,667,900,628,698,3830,0,0,0,0
GarrMission_RewardsBG-Desaturate,2509,152,502,154,505,1007,1,155,3831,0,0,0,0
GarrMission_RewardsBG,2510,152,502,154,1,503,1,155,3832,0,0,0,0
GarrMission_RewardsBorder-Corner-Desaturate,2511,152,64,64,750,814,930,994,3833,0,0,0,0
GarrMission_RewardsBorder-Corner,2512,152,64,64,365,429,940,1004,3834,0,0,0,0
GarrMission_Silhouettes-1Alliance,2517,152,266,284,1,267,313,597,3835,0,0,0,0
GarrMission_Silhouettes-1Horde,2518,152,266,284,1,267,599,883,3836,0,0,0,0
GarrMission_SingleModelBG,2521,152,162,170,269,431,470,640,3839,0,0,0,0
GarrMission_StartMissionFrame,2522,152,215,39,1,216,962,1001,3840,0,0,0,0
_GarrMission_Bg-BottomEdge,2532,153,256,251,0,256,1,252,3934,0,0,4,0
_GarrMission_Bg-BottomEdgeSmall,2533,153,256,42,0,256,507,549,3935,0,0,4,0
_GarrMission_LocationCover-Bottom,2534,153,256,38,0,256,638,676,3936,0,0,4,0
_GarrMission_ParchmentHeader-Mid,2539,153,128,41,0,128,595,636,3941,0,0,4,0
_GarrMission_RewardsBorder-Top-Desaturate,2540,153,64,25,0,64,780,805,3942,0,0,4,0
_GarrMission_RewardsBorder-Top,2541,153,64,25,0,64,753,778,3943,0,0,4,0
_GarrMission_TopBorder-Highlight,2542,153,32,10,0,32,866,876,3944,0,0,4,0
_GarrMission_TopBorder-Select,2543,153,32,10,0,32,878,888,3945,0,0,4,0
_GarrMission_TopBorder,2544,153,32,10,0,32,854,864,3946,0,0,4,0
_GarrMission_XPBar-BG,2545,153,32,6,0,32,902,908,3947,0,0,4,0
_GarrMission_XPBar-Fill,2546,153,32,6,0,32,910,916,3948,0,0,4,0
_Garr_InfoBoxBorderMission-Top,2547,153,256,18,0,256,834,852,3949,0,0,4,0
!GarrMission_Bg-Edge,2549,154,46,256,138,184,0,256,3851,0,0,2,0
!GarrMission_RewardsBorder-Left-Desaturate,2550,154,30,64,266,296,0,64,3852,0,0,2,0
!GarrMission_RewardsBorder-Left,2551,154,30,64,234,264,0,64,3853,0,0,2,0
!Garr_InfoBoxBorderMission-Left,2553,154,18,256,330,348,0,256,3855,0,0,2,0
Garr_InfoBoxMission-BackgroundTile,2554,155,256,256,0,256,0,256,3856,0,0,6,0
GarrMission_FollowerListButton,2566,156,232,56,218,450,806,862,3849,0,0,0,0
GarrMission_FollowerListButton-Highlight,2567,156,232,56,235,467,469,525,3859,0,0,0,0
GarrMission_FollowerListButton-Select,2568,156,232,56,1,233,469,525,3860,0,0,0,0
GarrMission_FollowerPageHeaderBG,2569,156,32,77,290,322,200,277,3861,0,0,0,0
GarrMission_IconLevelBG,2570,156,120,65,81,201,943,1008,3862,0,0,0,0
GarrMission_ListGlow-Highlight,2571,156,400,50,81,481,754,804,3863,0,0,0,0
GarrMission_ListGlow-Select,2572,156,400,50,81,481,702,752,3864,0,0,0,0
GarrMission_PlayerLootFrame,2576,156,49,49,345,394,382,431,3865,0,0,0,0
GarrMission_RareOverlay,2577,156,128,35,319,447,527,562,3866,0,0,0,0
GarrMission_TopBorderCorner,2578,156,26,33,476,502,200,233,3867,0,0,0,0
GarrMission_TopBorderCorner-Highlight,2579,156,26,33,481,507,326,359,3868,0,0,0,0
GarrMission_TopBorderCorner-Select,2580,156,26,33,345,371,433,466,3869,0,0,0,0
GarrMission_UsefulAbilityIcon,2581,156,34,37,267,301,282,319,3870,0,0,0,0
GarrMission_XPBarBig-End,2582,156,15,15,486,501,282,297,3871,0,0,0,0
GarrMission_XPBarBig-LevelBorder,2583,156,28,15,258,286,232,247,3872,0,0,0,0
GarrMission_XPBarBig-Mid,2584,156,16,15,373,389,433,448,3873,0,0,0,0
Garr_InfoBoxBorderMission-Corner,2585,156,30,30,258,288,200,230,3874,0,0,0,0
PartySizeIcon,2586,156,52,42,1,53,282,324,3875,0,0,0,0
GarrMission_CurrencyIcon-Material,2588,157,57,57,1,58,1,58,3876,0,0,0,0
GarrMission_CurrencyIcon-Salvage,2589,157,57,57,60,117,1,58,3877,0,0,0,0
GarrMission_CurrencyIcon-Xp,2590,157,57,57,1,58,60,117,3878,0,0,0,0
_GarrMissionLocation-TannanJungle-Back,2591,158,1024,285,0,1024,1,286,3937,0,0,4,0
_GarrMissionLocation-TannanJungle-Fore,2592,158,1024,285,0,1024,288,573,3938,0,0,4,0
_GarrMissionLocation-TannanJungle-Mid,2593,158,1024,285,0,1024,575,860,3939,0,0,4,0
GarrMission_MissionParchment,2594,159,256,256,0,256,0,256,3879,0,0,6,0
GarrBuilding_MageTower_1_A_Info,2599,160,250,162,1,251,1,163,3884,0,0,0,0
GarrBuilding_MageTower_2_A_Info,2600,161,250,162,1,251,1,163,3885,0,0,0,0
GarrBuilding_MageTower_3_A_Info,2601,162,250,162,1,251,1,163,3886,0,0,0,0
GarrBuilding_TownHall_1_A_Info,2602,163,250,162,1,251,1,163,3887,0,0,0,0
GarrBuilding_TownHall_2_A_Info,2603,164,250,162,1,251,1,163,3880,0,0,0,0
GarrBuilding_TownHall_3_A_Info,2604,165,250,162,1,251,1,163,3881,0,0,0,0
GarrBuilding_TownHall_3_A_Map,2605,166,108,141,1,109,1,142,3882,0,0,0,0
GarrBuilding_TownHall_2_A_Map,2606,167,108,110,1,109,1,111,3883,0,0,0,0
GarrBuilding_TownHall_1_A_Map,2607,168,108,101,1,109,1,102,3888,0,0,0,0
GarrBuilding_MageTower_1_A_Map,2608,169,108,82,1,109,1,83,3889,0,0,0,0
GarrBuilding_MageTower_2_A_Map,2609,170,108,113,1,109,1,114,3890,0,0,0,0
GarrBuilding_MageTower_3_A_Map,2610,171,108,146,1,109,1,147,3891,0,0,0,0
GarrBuilding_Inn_1_A_Info,2612,172,250,162,1,251,1,163,3892,0,0,0,0
GarrBuilding_Inn_1_A_Map,2613,173,108,71,1,109,1,72,3893,0,0,0,0
GarrBuilding_Inn_2_A_Info,2614,174,250,162,1,251,1,163,3894,0,0,0,0
GarrBuilding_Inn_3_A_Info,2615,175,250,162,1,251,1,163,3895,0,0,0,0
GarrBuilding_Inn_2_A_Map,2616,176,108,79,1,109,1,80,3896,0,0,0,0
GarrBuilding_Inn_3_A_Map,2617,177,108,84,1,109,1,85,3897,0,0,0,0
GarrBuilding_Mine_1_A_Info,2618,178,250,162,1,251,1,163,3898,0,0,0,0
GarrBuilding_Mine_2_A_Info,2619,179,250,162,1,251,1,163,3899,0,0,0,0
GarrBuilding_Mine_3_A_Info,2620,180,250,162,1,251,1,163,3900,0,0,0,0
GarrBuilding_Mine_1_A_Map,2621,181,108,78,1,109,1,79,3901,0,0,0,0
GarrBuilding_Mine_2_A_Map,2622,182,108,77,1,109,1,78,3902,0,0,0,0
GarrBuilding_Mine_3_A_Map,2623,183,108,77,1,109,1,78,3903,0,0,0,0
GarrBuilding_Barracks_1_A_Map,2624,184,108,70,1,109,1,71,3904,0,0,0,0
GarrBuilding_Barracks_2_A_Map,2625,185,108,83,1,109,1,84,3905,0,0,0,0
GarrBuilding_Barracks_3_A_Map,2626,186,108,86,1,109,1,87,3906,0,0,0,0
GarrBuilding_Barracks_1_A_Info,2627,187,250,162,1,251,1,163,3907,0,0,0,0
GarrBuilding_Barracks_2_A_Info,2628,188,250,162,1,251,1,163,3908,0,0,0,0
GarrBuilding_Barracks_3_A_Info,2629,189,250,162,1,251,1,163,3909,0,0,0,0
GarrBuilding_Engineering_1_A_Info,2630,190,250,162,1,251,1,163,3910,0,0,0,0
GarrBuilding_Engineering_2_A_Info,2631,191,250,162,1,251,1,163,3911,0,0,0,0
GarrBuilding_Engineering_3_A_Info,2632,192,250,162,1,251,1,163,3912,0,0,0,0
GarrBuilding_Engineering_1_A_Map,2633,193,108,76,1,109,1,77,3913,0,0,0,0
GarrBuilding_Engineering_2_A_Map,2634,194,108,75,1,109,1,76,3914,0,0,0,0
GarrBuilding_Engineering_3_A_Map,2635,195,108,81,1,109,1,82,3915,0,0,0,0
Rewards-Shadow,2644,197,154,16,301,455,216,232,3916,0,0,0,0
OBJFX_LineBurst,2645,197,86,20,84,170,269,289,3917,0,0,0,0
OBJBonusBar-Top,2646,197,230,23,1,231,244,267,3918,0,0,0,0
OBJFX_LineGlow,2647,197,230,22,233,463,244,266,3919,0,0,0,0
Objective-Header,2648,197,297,86,1,298,1,87,3920,0,0,0,0
Rewards-Top,2649,197,167,22,342,509,177,199,3921,0,0,0,0
OBJFX_StarBurst,2650,197,64,64,366,430,1,65,3922,0,0,0,0
Objective-Nub,2651,197,11,10,432,443,19,29,3923,0,0,0,0
OBJFX_Glow,2652,197,64,64,300,364,1,65,3924,0,0,0,0
shadoworbs-small-Orb-Bg,2653,198,28,28,1,29,143,171,3736,0,0,0,0
shadoworbs-small-Orb,2654,198,25,25,1,26,173,198,3737,0,0,0,0
shadoworbs-small-Frame-OrbHighlight,2655,198,52,29,162,214,57,86,3738,0,0,0,0
shadoworbs-large-Orb,2656,198,38,37,216,254,57,94,3739,0,0,0,0
shadoworbs-large-Frame,2657,198,159,54,1,160,1,55,3740,0,0,0,0
shadoworbs-large-Orb-Bg,2658,198,38,37,1,39,104,141,3741,0,0,0,0
shadoworbs-large-Frame-OrbHighlight,2659,198,74,44,162,236,1,45,3742,0,0,0,0
shadoworbs-small-Frame,2660,198,159,45,1,160,57,102,3743,0,0,0,0
achievementcompare-GreenCheckmark,2661,199,9,11,1,10,1,12,3744,0,0,0,0
achievementcompare-YellowCheckmark,2662,199,9,11,12,21,1,12,3745,0,0,0,0
MonkUI-background-shadow,2663,200,136,43,1,137,1,44,3746,0,0,0,0
MonkUI-OrbOff,2664,200,21,21,139,160,1,22,3747,0,0,0,0
MonkUI-OrbOff-small,2665,200,18,18,139,157,24,42,3748,0,0,0,0
MonkUI-LightOrb-small,2666,200,18,18,162,180,24,42,3749,0,0,0,0
MonkUI-background,2667,200,136,43,1,137,46,89,3750,0,0,0,0
MonkUI-LightOrb,2668,200,21,21,162,183,1,22,3751,0,0,0,0
Garr_InfoBoxMission-Corner,2669,156,135,135,81,216,806,941,3940,0,0,0,0
_Garr_InfoBoxMission-Top,2670,156,256,135,0,256,44,179,3950,0,0,4,0
!Garr_InfoBoxMission-Left,2671,154,135,256,1,136,0,256,3951,0,0,2,0
bags-newitem,2673,202,44,44,209,253,202,246,3752,0,0,0,0
Tracker-Check,2675,197,16,16,300,316,67,83,3782,0,0,0,0
_GarrMission_MissionListTopHighlight,2676,156,256,17,0,256,181,198,3925,0,0,4,0
GarrMission_PartyBuffAbilityBorder,2677,152,32,32,725,757,435,467,3926,0,0,0,0
collections-icon-favorites,2679,203,31,33,93,124,7,40,3952,0,0,0,0
collections-itemborder-collected,2680,203,56,56,126,182,7,63,3953,0,0,0,0
collections-itemborder-uncollected-innerglow,2681,203,42,41,184,226,7,48,3954,0,0,0,0
collections-itemborder-uncollected,2682,203,100,100,154,254,102,202,3955,0,0,0,0
collections-levelplate-black,2683,203,32,21,184,216,50,71,3956,0,0,0,0
collections-levelplate-gold,2684,203,32,21,228,260,7,28,3957,0,0,0,0
collections-newglow,2685,203,59,37,262,321,7,44,3958,0,0,0,0
collections-slotheader,2686,203,490,24,1,491,76,100,3959,0,0,0,0
collections-background-filagree,2694,203,151,109,1,152,102,211,3930,0,0,0,0
collections-background-corner,2696,203,90,67,1,91,7,74,3931,0,0,0,0
collections-background-tile,2702,204,256,256,0,256,0,256,3929,0,0,6,0
_collections-background-line,2710,203,512,4,0,512,1,5,3933,0,0,4,0
collections-background-shadow-small,2711,203,13,13,93,106,42,55,3928,0,0,0,0
collections-background-shadow-large,2712,203,145,147,93,238,213,360,3932,0,0,0,0
bags-junkcoin,2713,202,20,18,66,86,117,135,3927,0,0,0,0
bags-innerglow,2785,202,36,36,261,297,128,164,3960,0,0,0,0
Capacitance-Blacksmithing-BG,2786,208,321,370,1,322,1,371,3961,0,0,0,0
Capacitance-Blacksmithing-IconBG,2787,208,291,58,1,292,373,431,3962,0,0,0,0
Capacitance-Blacksmithing-IconBorder,2788,208,59,58,324,383,1,59,3963,0,0,0,0
Capacitance-Blacksmithing-TimerBG,2789,208,275,15,1,276,467,482,3964,0,0,0,0
Capacitance-Blacksmithing-TimerFill,2790,208,275,15,1,276,484,499,3965,0,0,0,0
Capacitance-Blacksmithing-TimerFrame,2791,208,292,32,1,293,433,465,3966,0,0,0,0
Capacitance-General-EmptyFollower,2792,209,59,62,1,60,44,106,3967,0,0,0,0
Capacitance-General-ItemBorder,2793,209,133,41,1,134,1,42,3753,0,0,0,0
Capacitance-General-LockIcon,2794,209,22,29,233,255,1,30,3754,0,0,0,0
Capacitance-General-WorkOrderActive,2795,209,48,48,123,171,44,92,3755,0,0,0,0
Capacitance-General-WorkOrderArrow,2796,209,16,10,136,152,27,37,3756,0,0,0,0
Capacitance-General-WorkOrderBorder,2797,209,34,34,197,231,1,35,3757,0,0,0,0
Capacitance-General-WorkOrderCheckmark,2798,209,36,32,123,159,94,126,3758,0,0,0,0
Capacitance-General-WorkOrderEmpty,2799,209,34,34,173,207,44,78,3759,0,0,0,0
Capacitance-General-LevelBorder,2800,209,59,24,136,195,1,25,3760,0,0,0,0
Capacitance-General-PortraitRing,2801,209,59,62,62,121,44,106,3761,0,0,0,0
minortalents-icon-book,2808,213,40,38,437,477,48,86,3765,0,0,0,0
minortalents-iconcover,2809,213,25,45,437,462,88,133,3766,0,0,0,0
_minortalents-iconspinner,2811,213,512,45,0,512,1,46,3768,0,0,4,0
Objective-Fail,3137,197,16,16,486,502,1,17,3767,0,0,0,0
minortalents-backplate,3138,213,418,169,1,419,238,407,3769,0,0,0,0
minortalents-descriptionshadow,3139,213,434,188,1,435,48,236,3770,0,0,0,0
characterundelete-RestoreButton,3141,217,30,30,1,31,1,31,3762,0,0,0,0
bank-slots-shadow,3157,220,116,327,1,117,1,328,3771,0,0,0,0
bank-slots,3158,220,98,309,119,217,1,310,3772,0,0,0,0
Garr_MissionToast,3168,150,317,82,1,318,1,83,3773,0,0,0,0
Garr_FollowerToast-Epic,3169,150,219,26,275,494,253,279,3763,0,0,0,0
Garr_FollowerToast-Rare,3170,150,219,26,275,494,281,307,3764,0,0,0,0
Garr_FollowerToast-Uncommon,3171,150,219,26,1,220,314,340,3774,0,0,0,0
Garr_MissionToast-IconBG,3172,150,73,55,320,393,1,56,3775,0,0,0,0
Garr_Map_Frostfire1_H,3174,225,672,468,1,673,1,469,3776,0,0,0,0
Garr_Map_Frostfire2_H,3175,226,672,468,1,673,1,469,3777,0,0,0,0
Garr_Map_Frostfire3_H,3176,227,672,468,1,673,1,469,3783,0,0,0,0
ZoneAbility-Generic-AbilityBar-Glow,3189,230,153,27,79,232,30,57,3784,0,0,0,0
ZoneAbility-Generic-AbilityBar,3190,230,153,27,79,232,1,28,3785,0,0,0,0
ZoneAbility-Generic-IconBorder,3191,230,63,65,79,142,59,124,3786,0,0,0,0
ZoneAbility-Generic-SpellBox,3192,230,76,66,1,77,1,67,3787,0,0,0,0
groupfinder-icon-voice,3213,236,16,14,19,35,1007,1021,3791,0,0,0,0
groupfinder-icon-friend,3214,236,20,19,303,323,339,358,3792,0,0,0,0
GarrBuilding_Barn_1_A_Info,3233,254,250,162,1,251,1,163,3803,0,0,0,0
GarrBuilding_Barn_2_A_Info,3234,255,250,162,1,251,1,163,3804,0,0,0,0
GarrBuilding_Barn_3_A_Info,3235,256,250,162,1,251,1,163,3805,0,0,0,0
GarrBuilding_Barn_1_A_Map,3236,257,108,85,1,109,1,86,3806,0,0,0,0
GarrBuilding_Barn_2_A_Map,3237,258,108,90,1,109,1,91,3809,0,0,0,0
GarrBuilding_Barn_3_A_Map,3238,259,108,94,1,109,1,95,3812,0,0,0,0
garlanding-bottom,3266,268,412,86,1301,1713,60,146,3813,0,0,0,0
garlanding-left,3267,268,93,225,1403,1496,219,444,3818,0,0,0,0
garlanding-right,3268,268,94,225,1307,1401,219,444,4197,0,0,0,0
garrlanding-invasionbadge-glow,3271,268,280,67,303,583,387,454,4200,0,0,0,0
garrlanding-invasionbadge,3272,268,280,67,1,281,387,454,4201,0,0,0,0
garrlanding-missionlistbg,3274,268,478,64,1307,1785,153,217,4203,0,0,0,0
garrlanding-top,3279,268,413,91,886,1299,60,151,4207,0,0,0,0
garrlanding-tradeskilltimer-bg,3280,268,64,64,816,880,280,344,4208,0,0,0,0
garrlanding_watermark-tradeskill,3284,268,279,277,605,884,1,278,4212,0,0,0,0
garrlanding-followerscrollframe,3286,268,300,384,303,603,1,385,4213,0,0,0,0
garrlanding-lowerleft,3288,268,209,158,605,814,280,438,4215,0,0,0,0
garrlanding-lowerright,3289,268,209,158,886,1095,153,311,4216,0,0,0,0
garrlanding-upperleft,3290,268,209,158,886,1095,313,471,4217,0,0,0,0
garrlanding-upperright,3291,268,208,158,1097,1305,153,311,4218,0,0,0,0
garrlanding-headerbar,3293,268,772,57,886,1658,1,58,4220,0,0,0,0
GarrLanding-MiddleTile,3294,269,256,256,0,256,0,256,4202,0,0,6,0
garrlanding-mission-complete,3296,268,400,47,1498,1898,317,364,4214,0,0,0,0
garrlanding-mission-inprogress,3297,268,400,47,1498,1898,366,413,4219,0,0,0,0
garrlanding-building-complete,3298,268,400,47,1498,1898,219,266,4221,0,0,0,0
garrlanding-building-inprogress,3299,268,400,47,1498,1898,268,315,4222,0,0,0,0
Garr_BuildingInfoShadow,3301,123,158,57,131,289,173,230,4048,0,0,0,0
GarrBuilding_Farm_1_A_Info,3302,270,250,162,1,251,1,163,4120,0,0,0,0
GarrBuilding_Farm_2_A_Info,3303,271,250,162,1,251,1,163,4121,0,0,0,0
GarrBuilding_Farm_3_A_Info,3304,272,250,162,1,251,1,163,4122,0,0,0,0
GarrBuilding_Farm_1_A_Map,3305,273,108,98,1,109,1,99,4123,0,0,0,0
GarrBuilding_Farm_2_A_Map,3306,274,108,98,1,109,1,99,4124,0,0,0,0
GarrBuilding_Farm_3_A_Map,3307,275,108,98,1,109,1,99,4125,0,0,0,0
GarrBuilding_LumberMill_1_A_Info,3320,277,250,162,1,251,1,163,3708,0,0,0,0
GarrBuilding_LumberMill_2_A_Info,3321,278,250,162,1,251,1,163,3709,0,0,0,0
GarrBuilding_LumberMill_3_A_Info,3322,279,250,162,1,251,1,163,3703,0,0,0,0
GarrBuilding_LumberMill_1_A_Map,3323,280,108,70,1,109,1,71,3704,0,0,0,0
GarrBuilding_LumberMill_2_A_Map,3324,281,108,79,1,109,1,80,3710,0,0,0,0
GarrBuilding_LumberMill_3_A_Map,3325,282,108,99,1,109,1,100,3711,0,0,0,0
GarrBuilding_SalvageYard_1_A_Info,3326,283,250,162,1,251,1,163,3712,0,0,0,0
GarrBuilding_SalvageYard_1_A_Map,3327,284,108,89,1,109,1,90,3713,0,0,0,0
GarrBuilding_SparringArena_1_A_Info,3328,285,250,162,1,251,1,163,4126,0,0,0,0
GarrBuilding_SparringArena_2_A_Info,3329,286,250,162,1,251,1,163,4127,0,0,0,0
GarrBuilding_SparringArena_3_A_Info,3330,287,250,162,1,251,1,163,4128,0,0,0,0
GarrBuilding_SparringArena_1_A_Map,3331,288,108,66,1,109,1,67,4129,0,0,0,0
GarrBuilding_SparringArena_2_A_Map,3332,289,108,81,1,109,1,82,4130,0,0,0,0
GarrBuilding_SparringArena_3_A_Map,3333,290,108,77,1,109,1,78,4131,0,0,0,0
GarrBuilding_Stables_1_A_Info,3334,291,250,162,1,251,1,163,4132,0,0,0,0
GarrBuilding_Stables_2_A_Info,3335,292,250,162,1,251,1,163,4133,0,0,0,0
GarrBuilding_Stables_3_A_Info,3336,293,250,162,1,251,1,163,4134,0,0,0,0
GarrBuilding_Stables_1_A_Map,3337,294,108,80,1,109,1,81,4135,0,0,0,0
GarrBuilding_Stables_2_A_Map,3338,295,108,71,1,109,1,72,4136,0,0,0,0
GarrBuilding_Stables_3_A_Map,3339,296,108,72,1,109,1,73,4137,0,0,0,0
GarrBuilding_Storehouse_1_A_Info,3340,297,250,162,1,251,1,163,4138,0,0,0,0
GarrBuilding_Storehouse_1_A_Map,3341,298,108,73,1,109,1,74,4139,0,0,0,0
GarrBuilding_TradingPost_1_A_Info,3342,299,250,162,1,251,1,163,4140,0,0,0,0
GarrBuilding_TradingPost_2_A_Info,3343,300,250,162,1,251,1,163,4141,0,0,0,0
GarrBuilding_TradingPost_3_A_Info,3344,301,250,162,1,251,1,163,4142,0,0,0,0
GarrBuilding_TradingPost_1_A_Map,3345,302,108,77,1,109,1,78,4143,0,0,0,0
GarrBuilding_TradingPost_2_A_Map,3346,303,108,94,1,109,1,95,4144,0,0,0,0
GarrBuilding_TradingPost_3_A_Map,3347,304,108,85,1,109,1,86,4145,0,0,0,0
Objective-ItemBorder,3351,197,81,30,1,82,269,299,4004,0,0,0,0
Garr_Building-AddFollowerPlus,3352,123,33,33,315,348,389,422,4005,0,0,0,0
Monuments-Frame,3353,307,333,91,1,334,1,92,4006,0,0,0,0
Monuments-LeftButton-Down,3354,307,35,35,466,501,1,36,4007,0,0,0,0
Monuments-LeftButton-Up,3355,307,35,35,383,418,59,94,4008,0,0,0,0
Monuments-RightButton-Down,3356,307,35,35,420,455,59,94,4009,0,0,0,0
Monuments-RightButton-Up,3357,307,35,35,457,492,59,94,4010,0,0,0,0
Monuments-LockedOverlay,3358,307,128,56,336,464,1,57,4011,0,0,0,0
Monuments-Lock,3359,307,45,59,336,381,59,118,4012,0,0,0,0
BonusChest-KeyholeBurst,3360,308,118,128,136,254,136,264,4013,0,0,0,0
BonusChest-KeyholeGlow,3361,308,45,57,136,181,454,511,4014,0,0,0,0
BonusChest-Lock,3362,308,82,104,136,218,266,370,4015,0,0,0,0
BonusChest-CircleGlow,3363,308,99,98,1,100,401,499,4016,0,0,0,0
guild-levelring,3364,309,33,30,1,34,1,31,4049,0,0,0,0
Calendar_Quest,3370,310,91,91,1,92,1,92,4050,0,0,0,0
groupfinder-highlightbar-green,3371,236,304,32,331,635,431,463,3968,0,0,0,0
groupfinder-highlightbar-yellow,3372,236,304,32,943,1247,431,463,3969,0,0,0,0
groupfinder-icon-greencheckmark,3373,236,11,13,67,78,1007,1020,3970,0,0,0,0
groupfinder-icon-redx,3374,236,12,12,53,65,1007,1019,3971,0,0,0,0
groupfinder-background,3377,236,328,336,1,329,1,337,3972,0,0,0,0
groupfinder-button-arenas,3378,236,290,36,1,291,513,549,3973,0,0,0,0
groupfinder-button-battlegrounds,3379,236,290,36,1,291,589,625,3974,0,0,0,0
groupfinder-button-cover,3380,236,300,46,1,301,339,385,3975,0,0,0,0
groupfinder-button-custom-pve,3381,236,290,36,1,291,627,663,3976,0,0,0,0
groupfinder-button-custom-pvp,3382,236,290,36,1,291,665,701,3977,0,0,0,0
groupfinder-button-dungeons,3383,236,290,36,1,291,741,777,3978,0,0,0,0
groupfinder-button-questing,3384,236,290,36,1,291,817,853,3979,0,0,0,0
groupfinder-button-ratedbgs,3390,236,290,36,1671,1961,333,369,3985,0,0,0,0
groupfinder-button-scenarios,3391,236,290,36,331,621,393,429,3986,0,0,0,0
groupfinder-button-skirmishes,3392,236,290,36,623,913,393,429,3987,0,0,0,0
groupfinder-highlightbar-blue,3393,236,304,32,1499,1803,393,425,3988,0,0,0,0
Garr_SwapIcon,3395,123,46,46,289,335,463,509,4158,0,0,0,0
Garr_BuildFX-Glow,3396,123,49,80,351,400,371,451,4159,0,0,0,0
Garr_BuildFX-Lines,3397,123,27,84,99,126,256,340,4160,0,0,0,0
Garr_LockedBuilding,3398,123,68,83,241,309,304,387,4161,0,0,0,0
Garr_UpgradeFX-Glow,3399,123,49,80,425,474,232,312,4017,0,0,0,0
BonusChest-ItemBorder-Uncommon,3403,308,66,66,405,471,64,130,4087,0,0,0,0
BonusChest-Burst-Uncommon,3404,308,156,133,1,157,1,134,4088,0,0,0,0
bags-glow-purple,3409,202,39,39,261,300,46,85,4162,0,0,0,0
bags-glow-blue,3410,202,39,39,358,397,1,40,4163,0,0,0,0
bags-glow-orange,3411,202,39,39,93,132,214,253,4164,0,0,0,0
bags-glow-green,3412,202,39,39,399,438,1,40,4165,0,0,0,0
bags-glow-heirloom,3413,202,39,39,440,479,1,40,4166,0,0,0,0
bags-glow-white,3414,202,39,39,261,300,87,126,4167,0,0,0,0
bags-glow-flash,3418,202,90,90,1,91,1,91,4051,0,0,0,0
LFG-lock,3423,314,17,21,30,47,1,22,4235,0,0,0,0
Garr_Building_MaterialFrame,3431,123,290,43,274,564,63,106,4236,0,0,0,0
Garr_Mission_MaterialFrame,3433,156,316,43,1,317,527,570,4238,0,0,0,0
GarrMission_RewardsListBG,3434,156,218,75,218,436,946,1021,4237,0,0,0,0
GarrMission_RewardsShadow,3435,156,54,54,345,399,326,380,4239,0,0,0,0
Garr_MissionList-CostBG,3436,156,143,30,122,265,282,312,4240,0,0,0,0
Garr_MissionList-IconBG,3437,156,150,76,324,474,200,276,3989,0,0,0,0
GarrMission_ParchmentHeaderSelect-End,3446,156,65,41,55,120,282,323,3990,0,0,0,0
_GarrMission_ParchmentHeaderSelect-Mid,3448,156,128,41,0,128,1,42,3991,0,0,4,0
GarrMission_MissionCostStartButtonBg,3449,152,376,51,433,809,470,521,3992,0,0,0,0
GarMission_ChestPercentageShadow,3450,152,72,50,655,727,970,1020,3993,0,0,0,0
GarrMission_ChestOpenTextGlow,3451,152,189,42,811,1000,470,512,3994,0,0,0,0
GarrMission_PortraitRing_Glow,3452,152,59,62,887,946,877,939,3995,0,0,0,0
GarrMission_PortraitRing_Highlight,3453,152,59,62,948,1007,877,939,3996,0,0,0,0
splash-bigbutton,3454,319,356,99,1,357,18,117,4018,0,0,0,0
BonusChest-Smoke-Uncommon,3457,308,80,80,136,216,372,452,3997,0,0,0,0
splash-botleft,3463,319,368,15,1,369,1,16,4023,0,0,0,0
splash-boost-botleft,3464,320,137,371,374,511,587,958,4024,0,0,0,0
splash-boost-right,3465,320,510,584,1,511,1,585,4025,0,0,0,0
splash-boost-topleft,3466,320,371,434,1,372,587,1021,4026,0,0,0,0
splash-601-botleft,3467,321,137,371,374,511,587,958,4027,0,0,0,0
splash-601-right,3468,321,510,584,1,511,1,585,4019,0,0,0,0
splash-601-topleft,3469,321,371,434,1,372,587,1021,4020,0,0,0,0
splash-600-botleft,3470,322,137,371,374,511,587,958,4021,0,0,0,0
splash-600-right,3471,322,510,584,1,511,1,585,4022,0,0,0,0
splash-600-topleft,3472,322,371,434,1,372,587,1021,4028,0,0,0,0
GarrMission_CheckGlow,3473,152,32,32,218,250,962,994,3998,0,0,0,0
GarrMission_MissionIcon-Blacksmithing,3474,323,64,64,67,131,1,65,3999,0,0,0,0
GarrMission_MissionIcon-Combat,3475,323,64,64,133,197,1,65,4000,0,0,0,0
GarrMission_MissionIcon-Exploration,3476,323,64,64,1,65,67,131,4001,0,0,0,0
GarrMission_ClassIcon-Hunter,3477,324,55,49,1,56,52,101,4002,0,0,0,0
GarrMission_ClassIcon-Warrior,3478,324,55,49,58,113,205,254,4003,0,0,0,0
GarrMission_ClassIcon-Priest,3479,324,55,49,58,113,52,101,4029,0,0,0,0
GarrMission_ClassIcon-Monk,3480,324,55,49,1,56,154,203,4052,0,0,0,0
GarrMission_ClassIcon-Rogue,3481,324,55,49,115,170,52,101,4053,0,0,0,0
GarrMission_ClassIcon-Mage,3482,324,55,49,1,56,103,152,4054,0,0,0,0
GarrMission_ClassIcon-Warlock,3483,324,55,49,58,113,154,203,4055,0,0,0,0
GarrMission_ClassIcon-Shaman,3484,324,55,49,172,227,52,101,4056,0,0,0,0
GarrMission_ClassIcon-Druid,3485,324,55,49,115,170,1,50,4057,0,0,0,0
GarrMission_ClassIcon-Paladin,3486,324,55,49,1,56,205,254,4058,0,0,0,0
GarrMission_ClassIcon-DeathKnight,3487,324,55,49,58,113,1,50,4059,0,0,0,0
GarrMission_EncounterBar-Xright,3491,152,93,96,655,748,872,968,4060,0,0,0,0
Garr_MissionFX-Glow,3492,152,49,80,967,1016,313,393,4061,0,0,0,0
Garr_MissionFX-Lines,3493,152,27,84,269,296,900,984,4062,0,0,0,0
groupfinder-icon-leader,3494,236,14,9,303,317,423,432,4030,0,0,0,0
Garr_Map_Frostfire4_H,3504,330,672,468,1,673,1,469,3819,0,0,0,0
Garr_Map_Shadowmoon4_A,3505,331,672,468,1,673,1,469,3822,0,0,0,0
GarrMission-FollowerItemBg,3506,156,181,41,303,484,282,323,3828,0,0,0,0
bags-button-autosort-down,3507,202,62,62,1,63,171,233,3837,0,0,0,0
bags-button-autosort-up,3508,202,62,62,93,155,46,108,3838,0,0,0,0
bags-roundhighlight,3509,202,36,36,261,297,166,202,3841,0,0,0,0
garrlanding-minimapicon-alliance-down,3510,268,53,53,1940,1993,1,54,3842,0,0,0,0
garrlanding-minimapicon-alliance-up,3511,268,53,53,1781,1834,60,113,3843,0,0,0,0
garrlanding-minimapicon-horde-up,3512,268,53,53,1891,1944,60,113,3844,0,0,0,0
garrlanding-minimapicon-horde-down,3513,268,53,53,1836,1889,60,113,3845,0,0,0,0
garrlanding-circleglow,3515,268,46,46,250,296,456,502,4031,0,0,0,0
garrlanding-minimapalertbg,3516,268,174,46,1,175,456,502,4032,0,0,0,0
garrlanding-sidetoast-glow,3517,268,99,99,1097,1196,313,412,4033,0,0,0,0
garrlanding-toptabhighlight,3519,268,191,24,605,796,472,496,4034,0,0,0,0
garrlanding-toptabselected,3520,268,205,36,303,508,456,492,4035,0,0,0,0
garrlanding-toptabunselected,3521,268,205,30,605,810,440,470,4036,0,0,0,0
Alliance_Tier1_Barracks,3529,333,52,54,207,259,57,111,4168,0,0,0,0
Alliance_Tier1_Professions,3530,333,38,43,261,299,193,236,4169,0,0,0,0
Alliance_Tier1_TownHall,3531,333,41,40,468,509,1,41,4170,0,0,0,0
GarrMission_MissionStart,3538,156,222,40,248,470,654,694,4040,0,0,0,0
loottoast-arrow-blue,3545,332,21,25,856,877,81,106,4073,0,0,0,0
loottoast-arrow-green,3546,332,21,25,879,900,81,106,4074,0,0,0,0
loottoast-arrow-orange,3547,332,21,25,902,923,81,106,4075,0,0,0,0
loottoast-arrow-purple,3548,332,21,25,936,957,71,96,4076,0,0,0,0
loottoast-bg-questrewardupgrade,3549,332,276,96,1,277,218,314,4077,0,0,0,0
loottoast-glow,3550,332,286,109,284,570,1,110,4078,0,0,0,0
loottoast-itemborder-blue,3551,332,58,58,747,805,218,276,4079,0,0,0,0
loottoast-itemborder-glow,3552,332,68,68,936,1004,1,69,4080,0,0,0,0
loottoast-itemborder-green,3553,332,58,58,867,925,218,276,4081,0,0,0,0
loottoast-itemborder-orange,3554,332,58,58,279,337,300,358,4082,0,0,0,0
loottoast-itemborder-purple,3555,332,58,58,279,337,360,418,4083,0,0,0,0
loottoast-sheen,3556,332,171,75,839,1010,118,193,4084,0,0,0,0
Headhunter_AbilityBorderGlow,3557,334,32,32,1,33,372,404,4171,0,0,0,0
Headhunter_BG,3558,334,321,369,1,322,1,370,4172,0,0,0,0
Headhunter_LineHeader,3559,334,223,1,35,258,372,373,4173,0,0,0,0
_GarrMissionLocation-FrostfireRidge-Back,3560,335,1024,285,0,1024,1,286,4063,0,0,4,0
_GarrMissionLocation-FrostfireRidge-Fore,3561,335,1024,285,0,1024,288,573,4064,0,0,4,0
_GarrMissionLocation-FrostfireRidge-Mid,3562,335,1024,285,0,1024,575,860,4065,0,0,4,0
garrlanding_rewardsshadow,3563,268,34,34,510,544,456,490,4085,0,0,0,0
garrlanding_rewardslistbg,3564,268,132,45,1660,1792,1,46,4086,0,0,0,0
garrlandinglist-costbg,3565,268,120,18,886,1006,473,491,4089,0,0,0,0
GarrMission_MissionIcon-Enchanting,3566,323,64,64,331,395,1,65,4146,0,0,0,0
GarrMission_MissionIcon-Salvage,3567,323,64,64,265,329,67,131,4147,0,0,0,0
GarrMission_MissionIcon-Provision,3568,323,64,64,133,197,67,131,4148,0,0,0,0
GarrMission_MissionIcon-Generic,3569,323,64,64,1,65,133,197,4149,0,0,0,0
GarrMission_MissionIcon-Siege,3570,323,64,64,331,395,67,131,4150,0,0,0,0
GarrMission_MissionIcon-Alchemy,3571,323,64,64,1,65,1,65,4151,0,0,0,0
GarrMission_MissionIcon-Wildlife,3572,323,64,64,67,131,265,329,4152,0,0,0,0
GarrMission_MissionIcon-Tailoring,3573,323,64,64,397,461,67,131,4153,0,0,0,0
GarrMission_MissionIcon-Training,3574,323,64,64,67,131,199,263,4154,0,0,0,0
GarrMission_MissionIcon-Trading,3575,323,64,64,67,131,133,197,4155,0,0,0,0
GarrMission_MissionIcon-Jewelcrafting,3576,323,64,64,1,65,265,329,4156,0,0,0,0
GarrMission_MissionIcon-Defense,3577,323,64,64,265,329,1,65,4157,0,0,0,0
GarrMission_MissionIcon-Construction,3578,323,64,64,199,263,1,65,4174,0,0,0,0
GarrMission_MissionIcon-Inscription,3579,323,64,64,1,65,199,263,4175,0,0,0,0
GarrMission_MissionIcon-Logistics,3580,323,64,64,1,65,397,461,4176,0,0,0,0
GarrMission_MissionIcon-Engineering,3581,323,64,64,397,461,1,65,4177,0,0,0,0
GarrMission_MissionIcon-Patrol,3582,323,64,64,67,131,67,131,4178,0,0,0,0
GarrMission_MissionIcon-Recruit,3583,323,64,64,199,263,67,131,4179,0,0,0,0
GarrMission_MissionIcon-Leatherworking,3584,323,64,64,1,65,331,395,4180,0,0,0,0
GarrBuilding_Jewelcrafting_1_A_Info,3586,336,250,162,1,251,1,163,4066,0,0,0,0
GarrBuilding_Jewelcrafting_2_A_Info,3587,337,250,162,1,251,1,163,4067,0,0,0,0
GarrBuilding_Jewelcrafting_3_A_Info,3588,338,250,162,1,251,1,163,4068,0,0,0,0
GarrBuilding_Jewelcrafting_1_A_Map,3589,339,108,72,1,109,1,73,4069,0,0,0,0
GarrBuilding_Jewelcrafting_2_A_Map,3590,340,108,70,1,109,1,71,4070,0,0,0,0
GarrBuilding_Jewelcrafting_3_A_Map,3591,341,108,76,1,109,1,77,4071,0,0,0,0
GarrBuilding_Enchanting_1_A_Info,3592,342,250,162,1,251,1,163,4072,0,0,0,0
GarrBuilding_Enchanting_2_A_Info,3593,343,250,162,1,251,1,163,4090,0,0,0,0
GarrBuilding_Enchanting_3_A_Info,3594,344,250,162,1,251,1,163,4091,0,0,0,0
GarrBuilding_Enchanting_1_A_Map,3595,345,108,72,1,109,1,73,4092,0,0,0,0
GarrBuilding_Enchanting_2_A_Map,3596,346,108,72,1,109,1,73,4093,0,0,0,0
GarrBuilding_Enchanting_3_A_Map,3597,347,108,72,1,109,1,73,4094,0,0,0,0
GarrBuilding_Blacksmith_1_A_Info,3598,348,250,162,1,251,1,163,4095,0,0,0,0
GarrBuilding_Blacksmith_2_A_Info,3599,349,250,162,1,251,1,163,4096,0,0,0,0
GarrBuilding_Blacksmith_3_A_Info,3600,350,250,162,1,251,1,163,4097,0,0,0,0
GarrBuilding_Blacksmith_1_A_Map,3601,351,108,74,1,109,1,75,4098,0,0,0,0
GarrBuilding_Blacksmith_2_A_Map,3602,352,108,75,1,109,1,76,4099,0,0,0,0
GarrBuilding_Blacksmith_3_A_Map,3603,353,108,76,1,109,1,77,4100,0,0,0,0
GarrBuilding_Fishing_1_A_Info,3604,354,250,162,1,251,1,163,4101,0,0,0,0
GarrBuilding_Fishing_2_A_Info,3605,355,250,162,1,251,1,163,4102,0,0,0,0
GarrBuilding_Fishing_3_A_Info,3606,356,250,162,1,251,1,163,4103,0,0,0,0
GarrBuilding_Fishing_1_A_Map,3607,357,108,74,1,109,1,75,4104,0,0,0,0
GarrBuilding_Fishing_2_A_Map,3608,358,108,75,1,109,1,76,4105,0,0,0,0
GarrBuilding_Fishing_3_A_Map,3609,359,108,78,1,109,1,79,4106,0,0,0,0
GarrBuilding_Workshop_1_A_Info,3610,360,250,162,1,251,1,163,4037,0,0,0,0
GarrBuilding_Workshop_2_A_Info,3611,361,250,162,1,251,1,163,4038,0,0,0,0
GarrBuilding_Workshop_3_A_Info,3612,362,250,162,1,251,1,163,4039,0,0,0,0
GarrBuilding_Workshop_1_A_Map,3613,363,108,78,1,109,1,79,4041,0,0,0,0
GarrBuilding_Workshop_2_A_Map,3614,364,108,87,1,109,1,88,4042,0,0,0,0
GarrBuilding_Workshop_3_A_Map,3615,365,108,96,1,109,1,97,4043,0,0,0,0
groupfinder-eye-highlight,3616,236,86,86,331,417,465,551,4181,0,0,0,0
GarrBuilding_Tailoring_1_A_Info,3618,366,250,162,1,251,1,163,4182,0,0,0,0
GarrBuilding_Tailoring_2_A_Info,3619,367,250,162,1,251,1,163,4183,0,0,0,0
GarrBuilding_Tailoring_3_A_Info,3620,368,250,162,1,251,1,163,4184,0,0,0,0
GarrBuilding_Tailoring_1_A_Map,3621,369,108,73,1,109,1,74,4185,0,0,0,0
GarrBuilding_Tailoring_2_A_Map,3622,370,108,75,1,109,1,76,4186,0,0,0,0
GarrBuilding_Tailoring_3_A_Map,3623,371,108,76,1,109,1,77,4187,0,0,0,0
GarrBuilding_Inscription_1_A_Info,3624,372,250,162,1,251,1,163,4188,0,0,0,0
GarrBuilding_Inscription_2_A_Info,3625,373,250,162,1,251,1,163,4189,0,0,0,0
GarrBuilding_Inscription_3_A_Info,3626,374,250,162,1,251,1,163,4190,0,0,0,0
GarrBuilding_Inscription_1_A_Map,3627,375,108,75,1,109,1,76,4191,0,0,0,0
GarrBuilding_Inscription_2_A_Map,3628,376,108,91,1,109,1,92,4192,0,0,0,0
GarrBuilding_Inscription_3_A_Map,3629,377,108,91,1,109,1,92,4193,0,0,0,0
GarrBuilding_Leatherworking_1_A_Info,3630,378,250,162,1,251,1,163,4194,0,0,0,0
GarrBuilding_Leatherworking_2_A_Info,3631,379,250,162,1,251,1,163,4195,0,0,0,0
GarrBuilding_Leatherworking_3_A_Info,3632,380,250,162,1,251,1,163,4196,0,0,0,0
GarrBuilding_Leatherworking_1_A_Map,3633,381,108,70,1,109,1,71,4044,0,0,0,0
GarrBuilding_Leatherworking_2_A_Map,3634,382,108,72,1,109,1,73,4045,0,0,0,0
GarrBuilding_Leatherworking_3_A_Map,3635,383,108,74,1,109,1,75,4046,0,0,0,0
garrlanding-tradeskilltimer-parchmentbg,3636,268,64,64,1715,1779,60,124,4047,0,0,0,0
GarrBuilding_EmptyPlot_A_1,3689,391,250,162,1,251,1,163,4107,0,0,0,0
GarrBuilding_EmptyPlot_A_2,3690,392,250,162,1,251,1,163,4108,0,0,0,0
GarrBuilding_EmptyPlot_A_3,3691,393,250,162,1,251,1,163,4109,0,0,0,0
garrlanding-shipmentcompleteglow,3692,268,96,96,1097,1193,414,510,4110,0,0,0,0
GarrBuilding_PetStable_1_A_Info,3693,394,250,162,1,251,1,163,4111,0,0,0,0
GarrBuilding_PetStable_1_A_Map,3694,395,108,72,1,109,1,73,4112,0,0,0,0
_GarrMissionLocation-Gorgrond-Back,3695,396,1024,285,0,1024,1,286,4113,0,0,4,0
_GarrMissionLocation-Gorgrond-Fore,3696,396,1024,285,0,1024,288,573,4114,0,0,4,0
_GarrMissionLocation-Nagrand-Back,3698,397,1024,285,0,1024,1,286,4115,0,0,4,0
_GarrMissionLocation-Nagrand-Fore,3699,397,1024,285,0,1024,288,573,4116,0,0,4,0
_GarrMissionLocation-Nagrand-Mid,3700,397,1024,285,0,1024,575,860,4117,0,0,4,0
_GarrMissionLocation-Talador-Back,3701,398,1024,285,0,1024,1,286,4118,0,0,4,0
_GarrMissionLocation-Talador-Fore,3702,398,1024,285,0,1024,288,573,4119,0,0,4,0
_GarrMissionLocation-Talador-Mid,3703,398,1024,285,0,1024,575,860,4411,0,0,4,0
_GarrMissionLocation-ShadowmoonValley-Back,3704,399,1024,285,0,1024,1,286,4412,0,0,4,0
_GarrMissionLocation-ShadowmoonValley-Fore,3705,399,1024,285,0,1024,288,573,4413,0,0,4,0
_GarrMissionLocation-ShadowmoonValley-Mid,3706,399,1024,285,0,1024,575,860,4414,0,0,4,0
_GarrMissionLocation-SpiresofArak-Back,3707,400,1024,285,0,1024,1,286,4415,0,0,4,0
_GarrMissionLocation-SpiresofArak-Fore,3708,400,1024,285,0,1024,288,573,4416,0,0,4,0
_GarrMissionLocation-SpiresofArak-Mid,3709,400,1024,285,0,1024,575,860,4417,0,0,4,0
_GarrMissionLocation-Underground-Back,3710,401,1024,285,0,1024,1,286,4418,0,0,4,0
_GarrMissionLocation-Underground-Fore,3711,401,1024,285,0,1024,288,573,4419,0,0,4,0
_GarrMissionLocation-Underground-Mid,3712,401,1024,285,0,1024,575,860,4420,0,0,4,0
_GarrMissionLocation-TownHorde-Back,3713,402,1024,285,0,1024,1,286,4421,0,0,4,0
_GarrMissionLocation-TownHorde-Fore,3714,402,1024,285,0,1024,288,573,4422,0,0,4,0
_GarrMissionLocation-TownHorde-Mid,3715,402,1024,285,0,1024,575,860,4423,0,0,4,0
_GarrMissionLocation-TownAlliance-Back,3716,403,1024,285,0,1024,1,286,4424,0,0,4,0
_GarrMissionLocation-TownAlliance-Fore,3717,403,1024,285,0,1024,288,573,4425,0,0,4,0
_GarrMissionLocation-TownAlliance-Mid,3718,403,1024,285,0,1024,575,860,4426,0,0,4,0
GarrBuilding_Tailoring_1_H_Info,3719,404,250,162,1,251,1,163,4538,0,0,0,0
GarrBuilding_Tailoring_1_H_Map,3720,405,108,86,1,109,1,87,4539,0,0,0,0
GarrBuilding_Tailoring_2_H_Info,3721,406,250,162,1,251,1,163,4540,0,0,0,0
GarrBuilding_Tailoring_3_H_Info,3722,407,250,162,1,251,1,163,4541,0,0,0,0
GarrBuilding_Tailoring_2_H_Map,3723,408,108,83,1,109,1,84,4542,0,0,0,0
GarrBuilding_Tailoring_3_H_Map,3724,409,108,84,1,109,1,85,4543,0,0,0,0
GarrBuilding_Leatherworking_1_H_Info,3725,410,250,162,1,251,1,163,4283,0,0,0,0
GarrBuilding_Leatherworking_2_H_Info,3726,411,250,162,1,251,1,163,4284,0,0,0,0
GarrBuilding_Leatherworking_3_H_Info,3727,412,250,162,1,251,1,163,4285,0,0,0,0
GarrBuilding_Leatherworking_1_H_Map,3728,413,108,78,1,109,1,79,4286,0,0,0,0
GarrBuilding_Leatherworking_2_H_Map,3729,414,108,78,1,109,1,79,4287,0,0,0,0
GarrBuilding_Leatherworking_3_H_Map,3730,415,108,87,1,109,1,88,4288,0,0,0,0
GarrBuilding_Jewelcrafting_1_H_Info,3731,416,250,162,1,251,1,163,4544,0,0,0,0
GarrBuilding_Jewelcrafting_2_H_Info,3732,417,250,162,1,251,1,163,4545,0,0,0,0
GarrBuilding_Jewelcrafting_3_H_Info,3733,418,250,162,1,251,1,163,4546,0,0,0,0
GarrBuilding_Jewelcrafting_1_H_Map,3734,419,108,80,1,109,1,81,4547,0,0,0,0
GarrBuilding_Jewelcrafting_2_H_Map,3735,420,108,85,1,109,1,86,4548,0,0,0,0
GarrBuilding_Jewelcrafting_3_H_Map,3736,421,108,93,1,109,1,94,4549,0,0,0,0
GarrBuilding_Inscription_1_H_Info,3737,423,250,162,1,251,1,163,4550,0,0,0,0
GarrBuilding_Inscription_2_H_Info,3738,424,250,162,1,251,1,163,4551,0,0,0,0
GarrBuilding_Inscription_3_H_Info,3739,425,250,162,1,251,1,163,4552,0,0,0,0
GarrBuilding_Inscription_1_H_Map,3740,426,108,78,1,109,1,79,4553,0,0,0,0
GarrBuilding_Inscription_2_H_Map,3741,427,108,87,1,109,1,88,4554,0,0,0,0
GarrBuilding_Inscription_3_H_Map,3743,429,108,90,1,109,1,91,4556,0,0,0,0
GarrBuilding_Engineering_1_H_Info,3744,430,250,162,1,251,1,163,4557,0,0,0,0
GarrBuilding_Engineering_2_H_Info,3745,431,250,162,1,251,1,163,4555,0,0,0,0
GarrBuilding_Engineering_3_H_Info,3746,432,250,162,1,251,1,163,4558,0,0,0,0
GarrBuilding_Engineering_1_H_Map,3747,433,108,79,1,109,1,80,4559,0,0,0,0
GarrBuilding_Engineering_2_H_Map,3748,434,108,79,1,109,1,80,4560,0,0,0,0
GarrBuilding_Engineering_3_H_Map,3749,435,108,81,1,109,1,82,4561,0,0,0,0
GarrBuilding_Enchanting_1_H_Info,3751,437,250,162,1,251,1,163,4244,0,0,0,0
GarrBuilding_Enchanting_2_H_Info,3752,438,250,162,1,251,1,163,4245,0,0,0,0
GarrBuilding_Enchanting_3_H_Info,3753,439,250,162,1,251,1,163,4243,0,0,0,0
GarrBuilding_Enchanting_1_H_Map,3754,440,108,82,1,109,1,83,4246,0,0,0,0
GarrBuilding_Enchanting_2_H_Map,3755,441,108,83,1,109,1,84,4247,0,0,0,0
GarrBuilding_Enchanting_3_H_Map,3756,442,108,81,1,109,1,82,4248,0,0,0,0
GarrBuilding_Blacksmith_1_H_Info,3757,443,250,162,1,251,1,163,4498,0,0,0,0
GarrBuilding_Blacksmith_2_H_Info,3758,444,250,162,1,251,1,163,4499,0,0,0,0
GarrBuilding_Blacksmith_3_H_Info,3759,445,250,162,1,251,1,163,4500,0,0,0,0
GarrBuilding_Blacksmith_1_H_Map,3760,446,108,78,1,109,1,79,4501,0,0,0,0
GarrBuilding_Blacksmith_2_H_Map,3761,447,108,77,1,109,1,78,4502,0,0,0,0
GarrBuilding_Blacksmith_3_H_Map,3762,448,108,80,1,109,1,81,4503,0,0,0,0
GarrBuilding_Alchemy_1_H_Info,3763,449,250,162,1,251,1,163,4504,0,0,0,0
GarrBuilding_Alchemy_2_H_Info,3764,450,250,162,1,251,1,163,4505,0,0,0,0
GarrBuilding_Alchemy_3_H_Info,3765,451,250,162,1,251,1,163,4506,0,0,0,0
GarrBuilding_Alchemy_1_H_Map,3766,452,108,79,1,109,1,80,4507,0,0,0,0
GarrBuilding_Alchemy_2_H_Map,3767,453,108,79,1,109,1,80,4508,0,0,0,0
GarrBuilding_Alchemy_3_H_Map,3768,454,108,82,1,109,1,83,4509,0,0,0,0
GarrBuilding_Barn_1_H_Info,3769,455,250,162,1,251,1,163,4510,0,0,0,0
GarrBuilding_Barn_2_H_Info,3770,456,250,162,1,251,1,163,4511,0,0,0,0
GarrBuilding_Barn_3_H_Info,3771,457,250,162,1,251,1,163,4512,0,0,0,0
GarrBuilding_Barn_1_H_Map,3772,458,108,81,1,109,1,82,4513,0,0,0,0
GarrBuilding_Barn_2_H_Map,3773,459,108,88,1,109,1,89,4514,0,0,0,0
GarrBuilding_Barn_3_H_Map,3774,460,108,97,1,109,1,98,4515,0,0,0,0
GarrBuilding_Fishing_1_H_Info,3775,461,250,162,1,251,1,163,4516,0,0,0,0
GarrBuilding_Fishing_2_H_Info,3776,462,250,162,1,251,1,163,4517,0,0,0,0
GarrBuilding_Fishing_3_H_Info,3777,463,250,162,1,251,1,163,4518,0,0,0,0
GarrBuilding_Fishing_1_H_Map,3778,464,108,80,1,109,1,81,4519,0,0,0,0
GarrBuilding_Fishing_2_H_Map,3779,465,108,84,1,109,1,85,4520,0,0,0,0
GarrBuilding_Fishing_3_H_Map,3780,466,108,80,1,109,1,81,4521,0,0,0,0
GarrBuilding_Farm_1_H_Info,3781,467,250,162,1,251,1,163,4522,0,0,0,0
GarrBuilding_Farm_1_H_Map,3782,468,108,94,1,109,1,95,4523,0,0,0,0
GarrBuilding_EmptyPlot_H_3,3783,469,250,162,1,251,1,163,4524,0,0,0,0
GarrBuilding_EmptyPlot_H_2,3784,470,250,162,1,251,1,163,4525,0,0,0,0
GarrBuilding_EmptyPlot_H_1,3785,471,250,162,1,251,1,163,4526,0,0,0,0
GarrBuilding_Inn_1_H_Info,3786,472,250,162,1,251,1,163,4249,0,0,0,0
GarrBuilding_Inn_2_H_Info,3787,473,250,162,1,251,1,163,4250,0,0,0,0
GarrBuilding_Inn_3_H_Info,3788,474,250,162,1,251,1,163,4251,0,0,0,0
GarrBuilding_Inn_1_H_Map,3789,475,108,88,1,109,1,89,4252,0,0,0,0
GarrBuilding_Inn_2_H_Map,3790,476,108,100,1,109,1,101,4253,0,0,0,0
GarrBuilding_Inn_3_H_Map,3791,477,108,116,1,109,1,117,4254,0,0,0,0
GarrBuilding_TownHall_1_H_Info,3792,478,250,162,1,251,1,163,4255,0,0,0,0
GarrBuilding_TownHall_2_H_Info,3793,479,250,162,1,251,1,163,4256,0,0,0,0
GarrBuilding_TownHall_3_H_Info,3794,480,250,162,1,251,1,163,4257,0,0,0,0
GarrBuilding_TownHall_1_H_Map,3795,481,108,102,1,109,1,103,4258,0,0,0,0
GarrBuilding_TownHall_2_H_Map,3796,482,108,107,1,109,1,108,4259,0,0,0,0
GarrBuilding_TownHall_3_H_Map,3797,483,108,111,1,109,1,112,4260,0,0,0,0
GarrBuilding_Storehouse_1_H_Info,3798,484,250,162,1,251,1,163,4261,0,0,0,0
GarrBuilding_Storehouse_1_H_Map,3799,485,108,80,1,109,1,81,4262,0,0,0,0
GarrBuilding_SalvageYard_1_H_Info,3800,486,250,162,1,251,1,163,4263,0,0,0,0
GarrBuilding_SalvageYard_1_H_Map,3801,487,108,86,1,109,1,87,4264,0,0,0,0
GarrBuilding_Barracks_1_H_Info,3802,488,250,162,1,251,1,163,4265,0,0,0,0
GarrBuilding_Barracks_2_H_Info,3803,489,250,162,1,251,1,163,4266,0,0,0,0
GarrBuilding_Barracks_3_H_Info,3804,490,250,162,1,251,1,163,4267,0,0,0,0
GarrBuilding_Barracks_1_H_Map,3805,491,108,86,1,109,1,87,4268,0,0,0,0
GarrBuilding_Barracks_2_H_Map,3806,492,108,85,1,109,1,86,4269,0,0,0,0
GarrBuilding_Barracks_3_H_Map,3807,493,108,104,1,109,1,105,4270,0,0,0,0
GarrBuilding_SparringArena_1_H_Info,3817,496,250,162,1,251,1,163,4271,0,0,0,0
GarrBuilding_SparringArena_2_H_Info,3818,497,250,162,1,251,1,163,4272,0,0,0,0
GarrBuilding_SparringArena_3_H_Info,3819,498,250,162,1,251,1,163,4273,0,0,0,0
GarrBuilding_SparringArena_1_H_Map,3820,499,108,67,1,109,1,68,4274,0,0,0,0
GarrBuilding_SparringArena_2_H_Map,3821,500,108,76,1,109,1,77,4275,0,0,0,0
GarrBuilding_SparringArena_3_H_Map,3822,501,108,70,1,109,1,71,4276,0,0,0,0
GarrBuilding_Armory_1_H_Info,3823,502,250,162,1,251,1,163,4277,0,0,0,0
GarrBuilding_Armory_2_H_Info,3824,503,250,162,1,251,1,163,4278,0,0,0,0
GarrBuilding_Armory_3_H_Info,3825,504,250,162,1,251,1,163,4279,0,0,0,0
GarrBuilding_Armory_1_H_Map,3826,505,108,81,1,109,1,82,4280,0,0,0,0
GarrBuilding_Armory_2_H_Map,3827,506,108,86,1,109,1,87,4281,0,0,0,0
GarrBuilding_Armory_3_H_Map,3828,507,108,98,1,109,1,99,4282,0,0,0,0
GarrBuilding_MageTower_1_H_Info,3829,508,250,162,1,251,1,163,4289,0,0,0,0
GarrBuilding_MageTower_2_H_Info,3830,509,250,162,1,251,1,163,4370,0,0,0,0
GarrBuilding_MageTower_3_H_Info,3831,510,250,162,1,251,1,163,4371,0,0,0,0
GarrFollower-Shadow,3832,156,342,141,1,343,326,467,4372,0,0,0,0
GarrBuilding_MageTower_1_H_Map,3833,511,108,90,1,109,1,91,4373,0,0,0,0
GarrBuilding_MageTower_2_H_Map,3834,512,108,111,1,109,1,112,4374,0,0,0,0
GarrBuilding_MageTower_3_H_Map,3835,513,108,125,1,109,1,126,4375,0,0,0,0
GarrBuilding_Stables_2_H_Info,3837,515,250,162,1,251,1,163,4377,0,0,0,0
GarrBuilding_Stables_3_H_Info,3838,516,250,162,1,251,1,163,4378,0,0,0,0
GarrBuilding_Stables_1_H_Info,3839,514,250,162,1,251,1,163,4379,0,0,0,0
GarrBuilding_Stables_1_H_Map,3840,517,108,71,1,109,1,72,4380,0,0,0,0
GarrBuilding_Stables_2_H_Map,3841,518,108,71,1,109,1,72,4376,0,0,0,0
GarrBuilding_Stables_3_H_Map,3842,519,108,87,1,109,1,88,4381,0,0,0,0
GarrBuilding_TradingPost_1_H_Info,3843,520,250,162,1,251,1,163,4382,0,0,0,0
GarrBuilding_TradingPost_2_H_Info,3844,521,250,162,1,251,1,163,4383,0,0,0,0
GarrBuilding_TradingPost_3_H_Info,3845,522,250,162,1,251,1,163,4384,0,0,0,0
GarrBuilding_TradingPost_1_H_Map,3846,523,108,65,1,109,1,66,4385,0,0,0,0
GarrBuilding_TradingPost_2_H_Map,3848,525,108,95,1,109,1,96,4386,0,0,0,0
GarrBuilding_TradingPost_3_H_Map,3849,526,108,93,1,109,1,94,4387,0,0,0,0
GarrBuilding_Workshop_1_H_Info,3852,529,250,162,1,251,1,163,4388,0,0,0,0
GarrBuilding_Workshop_2_H_Info,3853,530,250,162,1,251,1,163,4389,0,0,0,0
GarrBuilding_Workshop_3_H_Info,3854,531,250,162,1,251,1,163,4390,0,0,0,0
GarrBuilding_Workshop_1_H_Map,3855,532,108,101,1,109,1,102,4391,0,0,0,0
GarrBuilding_Workshop_2_H_Map,3856,533,108,96,1,109,1,97,4392,0,0,0,0
GarrBuilding_Workshop_3_H_Map,3857,534,108,97,1,109,1,98,4393,0,0,0,0
GarrBuilding_Mine_1_H_Info,3859,536,250,162,1,251,1,163,4394,0,0,0,0
GarrBuilding_Mine_1_H_Map,3861,538,108,78,1,109,1,79,4395,0,0,0,0
GarrBuilding_LumberMill_1_H_Info,3862,539,250,162,1,251,1,163,4396,0,0,0,0
GarrBuilding_LumberMill_2_H_Info,3863,540,250,162,1,251,1,163,4397,0,0,0,0
GarrBuilding_LumberMill_3_H_Info,3864,541,250,162,1,251,1,163,4398,0,0,0,0
GarrBuilding_LumberMill_1_H_Map,3865,542,108,73,1,109,1,74,4399,0,0,0,0
GarrBuilding_LumberMill_2_H_Map,3866,543,108,82,1,109,1,83,4400,0,0,0,0
GarrBuilding_LumberMill_3_H_Map,3867,544,108,94,1,109,1,95,4401,0,0,0,0
GarrBuilding_PetStable_1_H_Info,3868,545,250,162,1,251,1,163,4402,0,0,0,0
GarrBuilding_PetStable_1_H_Map,3869,546,108,78,1,109,1,79,4403,0,0,0,0
GarrMission-AllianceChest,3873,152,209,155,269,478,313,468,4452,0,0,0,0
GarrMission-HordeChest,3874,152,209,155,480,689,313,468,4453,0,0,0,0
DungeonTargetIndicator,3875,314,27,29,1,28,1,30,4454,0,0,0,0
GarrMission_PortraitRing_Darkener,3876,152,59,62,826,885,877,939,4527,0,0,0,0
GarrMission_PortraitRing_Quality,3877,152,59,62,887,946,941,1003,4528,0,0,0,0
BonusChest-OrangeSmoke-Wide,3878,308,228,64,256,484,136,200,4529,0,0,0,0
BonusChest-OrangeGlow-Wide,3879,308,244,64,159,403,64,128,4530,0,0,0,0
loottoast-bg-alliance,3880,332,278,98,1,279,118,216,3788,0,0,0,0
loottoast-bg-horde,3881,332,282,100,572,854,1,101,3789,0,0,0,0
groupfinder-button-highlight,3882,236,292,37,1,293,435,472,3779,0,0,0,0
groupfinder-button-select,3883,236,292,37,1,293,474,511,3780,0,0,0,0
groupfinder-button-cover-down,3884,236,300,46,1,301,387,433,3781,0,0,0,0
GarrMission_EncounterBar-CheckMark-Left,3885,152,74,76,750,824,774,850,4531,0,0,0,0
GarrMission_EncounterBar-CheckMark-Right,3886,152,74,76,750,824,852,928,4532,0,0,0,0
GarrMission_EncounterBar-CheckMark,3887,152,74,76,528,602,920,996,4533,0,0,0,0
GarrMission_EncounterBar-CheckMarkCircleSwipe,3888,152,64,64,365,429,874,938,4534,0,0,0,0
Alliance_Tier1_Mine,3911,333,55,46,261,316,1,47,4404,0,0,0,0
Alliance_Tier1_Trading1,3912,333,42,43,424,466,1,44,4405,0,0,0,0
Alliance_Tier1_Armory1,3913,333,63,79,1,64,78,157,4406,0,0,0,0
Alliance_Tier1_Mage1,3914,333,53,57,139,192,176,233,4407,0,0,0,0
Alliance_Tier1_Mage2,3915,333,58,58,139,197,57,115,4408,0,0,0,0
Alliance_Tier1_Armory2,3916,333,69,75,1,70,1,76,4409,0,0,0,0
Alliance_Tier1_Stables1,3917,333,59,59,72,131,131,190,4410,0,0,0,0
Alliance_Tier1_Barracks1,3918,333,52,54,207,259,1,55,4427,0,0,0,0
Alliance_Tier1_Stables2,3919,333,68,66,1,69,159,225,4428,0,0,0,0
Alliance_Tier1_Lumber1,3920,333,58,61,72,130,68,129,4429,0,0,0,0
Alliance_Tier1_Barn2,3921,333,49,39,373,422,1,40,4430,0,0,0,0
Alliance_Tier1_Professions2,3922,333,38,43,308,346,49,92,4431,0,0,0,0
Alliance_Tier1_Inn1,3923,333,56,57,139,195,117,174,4432,0,0,0,0
Alliance_Tier1_Farm,3924,333,29,37,308,337,136,173,4433,0,0,0,0
Menagery1,3925,333,42,39,261,303,152,191,4434,0,0,0,0
Alliance_Tier1_Arena2,3926,333,53,43,318,371,1,44,4435,0,0,0,0
Alliance_Tier1_Lumber2,3927,333,55,63,72,127,192,255,4436,0,0,0,0
Alliance_Tier1_Trading2,3928,333,37,40,308,345,94,134,4437,0,0,0,0
Alliance_Tier1_Fishing,3929,333,36,30,207,243,217,247,4438,0,0,0,0
Alliance_Tier1_Barn1,3930,333,50,48,207,257,167,215,4439,0,0,0,0
Alliance_Tier1_Inn2,3931,333,43,47,261,304,103,150,4440,0,0,0,0
Alliance_Tier1_Arena1,3932,333,45,52,261,306,49,101,4441,0,0,0,0
Alliance_Tier2_Arena1,3933,554,58,58,390,448,74,132,4442,0,0,0,0
Alliance_Tier2_Arena2,3934,554,60,50,1,61,205,255,4443,0,0,0,0
Alliance_Tier2_Armory1,3935,554,84,99,1,85,1,100,4444,0,0,0,0
Alliance_Tier2_Armory2,3936,554,80,101,1,81,102,203,4445,0,0,0,0
Alliance_Tier2_Barn1,3937,554,48,48,331,379,137,185,4446,0,0,0,0
Alliance_Tier2_Barn2,3938,554,44,37,465,509,1,38,4447,0,0,0,0
Alliance_Tier2_Barracks1,3939,554,70,74,259,329,1,75,4448,0,0,0,0
Alliance_Tier2_Inn1,3940,554,63,63,259,322,77,140,4449,0,0,0,0
Alliance_Tier2_Inn2,3941,554,69,56,259,328,142,198,4450,0,0,0,0
Alliance_Tier2_Lumber1,3942,554,59,61,404,463,1,62,4451,0,0,0,0
Alliance_Tier2_Lumber2,3943,554,59,47,450,509,74,121,4455,0,0,0,0
Alliance_Tier2_Mage1,3944,554,72,75,175,247,158,233,4456,0,0,0,0
Alliance_Tier2_Mage2,3945,554,71,71,331,402,1,72,4457,0,0,0,0
Alliance_Tier2_Stables1,3946,554,73,76,87,160,178,254,4458,0,0,0,0
Alliance_Tier2_Stables2,3947,554,82,78,175,257,1,79,4459,0,0,0,0
Alliance_Tier2_Trading1,3948,554,57,61,331,388,74,135,4460,0,0,0,0
Alliance_Tier2_Trading2,3949,554,54,55,259,313,200,255,4461,0,0,0,0
Alliance_Tier3_Barn1,3950,555,62,67,177,239,296,363,4462,0,0,0,0
Alliance_Tier3_Lumber1,3951,555,66,67,103,169,322,389,4463,0,0,0,0
Alliance_Tier3_Mage2,3952,555,70,71,103,173,174,245,4464,0,0,0,0
Alliance_Tier3_Inn1,3953,555,74,74,1,75,392,466,4465,0,0,0,0
Alliance_Tier3_Barracks1,3954,555,92,90,221,313,1,91,4466,0,0,0,0
Alliance_Tier3_Armory2,3955,555,76,96,1,77,294,390,4467,0,0,0,0
Alliance_Tier3_Mage1,3956,555,72,75,103,175,97,172,4468,0,0,0,0
Alliance_Tier3_Lumber2,3957,555,66,54,103,169,456,510,4469,0,0,0,0
Alliance_Tier3_Inn2,3958,555,70,63,103,173,391,454,4470,0,0,0,0
Alliance_Tier3_Stables1,3959,555,117,94,1,118,1,95,4471,0,0,0,0
Alliance_Tier3_Trading2,3960,555,56,63,244,300,159,222,4472,0,0,0,0
Alliance_Tier3_Arena1,3961,555,66,73,103,169,247,320,4473,0,0,0,0
Alliance_Tier3_Trading1,3962,555,65,66,177,242,159,225,4474,0,0,0,0
Alliance_Tier3_Stables2,3963,555,99,92,120,219,1,93,4475,0,0,0,0
Alliance_Tier3_Barn2,3964,555,63,67,177,240,227,294,4476,0,0,0,0
Alliance_Tier3_Armory1,3965,555,83,95,1,84,197,292,4477,0,0,0,0
Alliance_Tier3_Arena2,3966,555,72,60,177,249,97,157,4478,0,0,0,0
Alliance_Tier1_Barracks2,3967,333,51,52,207,258,113,165,4479,0,0,0,0
Alliance_Tier2_Barracks2,3968,554,73,75,175,248,81,156,4480,0,0,0,0
Alliance_Tier3_Barracks2,3969,555,100,98,1,101,97,195,4481,0,0,0,0
Alliance_Tier1_Workshop1,3970,333,66,54,139,205,1,55,4482,0,0,0,0
Alliance_Tier1_Workshop2,3971,333,65,65,72,137,1,66,4483,0,0,0,0
Alliance_Tier2_Workshop1,3972,554,81,84,87,168,92,176,4484,0,0,0,0
Alliance_Tier2_Workshop2,3973,554,86,89,87,173,1,90,4485,0,0,0,0
Alliance_Tier3_Workshop1,3974,555,81,78,401,482,1,79,4486,0,0,0,0
Alliance_Tier3_Workshop2,3975,555,84,87,315,399,1,88,4487,0,0,0,0
streamcinematic-lk-down,3976,557,176,78,1,177,161,239,4488,0,0,0,0
streamcinematic-lk-up,3977,557,176,78,535,711,241,319,4489,0,0,0,0
streamcinematic-wod-down,3978,557,176,78,357,533,321,399,4490,0,0,0,0
streamcinematic-wod-up,3979,557,176,78,535,711,1,79,4491,0,0,0,0
streamcinematic-bc-down,3980,557,176,78,357,533,161,239,4492,0,0,0,0
streamcinematic-bc-up,3981,557,176,78,179,355,81,159,4493,0,0,0,0
streamcinematic-cc-down,3982,557,176,78,1,177,1,79,4494,0,0,0,0
streamcinematic-cc-up,3983,557,176,78,179,355,241,319,4495,0,0,0,0
streamcinematic-classic-down,3984,557,176,78,713,889,161,239,4496,0,0,0,0
streamcinematic-classic-up,3985,557,176,78,179,355,1,79,4497,0,0,0,0
streamcinematic-downloadicon,3986,557,43,43,936,979,1,44,4535,0,0,0,0
streamcinematic-highlight,3987,557,78,176,1,79,241,417,4536,0,0,0,0
streamcinematic-playbutton,3988,557,43,43,891,934,1,44,4537,0,0,0,0
streamcinematic-progressbarbg,3989,557,10,4,891,901,46,50,4562,0,0,0,0
streamcinematic-mop-down,3995,557,176,78,179,355,161,239,4563,0,0,0,0
streamcinematic-mop-up,3996,557,176,78,357,533,1,79,4564,0,0,0,0
accountupgradebanner-bc,3997,558,198,99,405,603,120,219,4565,0,0,0,0
accountupgradebanner-cataclysm,3998,558,200,140,1,201,1,141,4566,0,0,0,0
accountupgradebanner-classic,3999,558,200,100,203,403,409,509,4567,0,0,0,0
accountupgradebanner-mop,4000,558,200,117,607,807,1,118,4568,0,0,0,0
accountupgradebanner-wod,4001,558,200,117,809,1009,1,118,4569,0,0,0,0
accountupgradebanner-wotlk,4002,558,200,140,1,201,143,283,4570,0,0,0,0
MissionFX-Smoke,4004,152,80,80,943,1023,157,237,3790,0,0,0,0
MissionFX-SparkLines,4005,152,120,120,845,965,313,433,3815,0,0,0,0
Horde_Tier1_Arena1,4140,276,45,51,190,235,199,250,4571,0,0,0,0
Horde_Tier1_Arena2,4141,276,43,45,250,293,1,46,4572,0,0,0,0
Horde_Tier1_Armory1,4142,276,57,57,70,127,124,181,4573,0,0,0,0
Horde_Tier1_Armory2,4143,276,56,55,132,188,1,56,4290,0,0,0,0
Horde_Tier1_Barn1,4144,276,51,51,132,183,112,163,4291,0,0,0,0
Horde_Tier1_Barn2,4145,276,53,46,190,243,51,97,4292,0,0,0,0
Horde_Tier1_Barracks1,4146,276,65,70,1,66,73,143,4293,0,0,0,0
Horde_Tier1_Barracks2,4147,276,67,70,1,68,1,71,4294,0,0,0,0
Horde_Tier1_Farm1,4148,276,58,48,190,248,1,49,4295,0,0,0,0
Horde_Tier1_Fishing1,4149,276,42,44,250,292,48,92,4296,0,0,0,0
Horde_Tier1_Inn1,4150,276,50,48,190,240,99,147,4297,0,0,0,0
Horde_Tier1_Inn2,4151,276,50,48,190,240,149,197,4298,0,0,0,0
Horde_Tier1_Lumber1,4152,276,45,43,1,46,210,253,4299,0,0,0,0
Horde_Tier1_Lumber2,4153,276,37,48,250,287,183,231,4300,0,0,0,0
Horde_Tier1_Mage1,4154,276,51,50,132,183,165,215,4301,0,0,0,0
Horde_Tier1_Mage2,4155,276,52,52,132,184,58,110,4302,0,0,0,0
Horde_Tier1_Mine1,4156,276,52,36,132,184,217,253,4303,0,0,0,0
Horde_Tier1_Profession1,4157,276,40,38,337,377,1,39,4304,0,0,0,0
Horde_Tier1_Profession2,4158,276,42,43,250,292,138,181,4305,0,0,0,0
Horde_Tier1_Profession3,4159,276,43,42,250,293,94,136,4306,0,0,0,0
Horde_Tier1_Stables1,4160,276,57,55,70,127,183,238,4307,0,0,0,0
Horde_Tier1_Stables2,4161,276,62,63,1,63,145,208,4308,0,0,0,0
Horde_Tier1_Trading1,4162,276,37,37,379,416,1,38,4309,0,0,0,0
Horde_Tier1_Trading2,4163,276,40,39,295,335,1,40,4310,0,0,0,0
Horde_Tier1_Workshop1,4164,276,60,60,70,130,1,61,4311,0,0,0,0
Horde_Tier1_Workshop2,4165,276,56,59,70,126,63,122,4312,0,0,0,0
Horde_Tier2_Arena1,4166,560,59,55,288,347,61,116,4232,0,0,0,0
Horde_Tier2_Arena2,4167,560,54,55,231,285,131,186,4234,0,0,0,0
Horde_Tier2_Armory1,4168,560,64,68,89,153,148,216,4241,0,0,0,0
Horde_Tier2_Armory2,4169,560,65,61,164,229,1,62,4210,0,0,0,0
Horde_Tier2_Barn1,4170,560,59,58,350,409,1,59,4211,0,0,0,0
Horde_Tier2_Barn2,4171,560,53,45,288,341,170,215,4224,0,0,0,0
Horde_Tier2_Barracks1,4172,560,61,60,164,225,64,124,4225,0,0,0,0
Horde_Tier2_Barracks2,4173,560,61,60,164,225,126,186,4226,0,0,0,0
Horde_Tier2_Inn1,4174,560,60,57,411,471,1,58,4227,0,0,0,0
Horde_Tier2_Inn2,4175,560,60,58,288,348,1,59,4228,0,0,0,0
Horde_Tier2_Lumber1,4176,560,55,66,231,286,1,67,4229,0,0,0,0
Horde_Tier2_Lumber2,4177,560,54,60,231,285,69,129,4230,0,0,0,0
Horde_Tier2_Mage1,4178,560,76,76,1,77,167,243,4231,0,0,0,0
Horde_Tier2_Mage2,4179,560,73,74,89,162,1,75,4313,0,0,0,0
Horde_Tier2_Stables1,4180,560,62,59,164,226,188,247,4314,0,0,0,0
Horde_Tier2_Stables2,4181,560,65,69,89,154,77,146,4315,0,0,0,0
Horde_Tier2_Trading1,4182,560,54,52,231,285,188,240,4316,0,0,0,0
Horde_Tier2_Trading2,4183,560,54,50,288,342,118,168,4317,0,0,0,0
Horde_Tier2_Workshop1,4184,560,79,77,1,80,88,165,4318,0,0,0,0
Horde_Tier2_Workshop2,4185,560,86,85,1,87,1,86,4319,0,0,0,0
Horde_Tier3_Arena1,4186,561,70,65,244,314,1,66,4320,0,0,0,0
Horde_Tier3_Arena2,4187,561,55,69,377,432,68,137,4321,0,0,0,0
Horde_Tier3_Armory1,4188,561,65,71,165,230,157,228,4322,0,0,0,0
Horde_Tier3_Armory2,4189,561,65,63,310,375,68,131,4323,0,0,0,0
Horde_Tier3_Barn1,4190,561,64,65,244,308,68,133,4324,0,0,0,0
Horde_Tier3_Barn2,4191,561,72,50,434,506,68,118,4325,0,0,0,0
Horde_Tier3_Barracks1,4192,561,76,88,1,77,86,174,4326,0,0,0,0
Horde_Tier3_Barracks2,4193,561,82,76,1,83,176,252,4327,0,0,0,0
Horde_Tier3_Inn1,4194,561,70,65,316,386,1,66,4328,0,0,0,0
Horde_Tier3_Inn2,4195,561,60,67,244,304,135,202,4329,0,0,0,0
Horde_Tier3_Lumber1,4196,561,68,62,388,456,1,63,4330,0,0,0,0
Horde_Tier3_Lumber2,4197,561,59,51,244,303,204,255,4331,0,0,0,0
Horde_Tier3_Mage1,4198,561,76,75,87,163,174,249,4332,0,0,0,0
Horde_Tier3_Mage2,4199,561,73,73,165,238,82,155,4333,0,0,0,0
Horde_Tier3_Stables1,4200,561,77,79,165,242,1,80,4334,0,0,0,0
Horde_Tier3_Stables2,4201,561,76,83,87,163,89,172,4335,0,0,0,0
Horde_Tier3_Trading1,4202,561,66,54,377,443,139,193,4336,0,0,0,0
Horde_Tier3_Trading2,4203,561,63,63,310,373,133,196,4337,0,0,0,0
Horde_Tier3_Workshop1,4204,561,76,86,87,163,1,87,4338,0,0,0,0
Horde_Tier3_Workshop2,4205,561,84,83,1,85,1,84,4339,0,0,0,0
GarrMission_TabGlow,4206,152,189,42,811,1000,523,565,4340,0,0,0,0
Garr_Plot_Frostfire_H_3,4207,562,108,70,1,109,1,71,4341,0,0,0,0
Garr_Plot_Frostfire_H_2,4208,562,108,70,111,219,1,71,4342,0,0,0,0
Garr_Plot_Frostfire_H_1,4209,562,108,70,1,109,73,143,4343,0,0,0,0
Garr_Plot_Frostfire_H_4,4210,562,108,70,111,219,73,143,4344,0,0,0,0
BonusChest-GreenGlow-Wide,4211,152,244,64,668,912,702,766,3816,0,0,0,0
GarrMission_PortraitRing_iLvlBorder,4213,152,70,24,789,859,287,311,3817,0,0,0,0
bags-icon-consumables,4214,202,50,50,93,143,162,212,4345,0,0,0,0
bags-icon-equipment,4215,202,50,50,157,207,46,96,4346,0,0,0,0
bags-icon-tradegoods,4216,202,50,50,209,259,98,148,4347,0,0,0,0
search-highlight,4223,565,126,27,1,127,79,106,4351,0,0,0,0
search-select,4224,565,126,27,259,385,30,57,4352,0,0,0,0
_search-rowbg,4225,565,64,27,0,64,1,28,4353,0,0,4,0
GarrMission_EncounterAbilityBorder-Lg,4226,152,46,46,317,363,900,946,4348,0,0,0,0
GarrMission_EncounterBar-Elite,4227,152,75,67,943,1018,239,306,4349,0,0,0,0
GarrMission_RewardsBox_Shadow,4228,152,345,50,433,778,576,626,4350,0,0,0,0
GarrMission_MissionCompleteChanceBg,4229,152,282,95,505,787,157,252,4354,0,0,0,0
GarrMission_CurrentEncounter-Glow,4231,152,70,70,902,972,628,698,4356,0,0,0,0
GarrMission_CurrentEncounter-SpikeyGlow,4232,152,152,120,691,843,313,433,4357,0,0,0,0
_GarrMissionLocation-Gorgrond-Mid,4236,396,1024,285,0,1024,575,860,4360,0,0,4,0
garrmissionlocation-frostfireridge-list,4237,566,792,78,1,793,1,79,4358,0,0,0,0
garrmissionlocation-gorgrond-list,4238,566,792,78,1,793,81,159,4359,0,0,0,0
garrmissionlocation-nagrand-list,4239,566,792,78,1,793,161,239,4361,0,0,0,0
garrmissionlocation-shadowmoonvalley-list,4240,566,792,78,1,793,241,319,4362,0,0,0,0
garrmissionlocation-spiresofarak-list,4241,566,792,78,1,793,321,399,4363,0,0,0,0
garrmissionlocation-talador-list,4242,566,792,78,1,793,401,479,4364,0,0,0,0
garrmissionlocation-tannanjungle-list,4243,566,792,78,1,793,481,559,4365,0,0,0,0
groupfinder-icon-class-deathknight,4244,236,29,29,293,322,931,960,4355,0,0,0,0
groupfinder-icon-class-druid,4245,236,29,29,2006,2035,1,30,4366,0,0,0,0
groupfinder-icon-class-hunter,4246,236,29,29,2006,2035,32,61,4367,0,0,0,0
groupfinder-icon-class-mage,4247,236,29,29,2006,2035,63,92,4368,0,0,0,0
groupfinder-icon-class-monk,4248,236,29,29,2006,2035,99,128,4369,0,0,0,0
groupfinder-icon-class-paladin,4249,236,29,29,2006,2035,130,159,4656,0,0,0,0
groupfinder-icon-class-priest,4250,236,29,29,2006,2035,161,190,4657,0,0,0,0
groupfinder-icon-class-rogue,4251,236,29,29,2006,2035,197,226,4658,0,0,0,0
groupfinder-icon-class-shaman,4252,236,29,29,2006,2035,228,257,4659,0,0,0,0
groupfinder-icon-class-warlock,4253,236,29,29,2006,2035,259,288,4660,0,0,0,0
groupfinder-icon-class-warrior,4254,236,29,29,1963,1992,295,324,4661,0,0,0,0
groupfinder-icon-emptyslot,4255,236,29,29,1994,2023,295,324,4662,0,0,0,0
groupfinder-icon-quest,4256,236,14,14,37,51,1007,1021,4663,0,0,0,0
groupfinder-icon-role-large-dps,4257,236,29,29,1963,1992,333,362,4664,0,0,0,0
groupfinder-icon-role-large-heal,4258,236,29,29,1994,2023,333,362,4665,0,0,0,0
groupfinder-icon-role-large-tank,4259,236,29,29,1805,1834,393,422,4666,0,0,0,0
_GarrMissionLocation-BlackrockMountain-Back,4264,568,1024,285,0,1024,1,286,4574,0,0,4,0
_GarrMissionLocation-BlackrockMountain-Fore,4265,568,1024,285,0,1024,288,573,4575,0,0,4,0
_GarrMissionLocation-BlackrockMountain-Mid,4266,568,1024,285,0,1024,575,860,4576,0,0,4,0
garrlanding-tab-bottom-selected,4268,268,71,42,1794,1865,1,43,4615,0,0,0,0
garrlanding-tab-bottom-unselected,4269,268,71,42,1867,1938,1,43,4616,0,0,0,0
garrlanding-tab-bottom-highlight,4270,268,71,42,177,248,456,498,4617,0,0,0,0
challenges-timerborder,4271,569,184,23,1,185,411,434,4198,0,0,0,0
challenges-blackfade,4272,569,333,61,397,730,221,282,4199,0,0,0,0
challenges-timerbg,4273,569,243,59,732,975,221,280,4204,0,0,0,0
challenges-bannershine,4274,569,222,106,397,619,113,219,4205,0,0,0,0
challenges-toast,4276,569,311,78,649,960,1,79,4206,0,0,0,0
Banner-BgFiligree,4277,570,249,31,1,250,293,324,4209,0,0,0,0
Banner-FiligreeShadow,4278,570,382,35,1,383,256,291,4223,0,0,0,0
Banner-SmallFiligree,4279,570,61,19,429,490,1,20,4233,0,0,0,0
ScenariosIcon,4280,570,48,47,379,427,1,48,4242,0,0,0,0
ScenarioTrackerToast-FinalFiligree,4281,570,235,69,246,481,177,246,4736,0,0,0,0
ScenarioTrackerToast,4282,570,243,77,1,244,177,254,4737,0,0,0,0
Toast-Flash,4283,570,327,94,1,328,1,95,4738,0,0,0,0
Toast-Frame,4284,570,311,78,1,312,97,175,4739,0,0,0,0
Toast-IconBG,4285,570,47,52,330,377,1,53,4740,0,0,0,0
challenges-nomedal,4287,569,9,10,1,10,499,509,4741,0,0,0,0
Bonus-ToastBanner,4288,570,36,44,379,415,50,94,4742,0,0,0,0
groupfinder-button-ashran,4289,236,290,36,1,291,551,587,4670,0,0,0,0
groupfinder-background-arenas,4290,236,333,96,331,664,1,97,4671,0,0,0,0
groupfinder-background-ashran,4291,236,333,96,666,999,1,97,4672,0,0,0,0
groupfinder-background-battlegrounds,4292,236,333,96,1001,1334,1,97,4673,0,0,0,0
groupfinder-background-custom-pve,4293,236,333,96,1336,1669,1,97,4674,0,0,0,0
groupfinder-background-custom-pvp,4294,236,333,96,1671,2004,1,97,4675,0,0,0,0
groupfinder-background-dungeons,4295,236,333,96,666,999,99,195,4676,0,0,0,0
groupfinder-background-questing,4296,236,333,96,1336,1669,99,195,4677,0,0,0,0
groupfinder-background-ratedbgs,4302,236,333,96,1671,2004,197,293,4683,0,0,0,0
groupfinder-background-scenarios,4303,236,333,96,331,664,295,391,4684,0,0,0,0
groupfinder-background-skirmishes,4304,236,333,96,666,999,295,391,4685,0,0,0,0
groupfinder-background-raids-warlords,4305,236,333,96,1336,1669,197,293,4686,0,0,0,0
groupfinder-button-raids-warlords,4306,236,290,36,1671,1961,295,331,4687,0,0,0,0
garrlanding-tab-bottom-selected-right,4307,268,24,42,1946,1970,104,146,4809,0,0,0,0
garrlanding-tab-bottom-unselected-left,4308,268,24,42,1972,1996,60,102,4810,0,0,0,0
garrlanding-tab-bottom-selected-left,4309,268,24,42,1946,1970,60,102,4811,0,0,0,0
garrlanding-tab-bottom-highlight-right,4310,268,24,42,2021,2045,1,43,4812,0,0,0,0
garrlanding-tab-bottom-highlight-left,4311,268,24,42,1995,2019,1,43,4813,0,0,0,0
garrlanding-tab-bottom-unselected-right,4312,268,24,42,1972,1996,104,146,4814,0,0,0,0
collections-watermark-toy,4313,203,109,110,93,202,362,472,4578,0,0,0,0
CacheToast-Glow,4315,573,286,109,1,287,1,110,4696,0,0,0,0
CacheToast,4316,573,276,96,1,277,112,208,4697,0,0,0,0
npe_exclamationpoint,4321,575,32,32,2009,2041,1,33,4698,0,0,0,0
npe_icon,4322,575,64,64,1573,1637,261,325,4699,0,0,0,0
npe_leftclick,4323,575,32,32,2009,2041,35,67,4700,0,0,0,0
npe_rightclick,4324,575,32,32,2009,2041,69,101,4701,0,0,0,0
npe_turnin,4325,575,20,20,2009,2029,103,123,4702,0,0,0,0
npe_arrowdownglow,4326,575,64,64,1111,1175,261,325,4703,0,0,0,0
npe_arrowupglow,4327,575,64,64,1507,1571,261,325,4704,0,0,0,0
npe_arrowup,4328,575,64,64,1441,1505,261,325,4705,0,0,0,0
npe_arrowdown,4329,575,64,64,1045,1109,261,325,4706,0,0,0,0
npe_arrowrightglow,4330,575,64,64,1375,1439,261,325,4707,0,0,0,0
npe_keyboard,4331,575,912,354,1,913,341,695,4708,0,0,0,0
npe_arrowright,4332,575,64,64,1309,1373,261,325,4709,0,0,0,0
npe_arrowleftglow,4333,575,64,64,1243,1307,261,325,4710,0,0,0,0
npe_arrowleft,4334,575,64,64,1177,1241,261,325,4711,0,0,0,0
UI-Minimap-Clock,4340,579,55,28,1,56,1,29,4621,0,0,0,0
garrlanding-tradeskilltimer-border,4343,268,64,64,816,880,346,410,4618,0,0,0,0
barbershop-background,4344,580,266,348,274,540,1,349,4743,0,0,0,0
groupfinder-waitdot,4349,236,19,18,303,322,360,378,4712,0,0,0,0
OBJFX-BarGlow,4353,197,339,37,1,340,177,214,4619,0,0,0,0
deathrecap-icon-tombstone,4366,586,15,20,337,352,1,21,4580,0,0,0,0
collections-watermark-heirloom,4367,203,90,92,1,91,213,305,4769,0,0,0,0
Crop-Corner,4368,587,10,10,123,133,181,191,4713,0,0,0,0
Crop-Side,4369,587,10,10,123,133,202,212,4714,0,0,0,0
Crop-Top,4370,587,10,10,123,133,214,224,4715,0,0,0,0
WoWShare-AchievementIcon,4371,587,32,32,89,121,168,200,4716,0,0,0,0
WoWShare-AddButton-Down,4372,587,42,43,1,43,168,211,4717,0,0,0,0
WoWShare-AddButton-Up,4373,587,42,43,45,87,168,211,4718,0,0,0,0
WoWShare-ChatIcon,4374,587,23,18,89,112,236,254,4719,0,0,0,0
WoWShare-Highlight,4375,587,38,39,1,39,213,252,4720,0,0,0,0
WoWShare-ItemQualityBorder,4376,587,32,32,144,176,1,33,4721,0,0,0,0
WoWShare-Plus,4377,587,32,32,178,210,1,33,4722,0,0,0,0
WoWShare-Selection,4378,587,38,39,45,83,213,252,4723,0,0,0,0
WoWShare-ItemIcon,4381,587,32,32,89,121,202,234,4724,0,0,0,0
WoWShare-ScreenshotIcon,4382,587,32,32,212,244,1,33,4725,0,0,0,0
token-button-category,4383,590,156,20,631,787,235,255,4620,0,0,0,0
token-itemslot,4385,590,251,56,631,882,177,233,4622,0,0,0,0
token-choice-bnet,4390,590,174,174,631,805,1,175,4744,0,0,0,0
token-choice-wow,4391,590,108,108,807,915,1,109,4745,0,0,0,0
WoWShare-EdgeArt,4392,587,141,165,1,142,1,166,4815,0,0,0,0
UI-DialogBox-goldbutton-down-right-blue,4399,593,32,32,133,165,1,33,4816,0,0,0,0
UI-DialogBox-goldbutton-down-left-blue,4400,593,64,32,1,65,1,33,4817,0,0,0,0
UI-DialogBox-goldbutton-up-middle-blue,4401,593,64,32,1,65,35,67,4818,0,0,0,0
UI-DialogBox-goldbutton-up-right-blue,4402,593,32,32,167,199,1,33,4819,0,0,0,0
UI-DialogBox-goldbutton-up-left-blue,4403,593,64,32,1,65,69,101,4820,0,0,0,0
UI-DialogBox-goldbutton-down-middle-blue,4404,593,64,32,67,131,1,33,4821,0,0,0,0
BossBanner-BottomFillagree,4406,594,66,28,443,509,161,189,4746,0,0,0,0
BossBanner-SkullCircle,4407,594,44,44,443,487,69,113,4747,0,0,0,0
BossBanner-TopFillagree,4408,594,176,74,125,301,295,369,4748,0,0,0,0
BossBanner-RedFlash,4409,594,92,92,1,93,415,507,4732,0,0,0,0
BossBanner-LeftFillagree,4410,594,72,40,303,375,295,335,4726,0,0,0,0
BossBanner-RightFillagree,4411,594,72,40,377,449,295,335,4727,0,0,0,0
BossBanner-SkullSpikes,4412,594,50,66,443,493,1,67,4728,0,0,0,0
deathrecap-iconborder,4413,586,36,36,299,335,1,37,4688,0,0,0,0
deathrecap-background-innerglow,4414,586,296,254,1,297,1,255,4579,0,0,0,0
!GeneralFrame-InsetFrame-Left,4415,595,8,32,1,9,0,32,4623,0,0,2,0
!GeneralFrame-InsetFrame-Right,4416,595,8,32,11,19,0,32,4624,0,0,2,0
GeneralFrame-HorizontalBar-Left,4417,595,10,19,21,31,1,20,4625,0,0,0,0
GeneralFrame-HorizontalBar-Right,4418,595,10,19,33,43,1,20,4626,0,0,0,0
GeneralFrame-InsetFrame-BottomLeft,4419,595,8,8,21,29,22,30,4627,0,0,0,0
GeneralFrame-InsetFrame-BottomRight,4420,595,8,8,33,41,22,30,4628,0,0,0,0
GeneralFrame-InsetFrame-TopLeft,4421,595,8,8,45,53,1,9,4629,0,0,0,0
GeneralFrame-InsetFrame-TopRight,4422,595,8,8,55,63,1,9,4630,0,0,0,0
_GeneralFrame-HorizontalBar,4423,596,64,8,0,64,1,9,4631,0,0,4,0
_GeneralFrame-InsetFrame-Bottom,4424,596,32,8,0,32,11,19,4632,0,0,4,0
_GeneralFrame-InsetFrame-Top,4425,596,32,8,0,32,21,29,4633,0,0,4,0
collections-upgradeglow,4427,203,100,100,256,356,102,202,4689,0,0,0,0
XPBarAnim-OrangeGain,4429,599,64,8,40,104,21,29,4822,0,0,0,0
XPBarAnim-OrangeSpark,4430,599,32,32,1,33,29,61,4823,0,0,0,0
XPBarAnim-OrangeTrail,4431,599,64,8,40,104,1,9,4824,0,0,0,0
XPBarAnim-OrangeGlow,4432,599,64,8,40,104,11,19,4825,0,0,0,0
XPBarAnim-GlowLines,4433,599,37,26,1,38,1,27,4826,0,0,0,0
collections-upgradeglow-blue,4434,203,100,100,358,458,102,202,4634,0,0,0,0
splash-610-botleft,4435,600,137,371,374,511,587,958,4635,0,0,0,0
splash-610-right,4436,600,510,584,1,511,1,585,4636,0,0,0,0
splash-610-topleft,4437,600,371,434,1,372,587,1021,4637,0,0,0,0
Garr_MissionToast-Blank,4438,150,272,59,1,273,253,312,4638,0,0,0,0
colorblind-bar-green,4439,601,108,17,1,109,151,168,4749,0,0,0,0
colorblind-bar-red,4440,601,108,17,111,219,151,168,4750,0,0,0,0
colorblind-bar-yellow,4441,601,108,17,1,109,170,187,4751,0,0,0,0
colorblind-colorwheel,4442,601,148,148,1,149,1,149,4752,0,0,0,0
GarrMission_MissionTooltipAway,4443,156,15,15,258,273,249,264,4729,0,0,0,0
GarrMission_MissionTooltipWorking,4444,156,15,15,486,501,299,314,4730,0,0,0,0
GarrMission_CounterHalfCheck,4446,152,25,22,532,557,289,311,4639,0,0,0,0
TalkingHeads-Glow-TopSpike,4448,604,46,30,826,872,183,213,4690,0,0,0,0
TalkingHeads-PortraitBg,4449,604,115,115,573,688,315,430,4691,0,0,0,0
TalkingHeads-TextBackground,4450,604,570,155,1,571,1,156,4692,0,0,0,0
TalkingHeads-Alliance-PortraitFrame,4451,604,143,143,573,716,1,144,7471,0,0,0,0
TalkingHeads-Glow-TopBarGlow,4452,604,81,23,826,907,158,181,4694,0,0,0,0
TalkingHeads-Glow-SideBarGlow,4453,604,23,86,690,713,315,401,4695,0,0,0,0
TalkingHeads-Glow-Sheen,4454,604,262,34,573,835,231,265,4770,0,0,0,0
TalkingHeads-Glow-TextSheen,4455,604,251,71,573,824,158,229,4771,0,0,0,0
GarrMission-AbilityHighlight,4456,156,58,58,155,213,639,697,4731,0,0,0,0
token-info-background,4458,590,628,510,1,629,1,511,4733,0,0,0,0
WoWShare-TwitterLogo,4459,587,14,11,123,137,168,179,4581,0,0,0,0
token-info-arrow,4477,590,32,21,807,839,111,132,4640,0,0,0,0
adventureguide-pane-large,4481,609,335,337,1,336,164,501,4734,0,0,0,0
adventureguide-ring,4482,609,94,95,397,491,1,96,4735,0,0,0,0
BossBanner-BgBanner-Bottom,4483,594,440,112,1,441,1,113,4834,0,0,0,0
BossBanner-BgBanner-Top,4484,594,440,112,1,441,115,227,4837,0,0,0,0
LootBanner-IconGlow,4485,594,40,40,443,483,229,269,4838,0,0,0,0
LootBanner-ItemBg,4486,594,269,41,125,394,371,412,4839,0,0,0,0
LootBanner-LootBagCircle,4487,594,44,44,443,487,115,159,4840,0,0,0,0
BossBanner-BgBanner-Mid,4488,594,440,64,1,441,229,293,4841,0,0,0,0
loottoast-lessawesome,4489,332,276,80,279,555,218,298,4641,0,0,0,0
transmog-frame-pink,4494,610,44,43,105,149,239,282,4842,0,0,0,0
transmog-frame-red,4495,610,44,43,151,195,239,282,4843,0,0,0,0
transmog-frame-selected,4496,610,62,62,381,443,1,63,4844,0,0,0,0
transmog-frame,4497,610,58,57,445,503,1,58,4845,0,0,0,0
transmog-icon-chat,4498,610,13,13,428,441,65,78,4846,0,0,0,0
transmog-icon-checkmark,4499,610,28,26,363,391,154,180,4847,0,0,0,0
transmog-icon-remove,4500,610,26,26,393,419,154,180,4848,0,0,0,0
transmog-icon-revert-small-disabled,4501,610,25,24,142,167,487,511,4849,0,0,0,0
transmog-icon-revert-small,4502,610,25,24,105,130,487,511,4850,0,0,0,0
transmog-icon-revert,4503,610,32,32,298,330,154,186,4582,0,0,0,0
transmog-wardrobe-border-collected,4504,610,96,122,1,97,245,367,4583,0,0,0,0
transmog-wardrobe-border-highlighted,4505,610,84,110,295,379,1,111,4584,0,0,0,0
transmog-wardrobe-border-selected,4506,610,102,128,1,103,115,243,4585,0,0,0,0
transmog-wardrobe-border-uncollected,4507,610,96,122,1,97,369,491,4586,0,0,0,0
adventureguide-pane-small,4509,609,344,161,1,345,1,162,4753,0,0,0,0
NavalMap01,4522,612,934,630,1,935,1,631,4599,0,0,0,0
!ShipMission_Bg-Edge,4524,154,46,256,186,232,0,256,4754,0,0,2,0
!ShipMission_RewardsBorder-Left-Desaturate,4525,154,30,64,298,328,0,64,4755,0,0,2,0
!GarrMission_Bg-DarkEdge,4526,614,334,256,1,335,0,256,4756,0,0,2,0
!ShipMission_Bg-DarkEdge,4527,614,334,256,337,671,0,256,4757,0,0,2,0
_ShipMission_Bg-BottomEdge,4528,153,256,251,0,256,254,505,4758,0,0,4,0
_ShipMission_Bg-BottomEdgeSmall,4529,153,256,42,0,256,551,593,4759,0,0,4,0
_ShipMission_LocationCover-Bottom,4530,153,256,38,0,256,678,716,4760,0,0,4,0
_ShipMission_RewardsBorder-Top-Desaturate,4531,153,64,25,0,64,807,832,4761,0,0,4,0
_ShipMission_TopBorder,4532,153,32,10,0,32,890,900,4762,0,0,4,0
ShipMission_FollowerListButton-Highlight,4533,156,255,80,1,256,200,280,4763,0,0,0,0
ShipMission_FollowerListButton-Select,4534,156,255,80,218,473,864,944,4764,0,0,0,0
ShipMission_FollowerListButton,4535,156,255,80,248,503,572,652,4765,0,0,0,0
ShipMission_IconLevelBG,4536,156,91,65,155,246,572,637,4766,0,0,0,0
ShipMission_TopBorderCorner,4537,156,26,33,476,502,235,268,4767,0,0,0,0
ShipMission_Bg-DarkEdgeCorner,4538,152,46,256,317,363,642,898,3846,0,0,0,0
ShipMission_BoatRarity-Epic,4539,152,27,20,559,586,289,309,3847,0,0,0,0
ShipMission_BoatRarity-Rare,4540,152,27,20,588,615,289,309,3848,0,0,0,0
ShipMission_BoatRarity-Uncommon,4541,152,27,20,617,644,289,309,3850,0,0,0,0
ShipMission_DangerousSkull,4542,152,17,18,763,780,254,272,3854,0,0,0,0
ShipMission_EncounterAbilityBorder-Lg,4543,152,46,46,974,1020,628,674,3857,0,0,0,0
ShipMission_EncounterAbilityBorder,4544,152,32,32,759,791,435,467,4768,0,0,0,0
ShipMission_LocationCover-Side,4545,152,49,230,604,653,774,1004,4772,0,0,0,0
ShipMission_MissionCostStartButtonBg,4546,152,376,51,433,809,523,574,4773,0,0,0,0
ShipMission_RewardsBG-Desaturate,4547,152,502,154,1,503,157,311,4774,0,0,0,0
ShipMission_RewardsBorder-Corner-Desaturate,4548,152,64,64,826,890,811,875,4775,0,0,0,0
ShipMission_StartMissionFrame,4549,152,215,39,780,995,576,615,4776,0,0,0,0
ShipMissionParchment-Tile,4550,615,256,256,0,256,0,256,3858,0,0,6,0
_GarrMissionLocation-TannanSea-Back,4551,616,1024,285,0,1024,1,286,4777,0,0,4,0
_GarrMissionLocation-TannanSea-Fore,4552,616,1024,285,0,1024,288,573,4778,0,0,4,0
_GarrMissionLocation-TannanSea-Mid,4553,616,1024,285,0,1024,575,860,4779,0,0,4,0
ShipMission_CurrencyIcon-Oil,4554,157,57,57,60,117,60,117,4780,0,0,0,0
NavalMap-Horde-Fog,4557,612,496,361,1,497,633,994,4601,0,0,0,0
NavalMap-Horde-Highlight,4558,612,496,361,499,995,633,994,4602,0,0,0,0
NavalMap-Alliance-Fog,4559,618,449,351,1,450,1,352,4603,0,0,0,0
NavalMap-IronHorde-Fog,4560,618,454,353,1,455,354,707,4604,0,0,0,0
NavalMap-OpenWaters-Fog,4561,618,452,306,457,909,709,1015,4605,0,0,0,0
NavalMap-Alliance-Highlight,4562,618,449,351,452,901,1,352,4606,0,0,0,0
NavalMap-IronHorde-Highlight,4563,618,454,353,457,911,354,707,4607,0,0,0,0
NavalMap-OpenWaters-Highlight,4564,618,452,306,1,453,709,1015,4608,0,0,0,0
ShipMission_FollowerBG,4566,152,152,128,789,941,157,285,4781,0,0,0,0
ShipMission_FollowerBG-Glow,4567,156,152,128,1,153,572,700,4782,0,0,0,0
Ships_GalleonH-List,4568,620,154,80,1,155,131,211,4783,0,0,0,0
Ships_GalleonH-Portrait,4569,620,152,128,1,153,1,129,4784,0,0,0,0
Ships_GalleonH-Map,4582,621,83,72,1,84,1,73,4797,0,0,0,0
ShipMissionIcon-Combat-Map,4585,622,64,64,135,199,324,388,4798,0,0,0,0
ShipMissionIcon-Combat-MapBadge,4586,622,34,34,91,125,428,462,4785,0,0,0,0
ShipMissionIcon-Oil-Map,4587,622,64,64,201,265,258,322,4786,0,0,0,0
ShipMissionIcon-Oil-MapBadge,4588,622,34,34,135,169,456,490,4788,0,0,0,0
ShipMissionIcon-SiegeA-Map,4589,622,64,64,201,265,324,388,4789,0,0,0,0
ShipMissionIcon-SiegeA-MapBadge,4590,622,34,34,201,235,456,490,4791,0,0,0,0
ShipMissionIcon-SiegeH-Map,4591,622,64,64,201,265,390,454,4792,0,0,0,0
ShipMissionIcon-SiegeH-MapBadge,4592,622,34,34,465,499,258,292,4794,0,0,0,0
ShipMissionIcon-Training-Map,4593,622,64,64,399,463,258,322,4795,0,0,0,0
ShipMissionIcon-Training-MapBadge,4594,622,34,34,267,301,462,496,4799,0,0,0,0
ShipMissionIcon-Treasure-Map,4595,622,64,64,267,331,324,388,4800,0,0,0,0
ShipMissionIcon-Treasure-MapBadge,4596,622,34,34,333,367,324,358,4801,0,0,0,0
Ships_TroopTransport-List,4597,623,154,80,1,155,131,211,4802,0,0,0,0
Ships_TroopTransport-Portrait,4598,623,152,128,1,153,1,129,4803,0,0,0,0
Ships_TroopTransport-Map,4599,624,83,72,1,84,1,73,4804,0,0,0,0
Ships_EnemyTroopTransport-Portrait,4600,625,152,128,1,153,1,129,4805,0,0,0,0
Ships_Dreadnaught-List,4601,626,154,80,1,155,131,211,4806,0,0,0,0
Ships_Dreadnaught-Portrait,4602,626,152,128,1,153,1,129,4807,0,0,0,0
Ships_Dreadnaught-Map,4603,627,94,94,1,95,1,95,4609,0,0,0,0
Ships_EnemyDreadnaught-Portrait,4604,628,152,128,1,153,1,129,4587,0,0,0,0
Ships_SubmarineH-List,4605,629,154,80,1,155,131,211,4588,0,0,0,0
Ships_SubmarineH-Portrait,4606,629,152,128,1,153,1,129,4589,0,0,0,0
Ships_SubmarineH-Map,4607,630,83,72,1,84,1,73,4590,0,0,0,0
Ships_EnemySubmarineH-Portrait,4608,631,152,128,1,153,1,129,4591,0,0,0,0
Ships_SubmarineA-List,4609,632,154,80,1,155,131,211,4592,0,0,0,0
Ships_SubmarineA-Portrait,4610,632,152,128,1,153,1,129,4593,0,0,0,0
Ships_SubmarineA-Map,4611,633,83,72,1,84,1,73,4594,0,0,0,0
Ships_EnemySubmarineA-Portrait,4612,634,152,128,1,153,1,129,4595,0,0,0,0
ShipMissionIcon-Combat-Mission,4613,323,64,64,67,131,397,461,4808,0,0,0,0
ShipMissionIcon-Oil-Mission,4614,323,64,64,199,263,133,197,4787,0,0,0,0
ShipMissionIcon-SiegeA-Mission,4615,323,64,64,265,329,133,197,4790,0,0,0,0
ShipMissionIcon-SiegeH-Mission,4616,323,64,64,331,395,133,197,4793,0,0,0,0
ShipMissionIcon-Training-Mission,4617,323,64,64,133,197,265,329,4796,0,0,0,0
ShipMissionIcon-Treasure-Mission,4618,323,64,64,133,197,331,395,4596,0,0,0,0
Ships_EnemyGalleonH-Portrait,4619,635,152,128,1,153,1,129,4597,0,0,0,0
Ships_GalleonA-List,4620,636,154,80,1,155,131,211,4598,0,0,0,0
Ships_GalleonA-Portrait,4621,636,152,128,1,153,1,129,4600,0,0,0,0
Ships_GalleonA-Map,4622,637,83,72,1,84,1,73,4610,0,0,0,0
Ships_EnemyGalleonA-Portrait,4623,638,152,128,1,153,1,129,4611,0,0,0,0
Ships_CargoShip-List,4624,639,154,80,1,155,131,211,4612,0,0,0,0
Ships_CargoShip-Portrait,4625,639,152,128,1,153,1,129,4613,0,0,0,0
Ships_CargoShip-Map,4626,640,94,94,1,95,1,95,4614,0,0,0,0
Ships_EnemyCargoShip-Portrait,4627,641,152,128,1,153,1,129,4642,0,0,0,0
Ships_Carrier-List,4628,642,154,80,1,155,131,211,4643,0,0,0,0
Ships_Carrier-Portrait,4629,642,152,128,1,153,1,129,4644,0,0,0,0
Ships_Carrier-Map,4630,643,94,94,1,95,1,95,4645,0,0,0,0
Ships_EnemyCarrier-Portrait,4631,644,152,128,1,153,1,129,4646,0,0,0,0
ShipMission_ShipFollower-EquipmentBG,4632,156,78,78,1,79,782,860,4647,0,0,0,0
ShipMission_ShipFollower-EquipmentFrame,4633,156,78,78,401,479,326,404,4648,0,0,0,0
ShipMission_ShipFollower-Lock-Epic,4634,156,48,61,1,49,862,923,4649,0,0,0,0
ShipMission_ShipFollower-Lock-Rare,4635,156,48,61,461,509,406,467,4650,0,0,0,0
ShipMission_ShipFollower-TypeFrame,4636,156,78,78,1,79,702,780,4651,0,0,0,0
transmog-frame-small-pink,4637,610,38,38,147,185,327,365,4652,0,0,0,0
transmog-frame-small,4638,610,40,40,151,191,284,324,4653,0,0,0,0
transmog-frame-small-selected,4639,610,40,40,105,145,327,367,4654,0,0,0,0
transmog-frame-small-red,4640,610,38,38,105,143,369,407,4655,0,0,0,0
ShipMission-RedGlowRing,4642,622,88,88,1,89,392,480,5040,0,0,0,0
adventureguide-rewardring,4670,609,48,48,347,395,1,49,5041,0,0,0,0
wildbattlepet,4672,647,32,32,615,647,783,815,5078,0,0,8,0
archblob,4674,647,32,32,649,681,375,407,5080,0,0,8,0
banker,4675,647,32,32,853,885,375,407,5081,0,0,8,0
focus,4676,647,32,32,479,511,409,441,5082,0,0,8,0
battlemaster,4677,647,32,32,921,953,375,407,5083,0,0,8,0
ammunition,4678,647,32,32,411,443,375,407,5084,0,0,8,0
class,4679,647,32,32,377,409,443,475,5085,0,0,8,0
profession,4681,647,32,32,547,579,477,509,5087,0,0,8,0
target,4682,647,32,32,513,545,817,849,5088,0,0,8,0
food,4683,647,32,32,547,579,409,441,5089,0,0,8,0
reagents,4684,647,32,32,819,851,511,543,5090,0,0,8,0
innkeeper,4685,647,32,32,751,783,409,441,5091,0,0,8,0
auctioneer,4686,647,32,32,751,783,375,407,5092,0,0,8,0
repair,4687,647,32,32,853,885,511,543,5093,0,0,8,0
mailbox,4688,647,32,32,411,443,647,679,5094,0,0,8,0
flightmaster,4689,647,32,32,377,409,953,985,5095,0,0,8,0
none,4690,647,32,32,717,749,443,475,5096,0,0,8,0
questblob,4691,647,32,32,479,511,919,951,5097,0,0,8,0
trivialquests,4692,647,32,32,921,953,545,577,5098,0,0,8,0
poisons,4693,647,32,32,445,477,953,985,5099,0,0,8,0
playerfriend,4694,647,32,32,445,477,613,645,5100,0,0,8,0
questrepeatableturnin,4695,647,32,32,615,647,511,543,5101,0,0,8,0
mantidtowerdestroyed,4697,647,32,32,411,443,715,747,5103,0,0,8,0
portalred,4698,647,32,32,513,545,477,509,5104,0,0,8,0
questturnin,4699,647,32,32,717,749,511,543,5105,0,0,8,0
object,4701,647,32,32,751,783,443,475,5107,0,0,8,0
gear,4702,647,32,32,615,647,409,441,5108,0,0,8,0
monsterfriend,4703,647,32,32,513,545,443,475,5109,0,0,8,0
monsterenemy,4704,647,32,32,479,511,443,475,5110,0,0,8,0
portalpurple,4705,647,32,32,479,511,477,509,5111,0,0,8,0
dungeonskull,4707,647,32,32,377,409,817,849,5113,0,0,8,0
playerneutral,4708,647,32,32,445,477,647,679,5114,0,0,8,0
monsterneutral,4710,647,32,32,547,579,443,475,5115,0,0,8,0
portalblue,4711,647,32,32,445,477,987,1019,5116,0,0,8,0
questlegendaryturnin,4712,647,32,32,547,579,511,543,5117,0,0,8,0
questdaily,4713,647,32,32,479,511,953,985,5118,0,0,8,0
playercontrolled,4714,647,32,32,445,477,511,543,5119,0,0,8,0
vignetteloot,4715,647,32,32,955,987,579,611,5120,24,24,8,0
vignetteevent,4716,647,64,64,137,201,659,723,5121,32,32,8,0
playerenemy,4717,647,32,32,445,477,579,611,5122,0,0,8,0
partymember,4719,647,32,32,785,817,443,475,5123,0,0,8,0
xmarksthespot,4720,647,32,32,615,647,885,917,5124,0,0,8,0
questobjective,4721,647,32,32,581,613,511,543,5125,0,0,8,0
questlegendary,4723,647,32,32,513,545,511,543,5126,0,0,8,0
artifactquest,4725,647,32,32,683,715,375,407,5127,0,0,8,0
questnormal,4726,647,64,64,731,795,131,195,5128,32,32,8,0
vignettelootelite,4727,647,32,32,581,613,613,645,5129,0,0,8,0
flightpath,4728,647,32,32,445,477,409,441,5130,0,0,8,0
vignetteeventelite,4729,647,32,32,921,953,579,611,4852,0,0,8,0
chatballon,4730,647,32,32,989,1021,375,407,4944,0,0,8,0
mantidtower,4731,647,32,32,411,443,681,713,4945,0,0,8,0
raidmember,4732,647,32,32,785,817,511,543,4946,0,0,8,0
vignettekill,4733,647,64,64,137,201,923,987,4947,32,32,8,0
questbonusobjective,4734,647,64,64,467,531,131,195,4948,32,32,8,0
artifactquestturnin,4735,647,32,32,717,749,375,407,4949,0,0,8,0
smallquestbang,4736,647,32,32,513,545,715,747,4950,0,0,8,0
vignettekillelite,4737,647,64,64,665,729,197,261,4951,32,32,8,0
greencross,4738,647,32,32,683,715,409,441,4952,0,0,8,0
playerdeadblip,4740,647,32,32,445,477,545,577,4953,0,0,8,0
playerpartyblip,4741,647,32,32,445,477,681,713,4954,0,0,8,0
playerraidblip,4742,647,32,32,445,477,715,747,4955,0,0,8,0
vehicle-air-alliance,4743,647,64,64,137,201,395,459,4983,0,0,8,0
vehicle-air-horde,4745,647,64,64,137,201,461,525,4985,0,0,8,0
vehicle-air-occupied,4746,647,32,32,989,1021,545,577,4986,0,0,8,0
vehicle-air-unoccupied,4747,647,32,32,547,579,579,611,4987,0,0,8,0
vehicle-alliancecart,4748,647,32,32,547,579,613,645,4988,0,0,8,0
vehicle-carriage,4749,647,64,64,137,201,527,591,4989,0,0,8,0
vehicle-ground-occupied,4750,647,32,32,547,579,647,679,4990,0,0,8,0
vehicle-ground-unoccupied,4751,647,32,32,547,579,681,713,4991,0,0,8,0
vehicle-grummleconvoy,4752,647,32,32,547,579,715,747,4992,0,0,8,0
vehicle-hammergold-1,4753,647,32,32,547,579,783,815,4993,0,0,8,0
vehicle-hammergold-2,4754,647,32,32,547,579,817,849,4994,0,0,8,0
vehicle-hammergold-3,4755,647,32,32,547,579,851,883,4995,0,0,8,0
vehicle-hammergold,4756,647,32,32,547,579,749,781,4996,0,0,8,0
vehicle-hordecart,4757,647,32,32,547,579,885,917,4997,0,0,8,0
vehicle-mogu,4758,647,32,32,547,579,919,951,4998,0,0,8,0
vehicle-silvershardmines-arrow,4759,647,32,32,547,579,953,985,4999,0,0,8,0
vehicle-silvershardmines-minecart,4760,647,32,32,547,579,987,1019,5000,0,0,8,0
vehicle-silvershardmines-minecartblue,4761,647,32,32,581,613,579,611,5001,0,0,8,0
vehicle-silvershardmines-minecartred,4762,647,32,32,615,647,579,611,5002,0,0,8,0
vehicle-templeofkotmogu-cyanball,4763,647,32,32,649,681,579,611,5003,0,0,8,0
vehicle-templeofkotmogu-greenball,4764,647,32,32,683,715,579,611,5004,0,0,8,0
vehicle-templeofkotmogu-orangeball,4765,647,32,32,717,749,579,611,5005,0,0,8,0
vehicle-templeofkotmogu-purpleball,4766,647,32,32,751,783,579,611,5006,0,0,8,0
vehicle-trap-gold,4767,647,32,32,785,817,579,611,5007,0,0,8,0
vehicle-trap-grey,4768,647,32,32,819,851,579,611,5008,0,0,8,0
vehicle-trap-red,4769,647,32,32,853,885,579,611,5009,0,0,8,0
questskull,4770,647,32,32,683,715,511,543,5010,0,0,8,0
focus-tracker,4771,647,32,32,513,545,409,441,5042,0,0,8,0
mageportalalliance,4772,647,32,32,411,443,579,611,5043,0,0,8,0
mageportalhorde,4773,647,32,32,411,443,613,645,5044,0,0,8,0
questartifact,4774,647,32,32,479,511,851,883,5045,0,0,8,0
questartifactturnin,4775,647,32,32,479,511,885,917,5046,0,0,8,0
target-tracker,4776,647,32,32,513,545,851,883,5047,0,0,8,0
warlockportalalliance,4777,647,32,32,989,1021,613,645,5048,0,0,8,0
warlockportalhorde,4778,647,32,32,615,647,647,679,5049,0,0,8,0
wildbattlepet-tracker,4779,647,32,32,615,647,817,849,5050,0,0,8,0
wildbattlepetcapturable,4780,647,32,32,615,647,851,883,5051,0,0,8,0
crossedflags,4781,647,32,32,377,409,511,543,5052,0,0,8,0
crossedflagswithtimer,4782,647,32,32,377,409,545,577,5053,0,0,8,0
minimap-deadarrow,4785,647,32,32,411,443,919,951,5020,0,0,8,0
minimap-positionarrows,4786,647,16,32,1000,1016,83,115,5021,0,0,8,0
minimap-questarrow,4787,647,32,32,411,443,953,985,5022,0,0,8,0
minimap-vignettearrow,4788,647,32,32,411,443,987,1019,5023,0,0,8,0
minimaparrow,4789,647,32,32,445,477,443,475,5024,0,0,8,0
rotating-minimaparrow,4790,647,32,32,887,919,511,543,5025,0,0,8,0
rotating-minimapgrouparrow,4791,647,32,32,921,953,511,543,5026,0,0,8,0
rotating-minimapguidearrow,4792,647,32,32,955,987,511,543,5027,0,0,8,0
minimap-positionarrowdown,4793,647,48,48,203,251,475,523,5054,0,0,8,0
minimap-positionarrowup,4794,647,48,48,203,251,525,573,5055,0,0,8,0
movierecordingicon,4795,647,32,32,581,613,443,475,5077,0,0,8,0
BossBanner-RedLightning,4798,594,122,118,1,123,295,413,4928,0,0,0,0
Artifacts-PerkRing-GoldMedal,4800,607,88,88,1,89,807,895,4853,0,0,0,0
Artifacts-PerkRing-MainProc-Glow,4801,607,120,120,624,744,317,437,4854,0,0,0,0
Artifacts-PerkRing-MainProc,4802,607,92,92,258,350,879,971,4855,0,0,0,0
Artifacts-PerkRing-Small,4803,607,60,60,835,895,1,61,4856,0,0,0,0
Artifacts-PointsBox,4804,607,28,24,223,251,27,51,4857,0,0,0,0
Artifacts-PerkRing-Highlight,4808,607,46,46,305,351,1,47,4984,0,0,0,0
ArtifactsFX-SpinningGlowys,4809,607,70,70,549,619,1,71,5011,0,0,0,0
ArtifactsFX-StarBurst,4810,607,133,133,123,256,197,330,5012,0,0,0,0
ArtifactsFX-Whirls,4811,607,76,76,502,578,942,1018,5013,0,0,0,0
ArtifactsFX-YellowRing,4812,607,50,50,253,303,1,51,5014,0,0,0,0
Artifacts-DemonHunter-BG,4813,649,896,615,1,897,1,616,5015,0,0,0,0
Artifacts-Paladin-BG,4815,650,896,615,1,897,1,616,5016,0,0,0,0
Artifacts-PointsBoxGreen,4817,607,28,24,223,251,1,25,4895,0,0,0,0
ArtifactsFX-PointSideBurstLeft,4818,607,33,35,501,534,35,70,4896,0,0,0,0
ArtifactsFX-PointSideBurstRight,4819,607,33,35,767,800,37,72,4897,0,0,0,0
vas-receipt-selectedcharbg,4837,654,302,72,149,451,1,73,4892,0,0,0,0
Ships_CarrierA-List,4838,655,154,80,1,155,131,211,4863,0,0,0,0
Ships_CarrierA-Portrait,4839,655,152,128,1,153,1,129,4864,0,0,0,0
Ships_CarrierA-Map,4840,656,83,72,1,84,1,73,4865,0,0,0,0
Ships_CarrierH-Map,4841,657,83,72,1,84,1,73,4866,0,0,0,0
Ships_CarrierH-List,4842,658,154,80,1,155,131,211,4867,0,0,0,0
Ships_CarrierH-Portrait,4843,658,152,128,1,153,1,129,4868,0,0,0,0
garrlanding-shipmission-complete,4844,268,400,47,1498,1898,415,462,4869,0,0,0,0
garrlanding-shipmission-inprogress,4845,268,400,47,1498,1898,464,511,4870,0,0,0,0
_GarrMissionLocation-FrostfireSea-Back,4846,659,1024,285,0,1024,1,286,5028,0,0,4,0
_GarrMissionLocation-FrostfireSea-Fore,4847,659,1024,285,0,1024,288,573,5029,0,0,4,0
_GarrMissionLocation-FrostfireSea-Mid,4848,659,1024,285,0,1024,575,860,5030,0,0,4,0
_GarrMissionLocation-ShadowmoonSea-Back,4849,660,1024,285,0,1024,1,286,5031,0,0,4,0
_GarrMissionLocation-ShadowmoonSea-Fore,4850,660,1024,285,0,1024,288,573,5032,0,0,4,0
_GarrMissionLocation-ShadowmoonSea-Mid,4851,660,1024,285,0,1024,575,860,5034,0,0,4,0
_GarrMissionLocation-NagrandSea-Back,4852,661,1024,285,0,1024,1,286,5035,0,0,4,0
_GarrMissionLocation-NagrandSea-Fore,4853,661,1024,285,0,1024,288,573,5036,0,0,4,0
_GarrMissionLocation-NagrandSea-Mid,4854,661,1024,285,0,1024,575,860,5037,0,0,4,0
ShipMission_Toast,4855,150,317,82,1,318,169,251,4893,0,0,0,0
adventureguide-redx,4856,609,35,34,347,382,90,124,5086,0,0,0,0
Artifacts-MageArcane-BG,4858,662,896,615,1,897,1,616,4957,0,0,0,0
GarrisonFX_BlueFlare,4859,308,128,128,1,129,271,399,4894,0,0,0,0
GarrMission_WeakEncounterAbilityBorder-Lg,4860,152,46,46,317,363,948,994,5038,0,0,0,0
bonusobjectives-bar-bg,4861,663,193,18,243,436,348,366,5102,0,0,0,0
bonusobjectives-bar-fill,4862,663,1,18,259,260,153,171,5106,0,0,0,0
bonusobjectives-bar-frame,4863,663,240,51,1,241,262,313,5112,0,0,0,0
bonusobjectives-bar-glow-ring,4864,663,240,51,243,483,262,313,4827,0,0,0,0
bonusobjectives-bar-glow,4865,663,205,31,243,448,315,346,4828,0,0,0,0
bonusobjectives-bar-ring,4866,663,81,51,404,485,47,98,4829,0,0,0,0
bonusobjectives-bar-sheen,4867,663,97,44,404,501,1,45,4830,0,0,0,0
bonusobjectives-bar-spark,4868,663,10,28,247,257,153,181,4831,0,0,0,0
bonusobjectives-bar-starburst,4869,663,36,36,404,440,100,136,4832,0,0,0,0
bonusobjectives-title-bg,4870,663,418,76,1,419,184,260,4833,0,0,0,0
bonusobjectives-title-icon,4871,663,155,150,247,402,1,151,4835,0,0,0,0
ShipMission_NameBG,4873,153,132,21,1,133,918,939,4872,0,0,0,0
ShipMission_PartyBuffsBG,4874,153,256,33,0,256,718,751,4873,0,0,4,0
Ships_DreadnaughtA-List,4875,664,154,80,1,155,131,211,4874,0,0,0,0
Ships_DreadnaughtA-Portrait,4876,664,152,128,1,153,1,129,4871,0,0,0,0
Ships_DreadnaughtA-Map,4877,665,83,72,1,84,1,73,4875,0,0,0,0
Ships_DreadnaughtH-List,4878,666,154,80,1,155,131,211,4876,0,0,0,0
Ships_DreadnaughtH-Portrait,4879,666,152,128,1,153,1,129,4877,0,0,0,0
Ships_DreadnaughtH-Map,4880,667,83,72,1,84,1,73,4878,0,0,0,0
Ships_EnemyDreadnaughtH-Portrait,4881,668,152,128,1,153,1,129,4879,0,0,0,0
Ships_EnemyDreadnaughtA-Portrait,4882,669,152,128,1,153,1,129,4880,0,0,0,0
FontStyle_Parchment,4883,670,256,256,0,256,0,256,4836,0,0,6,0
FontStyle_BlueGradient,4884,671,128,128,0,128,0,128,4881,0,0,6,0
FontStyle_Garrisons,4885,672,256,256,0,256,0,256,4882,0,0,6,0
FontStyle_IronHordeMetal,4886,673,256,256,0,256,0,256,4883,0,0,6,0
FontStyle_Legion,4887,674,256,256,0,256,0,256,4884,0,0,6,0
FontStyle_Metal,4888,675,256,256,0,256,0,256,4885,0,0,6,0
splash-620-botleft,4889,676,137,371,374,511,587,958,4886,0,0,0,0
splash-620-right,4890,676,510,584,1,511,1,585,4887,0,0,0,0
splash-620-topleft,4891,676,371,434,1,372,587,1021,4888,0,0,0,0
Artifacts-DeathKnightFrost-BG,4892,677,896,615,1,897,1,616,4889,0,0,0,0
shop-card-darkcover,4893,654,146,209,1,147,1,210,5039,0,0,0,0
Artifacts-Warrior-BG,4894,678,896,615,1,897,1,616,4890,0,0,0,0
Artifacts-Rogue-BG,4895,679,896,615,1,897,1,616,4958,0,0,0,0
Artifacts-Druid-BG,4896,680,896,615,1,897,1,616,4959,0,0,0,0
ShipMissionIcon-Bonus-Mission,4897,323,64,64,67,131,331,395,4929,0,0,0,0
ShipMissionIcon-Bonus-Map,4898,622,64,64,135,199,258,322,4930,0,0,0,0
ShipMissionIcon-Bonus-MapBadge,4899,622,34,34,91,125,392,426,4931,0,0,0,0
NavalMap-CircleGlowTrails,4900,622,255,255,1,256,1,256,4932,0,0,0,0
NavalMap-LargeBonusCircle,4901,622,234,234,258,492,1,235,4933,0,0,0,0
NavalMap-SmallBonusCircle,4902,622,132,132,1,133,258,390,4934,0,0,0,0
GarrisonFX-StarBurst,4903,308,133,133,1,134,136,269,4935,0,0,0,0
GarrMission_WeakEncounterAbilityBorder,4904,152,32,32,793,825,435,467,4891,0,0,0,0
ShipMission-TimerBG,4905,622,55,21,1,56,482,503,4936,0,0,0,0
services-icon-warning,4928,687,42,37,1,43,985,1022,5017,0,0,0,0
ShipMissionIcon-Legendary-Map,4929,622,64,64,135,199,390,454,4956,0,0,0,0
ShipMissionIcon-Legendary-MapBadge,4930,622,34,34,91,125,464,498,4960,0,0,0,0
ShipMissionIcon-Legendary-Mission,4931,323,64,64,133,197,133,197,4961,0,0,0,0
_ForgeBorder-Top,4967,688,256,16,0,256,1,17,4898,0,0,4,0
!ForgeBorder-Right,4968,689,16,256,1,17,0,256,4899,0,0,2,0
_DemonHunter-DemonicFuryBar,4969,690,128,10,0,128,1,11,4900,0,0,4,0
services-icon-goldborder,4970,687,62,62,825,887,82,144,4901,0,0,0,0
vas-receipt-brownarrow,4971,654,30,15,193,223,199,214,5018,0,0,0,0
vas-receipt-greenbg,4972,654,297,46,149,446,75,121,5019,0,0,0,0
Ships_EnemyCarrierA-Portrait,5001,691,152,128,1,153,1,129,5056,0,0,0,0
Ships_EnemyCarrierH-Portrait,5002,692,152,128,1,153,1,129,5057,0,0,0,0
loottoast-moreawesome,5003,332,276,96,1,277,316,412,4969,0,0,0,0
legioninvasion-map-icon-portal-large,5005,693,59,62,314,373,144,206,5058,0,0,0,0
legioninvasion-map-icon-portal,5006,693,42,44,425,467,144,188,5059,0,0,0,0
legioninvasion-scenario-rewardring,5007,693,48,48,375,423,144,192,5060,0,0,0,0
legioninvasion-ScenarioTrackerToast,5008,693,243,77,1,244,224,301,5061,0,0,0,0
legioninvasion-Toast-Frame,5009,693,311,78,1,312,144,222,5062,0,0,0,0
legioninvasion-map-cover,5010,694,1004,672,1,1005,1,673,5063,0,0,0,0
ShipMissionIcon-SiegeIHA-Map,5012,622,64,64,267,331,258,322,4970,0,0,0,0
ShipMissionIcon-SiegeIHA-MapBadge,5013,622,34,34,267,301,390,424,4971,0,0,0,0
ShipMissionIcon-SiegeIHH-Map,5014,622,64,64,333,397,258,322,4972,0,0,0,0
ShipMissionIcon-SiegeIHH-MapBadge,5015,622,34,34,267,301,426,460,4973,0,0,0,0
ShipMissionIcon-SiegeIHA-Mission,5016,323,64,64,397,461,133,197,4974,0,0,0,0
ShipMissionIcon-SiegeIHH-Mission,5017,323,64,64,133,197,199,263,4975,0,0,0,0
tournamentarena-flag-large-blue-flash,5021,695,128,64,843,971,131,195,4976,0,0,0,0
tournamentarena-flag-large-blue,5022,695,128,64,583,711,131,195,4977,0,0,0,0
tournamentarena-flag-large-red-flash,5023,695,128,64,841,969,327,391,4978,0,0,0,0
tournamentarena-flag-large-red,5024,695,128,64,713,841,131,195,4979,0,0,0,0
tournamentarena-frame-bg-side-blue,5029,695,8,32,861,869,67,99,4980,0,0,0,0
tournamentarena-frame-bg-side-red,5030,695,8,32,1003,1011,1,33,4981,0,0,0,0
tournamentarena-frame-bot,5035,695,512,64,405,917,587,651,5064,0,0,0,0
tournamentarena-frame-botleft,5036,695,64,64,1,65,131,195,5065,0,0,0,0
tournamentarena-frame-botright,5037,695,64,64,807,871,1,65,5066,0,0,0,0
tournamentarena-frame-left,5038,695,64,256,1,65,628,884,5067,0,0,0,0
tournamentarena-frame-right,5039,695,64,256,325,389,710,966,5068,0,0,0,0
tournamentarena-frame-top,5040,695,512,64,391,903,840,904,5069,0,0,0,0
tournamentarena-frame-topleft,5041,695,64,64,1,65,886,950,5070,0,0,0,0
tournamentarena-frame-topright,5042,695,64,64,1,65,952,1016,5071,0,0,0,0
tournamentarena-titlebackplate,5043,695,512,128,391,903,710,838,5072,0,0,0,0
honorsystem-bar-background,5044,696,471,18,130,601,433,451,4902,0,0,0,0
honorsystem-bar-frame,5045,696,521,45,1,522,386,431,4903,0,0,0,0
honorsystem-bar-spark,5046,696,16,64,910,926,223,287,4904,0,0,0,0
honorsystem-bar-rewardborder-prestige-flash,5048,696,127,131,1,128,433,564,4905,0,0,0,0
honorsystem-bar-rewardborder-prestige,5049,696,59,60,902,961,56,116,4906,0,0,0,0
honorsystem-bar-rewardborder,5050,696,39,39,940,979,118,157,4907,0,0,0,0
honorsystem-prestige-laurel-bg-alliance,5051,696,134,134,638,772,223,357,4908,0,0,0,0
honorsystem-prestige-laurel-bg-horde,5052,696,134,134,774,908,223,357,4909,0,0,0,0
honorsystem-prestige-laurel,5053,696,262,220,638,900,1,221,4910,0,0,0,0
honorsystem-talents-bg,5054,696,635,383,1,636,1,384,4911,0,0,0,0
_honorsystem-bar-fill,5055,697,256,17,0,256,1,18,4912,0,0,4,0
honorsystem-icon-prestige-1,5056,698,128,128,1,129,1,129,4913,0,0,0,0
honorsystem-icon-prestige-10,5057,698,128,128,1,129,131,259,4914,0,0,0,0
honorsystem-icon-prestige-11,5058,698,128,128,1,129,261,389,4915,0,0,0,0
honorsystem-icon-prestige-2,5059,698,128,128,131,259,1,129,4916,0,0,0,0
honorsystem-icon-prestige-3,5060,698,128,128,131,259,131,259,4917,0,0,0,0
honorsystem-icon-prestige-4,5061,698,128,128,131,259,261,389,4918,0,0,0,0
honorsystem-icon-prestige-5,5062,698,128,128,261,389,1,129,4919,0,0,0,0
honorsystem-icon-prestige-6,5063,698,128,128,261,389,131,259,4920,0,0,0,0
honorsystem-icon-prestige-7,5064,698,128,128,261,389,261,389,4921,0,0,0,0
honorsystem-icon-prestige-8,5065,698,128,128,391,519,1,129,4922,0,0,0,0
honorsystem-icon-prestige-9,5066,698,128,128,391,519,131,259,4923,0,0,0,0
bonusobjectives-title-icon-honor,5067,663,244,181,1,245,1,182,4924,0,0,0,0
honorsystem-bar-frame-small,5068,696,314,43,524,838,386,429,4925,0,0,0,0
honorsystem-bar-rewardborder-circle,5069,696,48,48,963,1011,56,104,4926,0,0,0,0
honorsystem-icon-bonus,5070,696,29,29,993,1022,1,30,4927,0,0,0,0
honorsystem-portrait-alliance,5071,698,50,52,1,51,391,443,5073,0,0,0,0
honorsystem-portrait-horde,5072,698,50,52,1,51,445,497,5074,0,0,0,0
demoninvasion1,5073,647,32,32,377,409,579,611,5075,0,0,8,0
demoninvasion2,5074,647,32,32,377,409,613,645,5076,0,0,8,0
demoninvasion3,5075,647,32,32,377,409,647,679,5323,0,0,8,0
demoninvasion4,5076,647,32,32,377,409,681,713,5324,0,0,8,0
_Shaman-MaelstromBar,5077,699,128,10,0,128,1,11,5171,0,0,4,0
_Druid-LunarBar,5078,700,128,10,0,128,1,11,5172,0,0,4,0
titleprestige-glowcover,5079,701,216,216,358,574,330,546,5282,0,0,0,0
titleprestige-prestigeicon,5080,701,89,91,916,1005,1,92,5283,0,0,0,0
titleprestige-starglow,5081,701,355,359,1,356,1,360,5284,0,0,0,0
titleprestige-title,5082,701,141,43,576,717,485,528,5285,0,0,0,0
titleprestige-title2,5083,701,140,24,778,918,548,572,5286,0,0,0,0
titleprestige-wreath,5084,701,262,153,576,838,330,483,5287,0,0,0,0
titleprestige-title-bg,5085,701,418,76,358,776,548,624,5173,0,0,0,0
titleprestige-ember,5086,701,27,31,280,307,362,393,5174,0,0,0,0
services-popup-bot,5087,702,198,44,201,399,215,259,5188,0,0,0,0
services-popup-botleft,5088,702,104,44,397,501,125,169,5189,0,0,0,0
services-popup-botright,5089,702,104,44,401,505,215,259,5190,0,0,0,0
services-popup-top,5090,702,198,60,1,199,215,275,5191,0,0,0,0
services-popup-topleft,5091,702,106,60,397,503,1,61,5192,0,0,0,0
services-popup-topright,5092,702,106,60,397,503,63,123,5193,0,0,0,0
services-popup-bg,5093,702,394,212,1,395,1,213,5194,0,0,0,0
services-popup-left,5094,702,64,32,397,461,171,203,5195,0,0,0,0
services-popup-right,5095,702,64,32,1,65,277,309,5196,0,0,0,0
titleprestige-wings,5096,701,277,327,1,278,362,689,5131,0,0,0,0
titleprestige-wings2,5097,701,277,327,358,635,1,328,5132,0,0,0,0
titleprestige-wings-white,5098,701,277,327,1,278,691,1018,5133,0,0,0,0
titleprestige-wings2-white,5099,701,277,327,637,914,1,328,5134,0,0,0,0
titleprestige-starcrown,5101,701,122,41,840,962,503,544,5325,0,0,0,0
adventuremaplabel-large,5103,703,455,63,354,809,311,374,5289,0,0,0,0
adventuremaplabel-small,5104,703,181,39,811,992,311,350,5290,0,0,0,0
adventuremapicon-dailyquest,5106,703,25,41,939,964,265,306,5292,0,0,0,0
adventuremapicon-missioncombat,5107,703,42,42,354,396,460,502,5293,0,0,0,0
adventuremapicon-quest,5108,703,25,41,981,1006,268,309,5294,0,0,0,0
adventuremapicon-sandboxquest,5109,703,25,39,832,857,269,308,5295,0,0,0,0
questportraiticon-sandboxquest,5110,703,33,55,981,1014,211,266,5296,0,0,0,0
Mage-ArcaneCharge,5111,704,39,39,60,99,61,100,5288,0,0,0,0
Mage-ArcaneChargeBar,5112,704,125,15,60,185,1,16,5297,0,0,0,0
priest-insanityoverlay,5113,705,55,36,196,251,13,49,5291,0,0,0,0
_priest-insanitybar,5114,705,128,10,0,128,1,11,5298,0,0,4,0
Legion-boostpopup-bottom,5115,706,430,70,1,431,185,255,5135,0,0,0,0
Legion-boostpopup-middle,5116,706,430,108,1,431,1,109,5136,0,0,0,0
Legion-boostpopup-top,5117,706,430,72,1,431,111,183,5137,0,0,0,0
adventuremapicon-lock,5125,703,28,37,802,830,269,306,5299,0,0,0,0
adventuremaplabel-missiontimer,5126,703,76,20,125,201,1001,1021,5300,0,0,0,0
adventuremaplabel-questdiscovered,5127,703,189,36,354,543,376,412,5301,0,0,0,0
fxam-questbang,5128,703,34,54,987,1021,1,55,5302,0,0,0,0
fxam-smallspikeyglow,5129,703,40,52,939,979,211,263,5303,0,0,0,0
mission-followerportraitframe,5130,703,49,47,888,937,211,258,5304,0,0,0,0
mission-lootbackgroundglow,5131,703,183,71,802,985,1,72,5305,0,0,0,0
fogofwar,5132,703,341,371,1,342,441,812,5306,0,0,0,0
adventuremapquest-questpane,5133,703,351,438,1,352,1,439,5307,0,0,0,0
adventuremapquest-rewardspanel,5134,703,285,185,1,286,814,999,5308,0,0,0,0
adventuremapquest-itemnamebg,5135,703,95,38,888,983,171,209,5309,0,0,0,0
charactercreate-banner-bottom,5137,708,200,64,1,201,1975,2039,5326,0,0,0,0
charactercreate-banner-middle,5138,708,200,194,1149,1349,259,453,5327,0,0,0,0
charactercreate-banner-top,5139,708,200,49,1345,1545,497,546,5328,0,0,0,0
Artifacts-Shaman-BG,5140,709,896,615,1,897,1,616,5175,0,0,0,0
Artifacts-Hunter-BG,5145,710,896,615,1,897,1,616,5179,0,0,0,0
Artifacts-Priest-BG,5150,711,896,615,1,897,1,616,5183,0,0,0,0
Artifacts-Monk-BG,5155,712,896,615,1,897,1,616,5186,0,0,0,0
Artifacts-Warlock-BG,5160,713,896,615,1,897,1,616,5187,0,0,0,0
services-checkmark,5165,687,41,44,971,1012,1,45,5235,0,0,0,0
services-cover-ring,5166,687,80,82,256,336,867,949,5236,0,0,0,0
services-cover,5167,687,421,724,1,422,1,725,5237,0,0,0,0
services-icon-bonus-large,5168,687,34,34,89,123,985,1019,5238,0,0,0,0
services-icon-bonus-red,5169,687,19,19,179,198,985,1004,5239,0,0,0,0
services-icon-bonus,5170,687,19,19,200,219,985,1004,5240,0,0,0,0
services-icon-processing,5171,687,42,37,45,87,985,1022,5241,0,0,0,0
services-number-1,5172,687,71,79,338,409,867,946,5242,0,0,0,0
services-number-2,5173,687,71,79,679,750,1,80,5243,0,0,0,0
services-number-3,5174,687,71,79,679,750,82,161,5244,0,0,0,0
services-number-4,5175,687,71,79,679,750,163,242,5245,0,0,0,0
services-number-5,5176,687,71,79,752,823,1,80,5246,0,0,0,0
services-number-6,5177,687,71,79,752,823,82,161,5247,0,0,0,0
services-number-7,5178,687,71,79,752,823,163,242,5248,0,0,0,0
services-number-8,5179,687,71,79,825,896,1,80,5249,0,0,0,0
services-number-9,5180,687,71,79,898,969,1,80,5250,0,0,0,0
services-ring-countcircle,5181,687,32,32,125,157,985,1017,5251,0,0,0,0
services-ring-large-glow,5182,687,253,256,1,254,727,983,5252,0,0,0,0
services-ring-large-glowpulse,5183,687,145,138,256,401,727,865,5253,0,0,0,0
services-ring-large-glowspin,5184,687,253,256,424,677,1,257,5254,0,0,0,0
services-ring-large,5185,687,72,73,338,410,948,1021,5255,0,0,0,0
services-ring-wod,5186,687,72,68,256,328,951,1019,5256,0,0,0,0
services-ring,5187,687,59,60,825,884,146,206,5257,0,0,0,0
services-yellowarrow,5188,687,18,32,159,177,985,1017,5258,0,0,0,0
transmog-nav-slot-back,5189,610,35,37,145,180,369,406,5363,0,0,0,0
transmog-nav-slot-chest,5190,610,35,37,105,140,409,446,5364,0,0,0,0
transmog-nav-slot-feet,5191,610,35,37,142,177,409,446,5365,0,0,0,0
transmog-nav-slot-hands,5192,610,35,37,105,140,448,485,5366,0,0,0,0
transmog-nav-slot-head,5193,610,35,37,142,177,448,485,5367,0,0,0,0
transmog-nav-slot-legs,5194,610,35,37,203,238,115,152,5368,0,0,0,0
transmog-nav-slot-mainhand,5195,610,35,37,240,275,115,152,5369,0,0,0,0
transmog-nav-slot-selected,5197,610,45,47,381,426,65,112,5371,0,0,0,0
transmog-nav-slot-shirt,5198,610,35,37,314,349,115,152,5372,0,0,0,0
transmog-nav-slot-shoulder,5199,610,35,37,351,386,115,152,5373,0,0,0,0
transmog-nav-slot-tabard,5200,610,35,37,388,423,115,152,5374,0,0,0,0
transmog-nav-slot-waist,5201,610,35,37,425,460,115,152,5375,0,0,0,0
transmog-nav-slot-wrist,5202,610,35,37,462,497,115,152,5376,0,0,0,0
boostpopup-wod-bottom,5203,714,430,65,1,431,121,186,5377,0,0,0,0
boostpopup-wod-middle,5204,714,430,118,1,431,1,119,5378,0,0,0,0
boostpopup-wod-top,5205,714,430,65,1,431,188,253,5379,0,0,0,0
Relic-Arcane-Slot,5206,607,72,72,1,73,1,73,5197,0,0,0,0
Relic-Arcane-TraitBG,5207,607,120,120,245,365,75,195,5198,0,0,0,0
Relic-Arcane-TraitGlow,5208,607,120,120,502,622,698,818,5199,0,0,0,0
Relic-Arcane-TraitGlowRing,5209,607,120,120,380,500,439,559,5200,0,0,0,0
Relic-Blood-Slot,5210,607,72,72,897,969,1,73,5201,0,0,0,0
Relic-Blood-TraitBG,5211,607,120,120,367,487,75,195,5202,0,0,0,0
Relic-Blood-TraitGlow,5212,607,120,120,126,246,444,564,5203,0,0,0,0
Relic-Blood-TraitGlowRing,5213,607,120,120,126,246,787,907,5204,0,0,0,0
Relic-Fel-Slot,5214,607,72,72,624,696,933,1005,5205,0,0,0,0
Relic-Fel-TraitBG,5215,607,120,120,380,500,561,681,5206,0,0,0,0
Relic-Fel-TraitGlow,5216,607,120,120,380,500,317,437,5207,0,0,0,0
Relic-Fel-TraitGlowRing,5217,607,120,120,258,378,317,437,5208,0,0,0,0
Relic-Fire-Slot,5218,607,72,72,353,425,1,73,5209,0,0,0,0
Relic-Fire-TraitBG,5219,607,120,120,126,246,566,686,5210,0,0,0,0
Relic-Fire-TraitGlow,5220,607,120,120,258,378,561,681,5211,0,0,0,0
Relic-Fire-TraitGlowRing,5221,607,120,120,502,622,576,696,5212,0,0,0,0
Relic-Frost-Slot,5222,607,72,72,258,330,683,755,5213,0,0,0,0
Relic-Frost-TraitBG,5223,607,120,120,1,121,897,1017,5214,0,0,0,0
Relic-Frost-TraitGlow,5224,607,120,120,1,121,75,195,5215,0,0,0,0
Relic-Frost-TraitGlowRing,5225,607,120,120,502,622,820,940,5216,0,0,0,0
Relic-Holy-Slot,5226,607,72,72,427,499,1,73,5217,0,0,0,0
Relic-Holy-TraitBG,5227,607,120,120,1,121,685,805,5218,0,0,0,0
Relic-Holy-TraitGlow,5228,607,120,120,123,243,75,195,5219,0,0,0,0
Relic-Holy-TraitGlowRing,5229,607,120,120,624,744,689,809,5220,0,0,0,0
Relic-Iron-Slot,5230,607,72,72,75,147,1,73,5221,0,0,0,0
Relic-Iron-TraitBG,5231,607,120,120,746,866,689,809,5222,0,0,0,0
Relic-Iron-TraitGlow,5232,607,120,120,502,622,317,437,5223,0,0,0,0
Relic-Iron-TraitGlowRing,5233,607,120,120,258,378,439,559,5224,0,0,0,0
Relic-Life-Slot,5234,607,72,72,149,221,1,73,5225,0,0,0,0
Relic-Life-TraitBG,5235,607,120,120,571,691,75,195,5226,0,0,0,0
Relic-Life-TraitGlow,5236,607,120,120,693,813,75,195,5227,0,0,0,0
Relic-Life-TraitGlowRing,5237,607,120,120,868,988,689,809,5228,0,0,0,0
Relic-Shadow-Slot,5238,607,72,72,746,818,890,962,5229,0,0,0,0
Relic-Shadow-TraitBG,5239,607,120,120,1,121,441,561,5230,0,0,0,0
Relic-Shadow-TraitGlow,5240,607,120,120,380,500,683,803,5231,0,0,0,0
Relic-Shadow-TraitGlowRing,5241,607,120,120,815,935,75,195,5232,0,0,0,0
Relic-SlotBG,5242,607,34,34,731,765,37,71,5233,0,0,0,0
Relic-Water-Slot,5243,607,72,72,380,452,927,999,5234,0,0,0,0
Relic-Water-TraitBG,5244,607,120,120,380,500,805,925,5259,0,0,0,0
Relic-Water-TraitGlow,5245,607,120,120,624,744,811,931,5260,0,0,0,0
Relic-Water-TraitGlowRing,5246,607,120,120,1,121,197,317,5261,0,0,0,0
Relic-Wind-Slot,5247,607,72,72,621,693,1,73,5262,0,0,0,0
Relic-Wind-TraitBG,5248,607,120,120,1,121,319,439,5263,0,0,0,0
Relic-Wind-TraitGlow,5249,607,120,120,1,121,563,683,5264,0,0,0,0
Relic-Wind-TraitGlowRing,5250,607,120,120,258,378,757,877,5265,0,0,0,0
transmog-toast-bg,5251,715,253,75,1,254,1,76,5266,0,0,0,0
FullAlert-BigSpike,5252,716,27,34,1,28,1,35,5310,0,0,0,0
FullAlert-SoftCurveGlow,5253,716,20,37,30,50,1,38,5311,0,0,0,0
FullAlert-YellowCurveGlow,5254,716,20,37,52,72,1,38,5312,0,0,0,0
FullAlert-FrameGlow,5255,716,34,18,74,108,1,19,5313,0,0,0,0
accountupgradebanner-legion,5258,558,200,117,405,605,1,118,5329,0,0,0,0
Glues-WoW-LegionLogo,5259,717,510,256,1,511,1,257,5314,0,0,0,0
Glues-WoW-LegionLogo_cn,5260,717,510,256,1,511,259,515,5315,0,0,0,0
Glues-WoW-LegionLogo_tw,5261,717,510,256,1,511,517,773,5316,0,0,0,0
shop-games-legion,5262,718,138,86,149,287,128,214,5317,0,0,0,0
shop-games-legiondeluxe-card,5263,718,146,209,1,147,1,210,5318,0,0,0,0
shop-games-magnifyingglass,5264,718,46,47,289,335,1,48,5319,0,0,0,0
shop-games-legiondeluxe,5265,718,138,125,149,287,1,126,5320,0,0,0,0
Barbershop-Bottom,5266,580,271,103,542,813,1,104,5380,0,0,0,0
Barbershop-Top,5267,580,271,102,542,813,106,208,5381,0,0,0,0
!Barbershop-MiddleTile,5268,580,271,128,1,272,0,128,5382,0,0,2,0
AftLevelup-CloudyLineLeft,5269,607,255,67,746,1001,317,384,5383,0,0,0,0
AftLevelup-CloudyLineRight,5270,607,255,67,737,992,576,643,5384,0,0,0,0
AftLevelup-Dots1,5271,607,46,32,501,547,1,33,5385,0,0,0,0
AftLevelup-Dots2,5272,607,77,45,258,335,973,1018,5386,0,0,0,0
AftLevelup-GlowLine,5273,607,322,18,502,824,556,574,5387,0,0,0,0
AftLevelup-IconFrame,5274,607,80,80,126,206,909,989,5388,0,0,0,0
AftLevelup-IconGlow,5275,607,80,80,489,569,75,155,5389,0,0,0,0
AftLevelup-Lines1,5276,607,108,115,502,610,439,554,5390,0,0,0,0
AftLevelup-Lines2,5277,607,93,110,123,216,332,442,5391,0,0,0,0
AftLevelup-SoftCloud,5278,607,256,96,612,868,439,535,5392,0,0,0,0
AftLevelup-ToastBG,5279,607,275,77,746,1021,811,888,5393,0,0,0,0
AftLevelup-FiligreeLeft,5280,607,138,34,746,884,386,420,5267,0,0,0,0
AftLevelup-FiligreeRight,5281,607,138,34,695,833,1,35,5268,0,0,0,0
transmog-nav-slot-secondaryhand,5282,610,35,37,277,312,115,152,5370,0,0,0,0
AftLevelup-WhiteIconGlow,5283,607,97,97,126,223,688,785,5269,0,0,0,0
AftLevelup-WhiteStarBurst,5284,607,133,133,820,953,890,1023,5270,0,0,0,0
_transmog-preview-QuestPortrait-Divider_noname,5287,719,128,44,0,128,1,45,5321,0,0,4,0
_transmog-preview-QuestPortrait-StoneSwirls-Top,5288,719,128,18,0,128,47,65,5322,0,0,4,0
transmog-icon-downarrow,5289,610,15,9,428,443,80,89,5271,0,0,0,0
Forge-ColorSwatch,5291,720,55,55,1,56,965,1020,4982,0,0,0,0
Forge-ColorSwatchBorder,5292,720,55,55,111,166,846,901,4962,0,0,0,0
Forge-ColorSwatchSelection,5293,720,55,55,111,166,960,1015,4963,0,0,0,0
Forge-Lock,5294,720,55,55,177,232,723,778,4964,0,0,0,0
ForgeBorder-CornerBottomLeft,5295,720,64,64,1,65,833,897,4965,0,0,0,0
ForgeBorder-CornerBottomRight,5296,720,64,64,1,65,899,963,4966,0,0,0,0
ForgeBorder-CornerTopRight,5297,720,64,64,111,175,723,787,4967,0,0,0,0
Forge-Background,5298,720,460,615,1,461,1,616,4968,0,0,0,0
Artifacts-HeaderBG,5299,607,720,118,258,978,197,315,5394,0,0,0,0
Artifacts-Paladin-Header,5300,650,720,83,1,721,618,701,5395,0,0,0,0
Artifacts-DeathKnightFrost-Header,5301,677,720,125,1,721,618,743,5396,0,0,0,0
Artifacts-DemonHunter-Header,5302,649,896,126,1,897,618,744,5397,0,0,0,0
Artifacts-Druid-Header,5303,680,896,180,1,897,618,798,5398,0,0,0,0
search-iconframe-large,5304,565,38,38,387,425,30,68,5399,0,0,0,0
search-highlight-large,5305,565,256,47,1,257,30,77,5400,0,0,0,0
Artifacts-Hunter-Header,5306,710,720,65,1,721,618,683,5401,0,0,0,0
Artifacts-MageArcane-Header,5307,662,720,138,1,721,618,756,5402,0,0,0,0
Artifacts-Monk-Header,5308,712,896,145,1,897,618,763,5403,0,0,0,0
Artifacts-Priest-Header,5309,711,720,110,1,721,618,728,5404,0,0,0,0
Artifacts-Rogue-Header,5310,679,720,79,1,721,618,697,5405,0,0,0,0
Artifacts-Shaman-Header,5311,709,720,99,1,721,618,717,5138,0,0,0,0
Artifacts-Warlock-Header,5312,713,720,92,1,721,618,710,5139,0,0,0,0
Artifacts-Warrior-Header,5313,678,720,62,283,1003,618,680,5140,0,0,0,0
titleprestige-prestigeiconplate-alliance,5314,701,158,171,840,998,330,501,5330,0,0,0,0
titleprestige-prestigeiconplate-horde,5315,701,158,171,358,516,626,797,5331,0,0,0,0
Artifacts-PerkRing-WhiteGlow,5318,607,50,50,971,1021,1,51,5332,0,0,0,0
adventuremapquest-portraitbg,5319,703,44,44,354,398,414,458,5333,0,0,0,0
Rune-01-dark,5320,721,75,77,1,76,1,78,5272,0,0,0,0
Rune-01-light,5321,721,75,77,1,76,80,157,5273,0,0,0,0
Rune-02-dark,5322,721,75,77,1,76,159,236,5274,0,0,0,0
Rune-02-light,5323,721,75,77,1,76,238,315,5275,0,0,0,0
Rune-03-dark,5324,721,75,77,1,76,317,394,5276,0,0,0,0
Rune-03-light,5325,721,75,77,1,76,396,473,5277,0,0,0,0
Rune-04-dark,5326,721,75,77,78,153,1,78,5278,0,0,0,0
Rune-04-light,5327,721,75,77,155,230,1,78,5279,0,0,0,0
Rune-05-dark,5328,721,75,77,232,307,1,78,5280,0,0,0,0
Rune-05-light,5329,721,75,77,309,384,1,78,5281,0,0,0,0
Rune-06-dark,5330,721,75,77,386,461,1,78,5334,0,0,0,0
Rune-06-light,5331,721,75,77,78,153,80,157,5335,0,0,0,0
Rune-07-dark,5332,721,75,77,78,153,159,236,5336,0,0,0,0
Rune-07-light,5333,721,75,77,78,153,238,315,5337,0,0,0,0
Rune-08-dark,5334,721,75,77,78,153,317,394,5338,0,0,0,0
Rune-08-light,5335,721,75,77,78,153,396,473,5339,0,0,0,0
Rune-09-dark,5336,721,75,77,155,230,80,157,5340,0,0,0,0
Rune-09-light,5337,721,75,77,232,307,80,157,5341,0,0,0,0
Rune-10-dark ,5338,721,75,77,309,384,80,157,5342,0,0,0,0
Rune-10-light,5339,721,75,77,386,461,80,157,5343,0,0,0,0
Rune-11-dark,5340,721,75,77,155,230,159,236,5344,0,0,0,0
Rune-11-light,5341,721,75,77,155,230,238,315,5345,0,0,0,0
Mage-ArcaneCharge-CircleGlow,5342,704,41,41,60,101,18,59,5141,0,0,0,0
Mage-ArcaneCharge-Rune,5343,704,46,45,1,47,75,120,5142,0,0,0,0
Mage-ArcaneCharge-SmallSpark,5344,704,38,39,103,141,18,57,5143,0,0,0,0
Mage-ArcaneCharge-Spark,5345,704,57,72,1,58,1,73,5144,0,0,0,0
Forge-AppearanceStrip,5346,720,460,103,1,461,618,721,5346,0,0,0,0
Forge-ColorSwatchBackground,5347,720,55,55,111,166,789,844,5347,0,0,0,0
Forge-ColorSwatchHighlight,5348,720,55,55,111,166,903,958,5348,0,0,0,0
AdventureMap_TopBorder,5349,722,1002,668,1,1003,1,669,5145,0,0,0,0
AdventureMap_TileBg,5350,723,512,512,0,512,0,512,5146,0,0,6,0
Artifacts-PriestShadow-BG,5351,724,896,615,1,897,1,616,5147,0,0,0,0
Artifacts-PriestShadow-Header,5352,724,720,114,1,721,618,732,5148,0,0,0,0
bags-glow-artifact,5354,202,39,39,317,356,1,40,5349,0,0,0,0
adventuremap-insetmapborder,5355,703,446,308,354,800,1,309,5350,0,0,0,0
Artifacts-Paladin-KnowledgeRank,5357,650,57,56,899,956,89,145,5149,0,0,0,0
ClassOverlay-HolyPower1off,5358,725,32,22,69,101,36,58,5150,0,0,0,0
ClassOverlay-HolyPower1on,5359,725,32,22,136,168,1,23,5151,0,0,0,0
ClassOverlay-HolyPower2off,5360,725,33,20,170,203,1,21,5152,0,0,0,0
ClassOverlay-HolyPower2on,5361,725,33,20,205,238,1,21,5153,0,0,0,0
ClassOverlay-HolyPower3off,5362,725,32,24,1,33,36,60,5154,0,0,0,0
ClassOverlay-HolyPower3on,5363,725,32,24,35,67,36,60,5155,0,0,0,0
ClassOverlay-HolyPower4off,5364,725,33,17,170,203,23,40,5156,0,0,0,0
ClassOverlay-HolyPower4on,5365,725,33,17,170,203,42,59,5157,0,0,0,0
ClassOverlay-HolyPower5off,5366,725,33,17,205,238,23,40,5158,0,0,0,0
ClassOverlay-HolyPower5on,5367,725,33,17,205,238,42,59,5159,0,0,0,0
ClassOverlay-HolyPowerBG,5368,725,133,33,1,134,1,34,5160,0,0,0,0
Artifacts-DeathKnightFrost-KnowledgeRank,5369,677,57,56,899,956,89,145,5161,0,0,0,0
Artifacts-DemonHunter-KnowledgeRank,5370,649,57,56,899,956,89,145,5162,0,0,0,0
Artifacts-Druid-KnowledgeRank,5371,680,57,56,899,956,89,145,5163,0,0,0,0
Artifacts-Hunter-KnowledgeRank,5372,710,57,56,899,956,89,145,5164,0,0,0,0
Artifacts-MageArcane-KnowledgeRank,5373,662,57,56,899,956,89,145,5165,0,0,0,0
Artifacts-Monk-KnowledgeRank,5374,712,57,56,899,956,89,145,5166,0,0,0,0
Artifacts-Priest-KnowledgeRank,5375,711,57,56,899,956,89,145,5167,0,0,0,0
Artifacts-PriestShadow-KnowledgeRank,5376,724,57,56,899,956,89,145,5168,0,0,0,0
Artifacts-Rogue-KnowledgeRank,5377,679,57,56,899,956,89,145,5169,0,0,0,0
Artifacts-Shaman-KnowledgeRank,5378,709,57,56,899,956,89,145,5170,0,0,0,0
Artifacts-Warlock-KnowledgeRank,5379,713,57,56,899,956,89,145,5176,0,0,0,0
Artifacts-Warrior-KnowledgeRank,5380,678,57,56,899,956,89,145,5177,0,0,0,0
ClassOverlay-Fury,5381,726,118,11,1,119,1,12,5178,0,0,0,0
ClassOverlay-FuryBG,5382,726,118,11,1,119,14,25,5180,0,0,0,0
ClassOverlay-Rune,5383,727,25,28,1,26,1,29,5181,0,0,0,0
ClassOverlay-RunicPower,5384,727,142,6,28,170,1,7,5182,0,0,0,0
ClassOverlay-RunicPowerBg,5385,727,142,6,28,170,9,15,5184,0,0,0,0
ClassOverlay-ComboPoint,5386,728,20,20,29,49,44,64,5185,0,0,0,0
LegionSplash-NewCharacter,5388,729,822,362,1,823,1,363,4858,0,0,0,0
LegionSplash-DemonHunterButton,5389,729,504,84,503,1007,365,449,4851,0,0,0,0
LegionSplash-Logo,5390,729,500,238,1,501,365,603,4859,0,0,0,0
LegionSplash-NewCharacterButton,5392,729,465,84,503,968,451,535,4860,0,0,0,0
LegionSplash-DemonHunter,5393,730,942,759,1,943,1,760,4861,0,0,0,0
legioninvasion-title-bg,5394,693,467,141,1,468,1,142,4862,0,0,0,0
transmog-nav-slot-enchant,5395,610,29,29,332,361,154,183,5351,0,0,0,0
transmog-nav-slot-selected-small,5396,610,34,35,224,258,154,189,5352,0,0,0,0
honorsystem-portrait-neutral,5398,698,50,52,53,103,391,443,5353,0,0,0,0
nameplates-holypower1-off,5399,731,25,19,1,26,104,123,5354,0,0,0,0
nameplates-holypower1-on,5400,731,25,19,102,127,30,49,5355,0,0,0,0
nameplates-holypower2-off,5401,731,26,17,129,155,30,47,5356,0,0,0,0
nameplates-holypower2-on,5402,731,26,17,157,183,30,47,5357,0,0,0,0
nameplates-holypower3-off,5403,731,24,17,102,126,95,112,5358,0,0,0,0
nameplates-holypower3-on,5404,731,24,17,185,209,30,47,5359,0,0,0,0
nameplates-holypower4-off,5405,731,25,14,211,236,30,44,5360,0,0,0,0
nameplates-holypower4-on,5406,731,25,14,129,154,49,63,5361,0,0,0,0
nameplates-playerhealth-background,5407,731,126,12,1,127,16,28,5362,0,0,0,0
nameplates-InterruptShield,5409,731,14,16,238,252,30,46,5406,0,0,0,0
nameplate-WarlockShard-Off,5411,732,17,17,1,18,26,43,5407,0,0,0,0
nameplate-WarlockShard-On,5412,732,17,17,1,18,45,62,5408,0,0,0,0
nameplate-WarlockShard-Glow,5413,732,26,23,1,27,1,24,5409,0,0,0,0
ClassOverlay-ComboPoint-Off,5414,728,20,20,29,49,66,86,5410,0,0,0,0
insanity-drippypurple1,5415,705,49,33,196,245,51,84,5411,0,0,0,0
insanity-drippypurple2,5416,705,49,29,132,181,175,204,5412,0,0,0,0
insanity-portraitoverlay,5417,705,193,77,1,194,13,90,5413,0,0,0,0
insanity-purpleburston,5418,705,174,27,1,175,146,173,5414,0,0,0,0
insanity-shadowburston,5419,705,139,34,107,246,92,126,5415,0,0,0,0
insanity-tentacles,5420,705,129,30,1,130,175,205,5416,0,0,0,0
insanity-toppurpleshadow,5421,705,104,52,1,105,92,144,5417,0,0,0,0
insanity-spark,5423,705,9,41,1,10,207,248,5419,0,0,0,0
tradeskills-star-off,5424,734,20,19,62,82,489,508,5420,0,0,0,0
tradeskills-star,5425,734,20,19,62,82,468,487,5421,0,0,0,0
tradeskill-background-recipe,5426,734,300,383,1,301,1,384,5422,0,0,0,0
tradeskill-background-recipe-unlearned,5427,734,300,383,303,603,1,384,5423,0,0,0,0
loottoast-itemborder-heirloom,5429,332,58,58,927,985,218,276,5425,0,0,0,0
ComboPoints-AllPointsBG,5430,728,126,18,1,127,1,19,5426,0,0,0,0
ComboPoints-PointBg,5431,728,20,21,1,21,100,121,5424,0,0,0,0
ComboPoints-ComboPointDash,5432,728,9,10,117,126,21,31,5427,0,0,0,0
ComboPoints-ComboPointDash-Bg,5433,728,9,10,29,38,88,98,5428,0,0,0,0
ComboPoints-ComboPoint,5434,728,20,21,1,21,77,98,5429,0,0,0,0
ComboPoints-FX-Circle,5435,728,26,27,1,27,21,48,5430,0,0,0,0
ComboPoints-FX-Dash,5436,728,25,8,51,76,44,52,5431,0,0,0,0
ComboPoints-FX-Star,5437,728,25,25,1,26,50,75,5432,0,0,0,0
obliterumforge-background,5438,735,322,160,1,323,1,161,5433,0,0,0,0
obliterumforge-slotted-corners-glow,5439,735,132,60,325,457,1,61,5434,0,0,0,0
obliterumforge-slotted-corners,5440,735,132,60,325,457,63,123,5435,0,0,0,0
ChallengeMode-AffixRing-Lg,5442,736,52,52,934,986,55,107,5436,0,0,0,0
ChallengeMode-AffixRing-Sm,5443,736,34,34,988,1022,1,35,5437,0,0,0,0
ChallengeMode-DungeonIconFrame,5444,736,52,52,934,986,1,53,5438,0,0,0,0
ChallengeMode-KeystoneFrame,5445,736,398,548,137,535,400,948,5439,0,0,0,0
ChallengeMode-KeystoneSlotBG,5446,736,114,114,1,115,779,893,5440,0,0,0,0
ChallengeMode-KeystoneSlotFrame,5447,736,120,120,1,121,657,777,5441,0,0,0,0
ChallengeMode-KeystoneSlotFrameGlow,5448,736,120,120,1,121,535,655,5442,0,0,0,0
ChallengeMode-MainTabBg,5449,736,548,397,1,549,1,398,5443,0,0,0,0
ChallengeMode-ThinDivider,5453,736,365,3,551,916,384,387,5446,0,0,0,0
_DemonHunter-DemonicPainBar,5458,690,128,10,0,128,13,23,5567,0,0,4,0
GlyphIcon-Spellbook,5494,741,21,22,1,22,1,23,5531,0,0,0,0
ChallengeMode-Runes-GlowLarge,5495,736,392,391,537,929,630,1021,5519,0,0,0,0
ChallengeMode-Runes-Large,5496,736,381,381,551,932,1,382,5520,0,0,0,0
ChallengeMode-Runes-LineGlow,5497,736,242,228,537,779,400,628,5521,0,0,0,0
BossBanner-PortraitBorder,5498,569,61,61,1,62,436,497,5522,0,0,0,0
ChallengeMode-SoftYellowGlow,5499,569,206,206,1,207,1,207,5523,0,0,0,0
ChallengeMode-SpikeyStar,5500,569,200,200,1,201,209,409,5524,0,0,0,0
ChallengeMode-Timer,5501,569,261,87,621,882,113,200,5525,0,0,0,0
ChallengeMode-TimerBG,5502,569,223,11,649,872,81,92,5526,0,0,0,0
ChallengeMode-TimerFill,5503,569,223,11,621,844,202,213,5527,0,0,0,0
ChallengeMode-WhiteSpikeyGlow,5504,569,186,209,209,395,1,210,5528,0,0,0,0
ChallengeMode-Runes-BackgroundCoverGlow,5505,737,276,275,713,989,304,579,5529,0,0,0,0
ChallengeMode-Runes-GlowBurstLarge,5506,737,234,234,514,748,713,947,5503,0,0,0,0
ChallengeMode-Runes-GlowSmall,5507,737,261,260,1,262,713,973,5504,0,0,0,0
ChallengeMode-RuneBG,5508,737,710,710,1,711,1,711,5505,0,0,0,0
ChallengeMode-Runes-BackgroundBurst,5509,737,300,301,713,1013,1,302,5506,0,0,0,0
ChallengeMode-Runes-BL-Glow,5510,737,78,78,811,889,581,659,5507,0,0,0,0
ChallengeMode-Runes-BR-Glow,5511,737,78,78,891,969,581,659,5508,0,0,0,0
ChallengeMode-Runes-InnerCircleGlow,5512,737,211,209,750,961,713,922,5509,0,0,0,0
ChallengeMode-Runes-L-Glow,5513,737,78,78,750,828,924,1002,5510,0,0,0,0
ChallengeMode-Runes-R-Glow,5514,737,78,78,830,908,924,1002,5511,0,0,0,0
ChallengeMode-Runes-Small,5515,737,248,248,264,512,713,961,5512,0,0,0,0
ChallengeMode-Runes-T-Glow,5516,737,78,78,910,988,924,1002,5513,0,0,0,0
ChallengeMode-Runes-CircleGlow,5517,737,96,96,713,809,581,677,5514,0,0,0,0
recipetoast-bg,5518,742,312,89,1,313,1,90,5558,0,0,0,0
recipetoast-icon-star,5519,742,20,19,1,21,92,111,5559,0,0,0,0
transmog-wardrobe-border-unusable,5520,610,96,122,105,201,115,237,5496,0,0,0,0
worldquest-icon-clock,5521,743,22,22,489,511,1,23,5532,0,0,0,0
worldquest-questmarker-dragon-glow,5524,743,96,96,1,97,296,392,5533,48,48,0,0
worldquest-questmarker-dragon,5525,743,64,64,202,266,428,492,5534,32,32,0,0
worldquest-questmarker-epic-down,5526,743,64,64,268,332,428,492,5535,32,32,0,0
worldquest-questmarker-epic,5527,743,64,64,268,332,362,426,5536,32,32,0,0
worldquest-questmarker-glow,5528,743,36,36,334,370,362,398,5537,0,0,0,0
worldquest-questmarker-questbang,5530,743,8,17,192,200,418,435,5538,0,0,0,0
worldquest-tracker-checkmark,5531,743,40,35,466,506,296,331,5539,0,0,0,0
worldquest-tracker-questmarker-gray,5532,743,25,25,466,491,333,358,5540,0,0,0,0
worldquest-tracker-questmarker,5533,743,25,25,165,190,418,443,5541,0,0,0,0
worldquest-tracker,5534,743,278,71,1,279,223,294,5542,0,0,0,0
ChallengeMode-Runes-SmallCircleGlow,5535,736,134,133,1,135,400,533,5497,0,0,0,0
worldquest-questmarker-questionmark,5537,743,13,17,181,194,484,501,5560,0,0,0,0
ChallengeMode-Runes-Shockwave,5538,736,206,209,781,987,400,609,5498,0,0,0,0
ChallengeMode-Chest,5540,569,175,130,209,384,212,342,5445,0,0,0,0
worldquest-icon-pvp-ffa,5558,743,14,14,250,264,494,508,5565,0,0,0,0
worldquest-tracker-ring-selected,5559,743,44,44,47,91,460,504,5566,0,0,0,0
worldquest-tracker-ring,5560,743,44,44,1,45,460,504,5568,0,0,0,0
ChallengeMode-icon-chest,5561,569,19,20,187,206,411,431,5454,0,0,0,0
ChallengeMode-icon-redline,5562,569,19,19,64,83,436,455,5455,0,0,0,0
ChallengeMode-TimerBG-back,5563,569,223,11,649,872,94,105,5456,0,0,0,0
LegionMissionIcon-ZoneSupportAlliance-Map,5564,745,64,64,1,65,1,65,5457,0,0,0,0
orderhalltalents-background-mage,5569,746,322,382,1,323,1,383,5462,0,0,0,0
orderhalltalents-background-deathknight,5577,747,322,382,1,323,1,383,5468,0,0,0,0
orderhalltalents-background-demonhunter,5578,748,322,382,1,323,1,383,5469,0,0,0,0
orderhalltalents-background-druid,5579,749,322,382,1,323,1,383,5458,0,0,0,0
orderhalltalents-background-hunter,5580,750,322,382,1,323,1,383,5459,0,0,0,0
orderhalltalents-background-monk,5581,751,322,382,1,323,1,383,5460,0,0,0,0
orderhalltalents-background-paladin,5582,752,322,382,1,323,1,383,5461,0,0,0,0
orderhalltalents-background-priest,5583,753,322,382,1,323,1,383,5463,0,0,0,0
orderhalltalents-background-rogue,5584,754,322,382,1,323,1,383,5464,0,0,0,0
orderhalltalents-background-shaman,5585,755,322,382,1,323,1,383,5465,0,0,0,0
orderhalltalents-background-warlock,5586,756,322,382,1,323,1,383,5466,0,0,0,0
orderhalltalents-background-warrior,5587,757,322,382,1,323,1,383,5467,0,0,0,0
orderhalltalents-choice-background,5590,758,163,59,303,466,1,60,5561,0,0,0,0
orderhalltalents-spellborder-green,5591,758,50,50,73,123,393,443,5562,0,0,0,0
orderhalltalents-spellborder-yellow,5592,758,50,50,73,123,445,495,5563,0,0,0,0
orderhalltalents-spellborder,5593,758,50,50,73,123,341,391,5564,0,0,0,0
LegionMissionIcon-ZoneSupportAlliance-MapBadge,5594,745,34,34,199,233,1,35,5471,0,0,0,0
LegionMissionIcon-ZoneSupportHorde-Map,5595,745,64,64,133,197,1,65,5472,0,0,0,0
LegionMissionIcon-ZoneSupportHorde-MapBadge,5596,745,34,34,1,35,133,167,5473,0,0,0,0
LegionMissionIcon-ZoneSupportAlliance-Mission,5597,745,64,64,67,131,1,65,5474,0,0,0,0
LegionMissionIcon-ZoneSupportHorde-Mission,5598,745,64,64,1,65,67,131,5475,0,0,0,0
orderhalltalents-timer-bg,5599,758,64,64,1,65,371,435,5543,0,0,0,0
legionmission-map-orderhall-deathknight,5601,759,99,66,1,100,1,67,5544,0,0,0,0
legionmission-map-orderhall-demonhunter,5602,759,99,66,1,100,137,203,5545,0,0,0,0
legionmission-map-orderhall-druid,5603,759,99,66,1,100,69,135,5546,0,0,0,0
legionmission-map-orderhall-glow,5604,759,142,109,203,345,69,178,5547,0,0,0,0
legionmission-map-orderhall-hunter,5605,759,99,66,102,201,1,67,5548,0,0,0,0
legionmission-map-orderhall-mage,5606,759,99,66,102,201,69,135,5549,0,0,0,0
legionmission-map-orderhall-monk,5607,759,99,66,102,201,137,203,5550,0,0,0,0
legionmission-map-orderhall-paladin,5608,759,99,66,203,302,1,67,5551,0,0,0,0
legionmission-map-orderhall-priest,5609,759,99,66,304,403,1,67,5552,0,0,0,0
legionmission-map-orderhall-rogue,5610,759,99,66,405,504,1,67,5553,0,0,0,0
legionmission-map-orderhall-shaman,5611,759,99,66,347,446,69,135,5554,0,0,0,0
legionmission-map-orderhall-warlock,5612,759,99,66,347,446,137,203,5555,0,0,0,0
legionmission-map-orderhall-warrior,5613,759,99,66,203,302,180,246,5556,0,0,0,0
legionmission-map-orderhall-textglow,5614,759,122,22,347,469,205,227,5557,0,0,0,0
worldquest-icon-alchemy,5615,743,16,16,489,505,205,221,5476,0,0,0,0
worldquest-icon-archaeology,5616,743,14,14,234,248,494,508,5477,0,0,0,0
worldquest-icon-blacksmithing,5617,743,14,15,202,216,494,509,5478,0,0,0,0
worldquest-icon-cooking,5618,743,20,20,489,509,25,45,5479,0,0,0,0
worldquest-icon-enchanting,5619,743,16,16,99,115,494,510,5480,0,0,0,0
worldquest-icon-engineering,5620,743,14,15,218,232,494,509,5481,0,0,0,0
worldquest-icon-firstaid,5621,743,10,10,406,416,378,388,5482,0,0,0,0
worldquest-icon-fishing,5622,743,13,13,284,297,494,507,5483,0,0,0,0
worldquest-icon-herbalism,5623,743,13,13,299,312,494,507,5484,0,0,0,0
worldquest-icon-inscription,5624,743,11,14,406,417,362,376,5485,0,0,0,0
worldquest-icon-jewelcrafting,5625,743,14,11,158,172,499,510,5486,0,0,0,0
worldquest-icon-leatherworking,5626,743,13,12,143,156,499,511,5487,0,0,0,0
worldquest-icon-mining,5627,743,12,13,314,326,494,507,5488,0,0,0,0
worldquest-icon-skinning,5628,743,14,13,268,282,494,507,5489,0,0,0,0
worldquest-icon-tailoring,5629,743,12,13,493,505,333,346,5490,0,0,0,0
worldquest-icon-petbattle,5637,743,13,11,493,506,348,359,5499,0,0,0,0
demoninvasion5,5639,647,32,32,377,409,715,747,5500,0,0,0,0
book-bg,5640,761,486,494,1,487,1,495,5501,0,0,0,0
book-line,5641,761,411,8,1,412,497,505,5502,0,0,0,0
_orderhall-commandbar-bg,5642,762,128,25,0,128,1,26,5491,0,0,4,0
worldquest-icon-boss,5643,743,32,32,334,366,434,466,5492,16,16,0,0
transmog-icon-hidden,5647,610,36,30,260,296,154,184,5493,0,0,0,0
orderhalltalents-choice-arrow-large,5648,758,47,27,303,350,123,150,5494,0,0,0,0
orderhalltalents-choice-background-on,5650,758,163,59,303,466,62,121,5495,0,0,0,0
LegendaryToast-particles3,5651,764,84,163,203,287,294,457,5515,0,0,0,0
LegendaryToast-particles2,5652,764,78,147,329,407,122,269,5516,0,0,0,0
LegendaryToast-background,5655,764,302,119,203,505,1,120,5517,0,0,0,0
LegendaryToast-ring1,5656,764,131,176,1,132,205,381,5518,0,0,0,0
LegendaryToast-particles1,5657,764,124,170,203,327,122,292,5530,0,0,0,0
tradeskills-iconborder,5662,734,46,46,1,47,447,493,5676,0,0,0,0
LegendaryToast-OrangeStarglow,5663,764,200,202,1,201,1,203,5712,0,0,0,0
loottoast-itemborder-artifact,5667,332,58,58,687,745,218,276,5604,0,0,0,0
adventureguide-icon-whatsnew,5668,609,37,37,347,384,51,88,5605,0,0,0,0
adventureguide-microbutton-alert,5669,768,28,28,1,29,1,29,5606,0,0,0,0
transmog-frame-blackcover,5670,610,46,45,445,491,60,105,5713,0,0,0,0
transmog-frame-highlighted,5839,610,44,41,105,149,284,325,5714,0,0,0,0
transmog-background-race-bloodelf,5840,770,294,494,1,295,1,495,5715,0,0,0,0
transmog-background-race-human,5841,771,294,494,1,295,1,495,5716,0,0,0,0
transmog-background-race-draenei,5842,772,294,494,1,295,1,495,5717,0,0,0,0
transmog-background-race-dwarf,5843,773,294,494,1,295,1,495,5718,0,0,0,0
transmog-background-race-gnome,5844,774,294,494,1,295,1,495,5719,0,0,0,0
transmog-background-race-goblin,5845,775,294,494,1,295,1,495,5720,0,0,0,0
transmog-background-race-nightelf,5846,776,294,494,1,295,1,495,5721,0,0,0,0
transmog-background-race-orc,5847,777,294,494,1,295,1,495,5722,0,0,0,0
transmog-background-race-pandaren,5848,778,294,494,1,295,1,495,5723,0,0,0,0
transmog-background-race-tauren,5849,779,294,494,1,295,1,495,5724,0,0,0,0
transmog-background-race-troll,5850,780,294,494,1,295,1,495,5725,0,0,0,0
transmog-background-race-worgen,5852,782,294,494,1,295,1,495,5727,0,0,0,0
adventuremap-combatally-clouds,5853,703,117,95,802,919,74,169,5728,0,0,0,0
adventuremap-combatally-empty,5854,703,46,46,888,934,260,306,5729,0,0,0,0
adventuremap-combatally-ring,5855,703,58,58,288,346,889,947,5730,0,0,0,0
adventuremap-textlabelglow,5856,703,122,22,1,123,1001,1023,5731,0,0,0,0
legionmission-EncounterAbilityBorder-Lg,5857,783,61,61,1,62,158,219,5732,0,0,0,0
legionmission-EncounterAbilityBorder,5858,783,35,35,212,247,1,36,5733,0,0,0,0
worldquest-followerabilityframe,5859,743,101,86,99,200,296,382,5569,0,0,0,0
worldquest-questmarker-abilityhighlight,5860,743,42,42,99,141,450,492,5570,0,0,0,0
transmog-frame-highlighted-small,5863,610,24,24,169,193,487,511,5571,0,0,0,0
nameplates-bar-background-white,5864,731,254,13,1,255,1,14,5607,0,0,0,0
_honorsystem-bar-fill-rested,5865,697,256,17,0,256,20,37,5608,0,0,4,0
honorsystem-bar-frame-exhaustiontick-highlight,5866,696,17,35,1000,1017,118,153,5609,0,0,0,0
honorsystem-bar-frame-exhaustiontick,5867,696,17,35,981,998,118,153,5610,0,0,0,0
legionmission-complete-background-deathknight,5869,785,690,333,1,691,1,334,5734,0,0,0,0
legionmission-complete-background-demonhunter,5870,786,690,333,1,691,1,334,5735,0,0,0,0
legionmission-complete-background-druid,5871,787,690,333,1,691,1,334,5736,0,0,0,0
legionmission-complete-background-hunter,5872,788,690,333,1,691,1,334,5737,0,0,0,0
legionmission-complete-background-mage,5873,789,690,333,1,691,1,334,5738,0,0,0,0
legionmission-complete-background-monk,5874,790,690,333,1,691,1,334,5739,0,0,0,0
legionmission-complete-background-paladin,5875,791,690,333,1,691,1,334,5740,0,0,0,0
legionmission-complete-background-priest,5876,792,690,333,1,691,1,334,5741,0,0,0,0
legionmission-complete-background-rogue,5877,793,690,333,1,691,1,334,5742,0,0,0,0
legionmission-complete-background-shaman,5878,794,690,333,1,691,1,334,5743,0,0,0,0
legionmission-complete-background-warlock,5879,795,690,333,1,691,1,334,5744,0,0,0,0
legionmission-complete-background-warrior,5880,796,690,333,1,691,1,334,5745,0,0,0,0
legionmission-landingpage-background-deathknight,5881,797,229,184,1,230,1,185,5611,0,0,0,0
legionmission-landingpage-background-demonhunter,5882,798,230,236,1,231,1,237,5612,0,0,0,0
legionmission-landingpage-background-druid,5883,799,230,219,1,231,1,220,5613,0,0,0,0
legionmission-landingpage-background-hunter,5884,800,225,228,1,226,1,229,5614,0,0,0,0
legionmission-landingpage-background-mage,5885,801,230,203,1,231,1,204,5615,0,0,0,0
legionmission-landingpage-background-monk,5886,802,221,249,1,222,1,250,5616,0,0,0,0
legionmission-landingpage-background-paladin,5887,803,200,250,1,201,1,251,5617,0,0,0,0
legionmission-landingpage-background-priest,5888,804,230,190,1,231,1,191,5618,0,0,0,0
legionmission-landingpage-background-rogue,5889,805,231,211,1,232,1,212,5619,0,0,0,0
legionmission-landingpage-background-shaman,5890,806,209,250,1,210,1,251,5620,0,0,0,0
legionmission-landingpage-background-warlock,5891,807,230,184,1,231,1,185,5621,0,0,0,0
legionmission-landingpage-background-warrior,5892,808,181,253,1,182,1,254,5622,0,0,0,0
legionmission-landingbutton-deathknight-down,5893,809,53,53,1,54,1,54,5677,0,0,0,0
legionmission-landingbutton-deathknight-up,5894,809,53,53,56,109,1,54,5678,0,0,0,0
legionmission-landingbutton-demonhunter-down,5895,810,53,53,1,54,1,54,5679,0,0,0,0
legionmission-landingbutton-demonhunter-up,5896,810,53,53,56,109,1,54,5680,0,0,0,0
legionmission-landingbutton-druid-down,5897,811,53,53,1,54,1,54,5681,0,0,0,0
legionmission-landingbutton-druid-up,5898,811,53,53,56,109,1,54,5682,0,0,0,0
legionmission-landingbutton-hunter-down,5899,812,53,53,1,54,1,54,5683,0,0,0,0
legionmission-landingbutton-hunter-up,5900,812,53,53,56,109,1,54,5684,0,0,0,0
legionmission-landingbutton-mage-down,5901,813,53,53,1,54,1,54,5685,0,0,0,0
legionmission-landingbutton-mage-up,5902,813,53,53,56,109,1,54,5686,0,0,0,0
legionmission-landingbutton-monk-down,5903,814,53,53,1,54,1,54,5687,0,0,0,0
legionmission-landingbutton-monk-up,5904,814,53,53,56,109,1,54,5688,0,0,0,0
legionmission-landingbutton-paladin-down,5905,815,53,53,1,54,1,54,5689,0,0,0,0
legionmission-landingbutton-paladin-up,5906,815,53,53,56,109,1,54,5690,0,0,0,0
legionmission-landingbutton-priest-down,5907,816,53,53,1,54,1,54,5691,0,0,0,0
legionmission-landingbutton-priest-up,5908,816,53,53,56,109,1,54,5692,0,0,0,0
legionmission-landingbutton-rogue-down,5909,817,53,53,1,54,1,54,5693,0,0,0,0
legionmission-landingbutton-rogue-up,5910,817,53,53,56,109,1,54,5694,0,0,0,0
legionmission-landingbutton-shaman-down,5911,818,53,53,1,54,1,54,5695,0,0,0,0
legionmission-landingbutton-shaman-up,5912,818,53,53,56,109,1,54,5696,0,0,0,0
legionmission-landingbutton-warlock-down,5913,819,53,53,1,54,1,54,5697,0,0,0,0
legionmission-landingbutton-warlock-up,5914,819,53,53,56,109,1,54,5698,0,0,0,0
legionmission-landingbutton-warrior-down,5915,820,53,53,1,54,1,54,5699,0,0,0,0
legionmission-landingbutton-warrior-up,5916,820,53,53,56,109,1,54,5700,0,0,0,0
transmog-wardrobe-border-current,5917,610,84,110,123,207,1,111,5701,0,0,0,0
transmog-wardrobe-border-selected-wisp,5918,610,28,19,421,449,154,173,5702,0,0,0,0
transmog-wardrobe-border-current-transmogged,5919,610,84,110,209,293,1,111,5703,0,0,0,0
glueannouncementpopup-arrow,5920,821,64,47,544,608,536,583,5704,0,0,0,0
glueannouncementpopup-background,5921,821,800,533,1,801,1,534,5705,0,0,0,0
glueannouncementpopup-icon-info,5922,821,21,21,610,631,536,557,5706,0,0,0,0
glueannouncementpopup-inset,5923,821,361,86,1345,1706,1,87,5707,0,0,0,0
loottab-set-itemborder-green,5925,822,41,41,44,85,1,42,5639,0,0,0,0
loottab-set-itemborder-purple,5926,822,41,41,1,42,1,42,5640,0,0,0,0
loottab-set-itemborder-blue,5929,822,41,41,87,128,1,42,5641,0,0,0,0
poi-alliance,5930,647,32,32,445,477,749,781,5708,0,0,0,0
poi-horde,5931,647,32,32,445,477,783,815,5709,0,0,0,0
GarrisonTroops-Health-Consume,5932,783,15,13,229,244,38,51,5710,0,0,0,0
GarrisonTroops-Health,5933,783,15,13,212,227,38,51,5711,0,0,0,0
BonusChest-BonusTextGlow,5935,308,311,61,159,470,1,62,5746,0,0,0,0
GarrMission_ClassIcon-DeathKnight-Blood,5936,823,55,49,172,227,154,203,5572,0,0,0,0
GarrMission_ClassIcon-DeathKnight-Frost,5937,823,55,49,343,398,1,50,5573,0,0,0,0
GarrMission_ClassIcon-DeathKnight-Unholy,5938,823,55,49,115,170,103,152,5574,0,0,0,0
GarrMission_ClassIcon-DemonHunter-Havoc,5939,823,55,49,58,113,205,254,5575,0,0,0,0
GarrMission_ClassIcon-DemonHunter-Vengeance,5940,823,55,49,58,113,256,305,5576,0,0,0,0
GarrMission_ClassIcon-Druid-Balance,5941,823,55,49,286,341,52,101,5577,0,0,0,0
GarrMission_ClassIcon-Druid-Feral,5942,823,55,49,1,56,358,407,5578,0,0,0,0
GarrMission_ClassIcon-Druid-Guardian,5943,823,55,49,229,284,103,152,5579,0,0,0,0
GarrMission_ClassIcon-Druid-Restoration,5944,823,55,49,400,455,103,152,5580,0,0,0,0
GarrMission_ClassIcon-Hunter-BeastMastery,5945,823,55,49,115,170,1,50,5581,0,0,0,0
GarrMission_ClassIcon-Hunter-Marksmanship,5946,823,55,49,400,455,1,50,5582,0,0,0,0
GarrMission_ClassIcon-Hunter-Survival,5947,823,55,49,343,398,52,101,5583,0,0,0,0
GarrMission_ClassIcon-Mage-Arcane,5948,823,55,49,1,56,205,254,5584,0,0,0,0
GarrMission_ClassIcon-Mage-Fire,5949,823,55,49,286,341,1,50,5585,0,0,0,0
GarrMission_ClassIcon-Mage-Frost,5950,823,55,49,1,56,307,356,5586,0,0,0,0
GarrMission_ClassIcon-Monk-Brewmaster,5951,823,55,49,115,170,154,203,5587,0,0,0,0
GarrMission_ClassIcon-Monk-Mistweaver,5952,823,55,49,229,284,1,50,5588,0,0,0,0
GarrMission_ClassIcon-Monk-Windwalker,5953,823,55,49,343,398,103,152,5589,0,0,0,0
GarrMission_ClassIcon-Paladin-Holy,5954,823,55,49,172,227,103,152,5590,0,0,0,0
GarrMission_ClassIcon-Paladin-Protection,5955,823,55,49,58,113,307,356,5591,0,0,0,0
GarrMission_ClassIcon-Paladin-Retribution,5956,823,55,49,58,113,1,50,5592,0,0,0,0
GarrMission_ClassIcon-Priest-Discipline,5957,823,55,49,58,113,154,203,5593,0,0,0,0
GarrMission_ClassIcon-Priest-Holy,5958,823,55,49,58,113,409,458,5594,0,0,0,0
GarrMission_ClassIcon-Priest-Shadow,5959,823,55,49,115,170,52,101,5595,0,0,0,0
GarrMission_ClassIcon-Rogue-Assassination,5960,823,55,49,229,284,154,203,5596,0,0,0,0
GarrMission_ClassIcon-Rogue-Outlaw,5961,823,55,49,1,56,52,101,5597,0,0,0,0
GarrMission_ClassIcon-Rogue-Subtlety,5962,823,55,49,172,227,52,101,5598,0,0,0,0
GarrMission_ClassIcon-Shaman-Elemental,5963,823,55,49,286,341,103,152,5599,0,0,0,0
GarrMission_ClassIcon-Shaman-Enhancement,5964,823,55,49,1,56,409,458,5600,0,0,0,0
GarrMission_ClassIcon-Shaman-Restoration,5965,823,55,49,1,56,154,203,5601,0,0,0,0
GarrMission_ClassIcon-Warlock-Affliction,5966,823,55,49,172,227,1,50,5602,0,0,0,0
GarrMission_ClassIcon-Warlock-Demonology,5967,823,55,49,229,284,52,101,5603,0,0,0,0
GarrMission_ClassIcon-Warlock-Destruction,5968,823,55,49,58,113,358,407,5623,0,0,0,0
GarrMission_ClassIcon-Warrior-Arms,5969,823,55,49,58,113,460,509,5747,0,0,0,0
GarrMission_ClassIcon-Warrior-Fury,5970,823,55,49,400,455,52,101,5748,0,0,0,0
GarrMission_ClassIcon-Warrior-Protection,5971,823,55,49,1,56,256,305,5624,0,0,0,0
legionmission-background-combatally,5973,825,918,619,1,919,1,620,5626,0,0,0,0
_GarrMissionLocation-Legion-Mid,5976,828,1024,285,0,1024,1,286,5629,0,0,4,0
_GarrMissionLocation-Highmountain-Mid,5977,827,1024,285,0,1024,1,286,5630,0,0,4,0
_GarrMissionLocation-Dalaran-Mid,5978,826,1024,285,0,1024,1,286,5628,0,0,4,0
_GarrMissionLocation-Azsuna-Mid,5979,824,1024,285,0,1024,1,286,5631,0,0,4,0
_GarrMissionLocation-Stormheim-Mid,5980,829,1024,285,0,1024,1,286,5632,0,0,4,0
_GarrMissionLocation-Suramar-Mid,5981,830,1024,285,0,1024,1,286,5625,0,0,4,0
_GarrMissionLocation-Valsharah-Mid,5982,831,1024,285,0,1024,1,286,5627,0,0,4,0
legionmission-hearts-background,5983,783,119,44,134,253,158,202,5633,0,0,0,0
GarrMissionLocation-Azsuna-List,5984,832,792,78,1,793,1,79,5634,0,0,0,0
GarrMissionLocation-Dalaran-List,5985,832,792,78,1,793,81,159,5635,0,0,0,0
GarrMissionLocation-Highmountain-List,5986,832,792,78,1,793,161,239,5636,0,0,0,0
GarrMissionLocation-Legion-List,5987,832,792,78,1,793,241,319,5637,0,0,0,0
GarrMissionLocation-Stormheim-List,5988,832,792,78,1,793,321,399,5638,0,0,0,0
GarrMissionLocation-Suramar-List,5989,832,792,78,1,793,401,479,5642,0,0,0,0
GarrMissionLocation-Valsharah-List,5990,832,792,78,1,793,481,559,5643,0,0,0,0
poi-workorders,5991,647,32,32,445,477,919,951,5644,0,0,0,0
groupfinder-background-raids-legion,5992,236,333,96,666,999,197,293,5645,0,0,0,0
groupfinder-button-raids-legion,5993,236,290,36,1,291,931,967,5646,0,0,0,0
orderhall-commandbar-iconmask,5994,762,57,23,1,58,28,51,5647,0,0,0,0
GarrMission-NeutralChest,5995,783,209,155,1,210,1,156,5648,0,0,0,0
worldquest-tracker-lock,5996,743,36,47,143,179,450,497,5649,0,0,0,0
ClassTrial-End-Frame,5997,833,563,345,1,564,1,346,5650,0,0,0,0
ClassTrial-Hunter-Ring,5998,833,188,188,1,189,348,536,5651,0,0,0,0
ClassTrial-Priest-Ring,5999,833,188,188,191,379,538,726,5652,0,0,0,0
ClassTrial-DeathKnight-Ring,6000,833,188,188,566,754,1,189,5653,0,0,0,0
ClassTrial-Warrior-Ring,6001,833,188,188,761,949,348,536,5654,0,0,0,0
ClassTrial-Paladin-Ring,6002,833,188,188,191,379,348,536,5655,0,0,0,0
ClassTrial-Warlock-Ring,6003,833,188,188,571,759,348,536,5656,0,0,0,0
ClassTrial-Druid-Ring,6004,833,188,188,756,944,1,189,5657,0,0,0,0
ClassTrial-Monk-Ring,6005,833,188,188,1,189,728,916,5658,0,0,0,0
ClassTrial-Mage-Ring,6006,833,188,188,1,189,538,726,5659,0,0,0,0
ClassTrial-Rogue-Ring,6007,833,188,188,191,379,728,916,5660,0,0,0,0
Legion-boostpopup-exit-frame,6008,706,25,24,433,458,1,25,5661,0,0,0,0
transmog-wardrobe-border-selected-smoke,6009,610,19,65,203,222,154,219,5662,0,0,0,0
legionmission-icon-currency,6010,783,44,41,134,178,204,245,5663,0,0,0,0
UI-CharacterCreate-MetalFrame-Horizontal,6011,834,256,16,0,256,1,17,5664,0,0,4,0
UI-CharacterCreate-MetalFrame-Vertical,6012,835,16,256,1,17,0,256,5665,0,0,2,0
ClassTrial-Timer-Mid,6013,836,17,81,0,17,1,82,5666,0,0,4,0
ClassTrial-Timer-RightCorner,6014,836,25,81,282,307,84,165,5667,0,0,0,0
ClassTrial-Timer,6015,836,279,81,1,280,84,165,5668,0,0,0,0
UI-CharacterCreate-LargeButton-Blue-Highlight,6016,837,108,37,125,233,44,81,5669,0,0,0,0
UI-CharacterCreate-LargeButton-Yellow-Highlight,6017,837,108,37,125,233,83,120,5670,0,0,0,0
UI-CharacterCreate-LargeButton,6018,837,108,41,125,233,1,42,5671,0,0,0,0
UI-CharacterCreate-Metal-Finery-Corner,6019,837,56,49,1,57,1,50,5672,0,0,0,0
UI-CharacterCreate-Metal-Small-Finery,6020,837,35,32,1,36,52,84,5673,0,0,0,0
UI-CharacterCreate-PadLock,6021,837,63,76,59,122,51,127,5674,0,0,0,0
UI-Character-Info-Paladin-BG,6022,838,197,355,200,397,1,356,5675,0,0,0,0
UI-Character-Info-Priest-BG,6024,838,197,355,200,397,358,713,5756,0,0,0,0
UI-Character-Info-Warlock-BG,6025,838,197,355,598,795,1,356,5757,0,0,0,0
UI-Character-Info-Line-Bounce,6028,838,157,19,1,158,788,807,5760,0,0,0,0
UI-Character-Info-Shaman-BG,6029,838,197,355,399,596,358,713,5761,0,0,0,0
UI-Character-Info-ItemLevel-Bounce,6030,838,162,29,1,163,757,786,5762,0,0,0,0
UI-Character-Info-Warrior-BG,6032,838,197,355,797,994,1,356,5763,0,0,0,0
UI-Character-Info-Title,6033,838,196,40,1,197,715,755,5764,0,0,0,0
UI-Character-Info-Mage-BG,6034,838,197,355,1,198,1,356,5765,0,0,0,0
UI-Character-Info-Rogue-BG,6035,838,197,355,399,596,1,356,5766,0,0,0,0
UI-Character-Info-Monk-BG,6036,838,197,355,1,198,358,713,5767,0,0,0,0
UI-Character-Info-DeathKnight-BG,6037,839,197,355,1,198,1,356,5768,0,0,0,0
UI-Character-Info-DemonHunter-BG,6038,839,197,355,200,397,1,356,5769,0,0,0,0
UI-Character-Info-Druid-BG,6039,839,197,355,399,596,1,356,5770,0,0,0,0
UI-Character-Info-Hunter-BG,6040,839,197,355,598,795,1,356,5771,0,0,0,0
Relic-SlotBG-Glass,6041,607,34,34,695,729,37,71,5751,0,0,0,0
loottab-set-itemborder-artifact,6042,822,41,41,1,42,44,85,5752,0,0,0,0
loottab-set-itemborder-white,6043,822,41,41,87,128,44,85,5753,0,0,0,0
loottab-set-itemborder-orange,6044,822,41,41,44,85,44,85,5754,0,0,0,0
Artifacts-BG-Shadow,6045,840,896,615,1,897,1,616,5755,0,0,0,0
worldquest-questmarker-rare-down,6046,743,20,20,489,509,69,89,5749,0,0,0,0
worldquest-questmarker-rare,6047,743,20,20,489,509,47,67,5750,0,0,0,0
poi-majorcity,6049,647,32,32,445,477,817,849,5758,0,0,0,0
poi-town,6050,647,32,32,445,477,885,917,5759,0,0,0,0
pvpqueue-bg-alliance,6051,841,322,229,1,323,1,230,5977,0,0,0,0
pvpqueue-bg-horde,6052,842,322,229,1,323,1,230,5978,0,0,0,0
honorsystem-prestige-smallwreath,6053,696,89,53,902,991,1,54,5901,0,0,0,0
orderhall-commandbar-mapbutton-down,6054,762,27,27,60,87,28,55,5772,0,0,0,0
orderhall-commandbar-mapbutton-up,6055,762,27,27,89,116,28,55,5773,0,0,0,0
worldquest-tracker-bg-noemissary,6056,743,30,30,67,97,426,456,5858,0,0,0,0
Quest-Alliance-WaxSeal,6057,843,97,90,1,98,819,909,5859,0,0,0,0
Quest-Horde-WaxSeal,6058,843,97,90,1,98,911,1001,5860,0,0,0,0
QuestBG-Alliance,6059,843,299,407,1,300,1,408,5861,0,0,0,0
QuestBG-Horde,6060,843,299,407,1,300,410,817,5862,0,0,0,0
insetshadow,6062,844,510,395,1,511,1,396,5979,0,0,0,0
ChallengeMode-guild-background,6063,569,250,110,397,647,1,111,5902,0,0,0,0
ChallengeMode-RankLineDivider,6064,569,193,9,397,590,284,293,5903,0,0,0,0
_Talent-green-glow,6068,110,16,16,0,16,86,102,5980,0,0,4,0
legionmission-lock,6072,783,32,42,212,244,53,95,5908,0,0,0,0
honorsystem-prestige-rewardline,6076,696,276,1,603,879,433,434,5941,0,0,0,0
orderhalltalents-done-checkmark,6085,758,40,35,468,508,1,36,5774,0,0,0,0
orderhalltalents-done-glow,6086,758,146,146,155,301,1,147,5775,0,0,0,0
map-icon-ignored-blueexclaimation,6088,647,32,32,411,443,749,781,5776,0,0,0,0
map-icon-ignored-bluequestion,6089,647,32,32,411,443,783,815,5777,0,0,0,0
map-icon-deathknightclasshall,6090,647,64,64,71,135,791,855,5942,0,0,0,0
dungeon,6091,647,50,50,203,253,321,371,5778,32,32,0,0
raid,6092,647,50,50,203,253,373,423,5779,32,32,0,0
map-icon-suramardoor.tga,6093,647,32,32,411,443,817,849,5816,0,0,0,0
ClassTrial-Shaman-Ring,6094,833,188,188,381,569,348,536,5909,0,0,0,0
Mobile-BonusIcon,6095,846,128,128,391,519,1,129,5817,0,0,0,0
Mobile-CombatBadgeIcon,6096,846,128,128,651,779,1,129,5818,0,0,0,0
Mobile-CombatIcon,6097,846,128,128,781,909,1,129,5819,0,0,0,0
Mobile-LegendaryQuestIcon,6098,846,128,128,651,779,131,259,5820,0,0,0,0
Mobile-QuestIcon,6099,846,128,128,391,519,261,389,5821,0,0,0,0
Mobile-TreasureIcon,6100,846,128,128,261,389,391,519,5822,0,0,0,0
ClassHall_StoneFrame-BackgroundTile,6101,847,256,256,0,256,0,256,5823,0,0,6,0
ClassHall_InfoBoxMission-BackgroundTile,6102,848,256,256,0,256,0,256,5824,0,0,6,0
StoneFrameCorner-TopLeft,6103,849,42,40,461,503,61,101,5825,0,0,0,0
ClassHall-Circle-Mage,6104,849,90,88,1,91,421,509,5826,0,0,0,0
_StoneFrameTile-Bottom,6105,849,512,28,0,512,1,29,5827,0,0,4,0
_StoneFrameTile-Top,6106,849,512,28,0,512,31,59,5828,0,0,4,0
ClassHall-Circle-DeathKnight,6107,849,90,88,1,91,61,149,5829,0,0,0,0
ClassHall-Circle-Hunter,6108,849,90,88,1,91,331,419,5830,0,0,0,0
ClassHall-Circle-Warrior,6109,849,90,88,93,183,331,419,5831,0,0,0,0
ClassHall-Circle-Druid,6110,849,90,88,1,91,241,329,5832,0,0,0,0
ClassHall-Circle-Warlock,6111,849,90,88,93,183,241,329,5833,0,0,0,0
ClassHall-Circle-Shaman,6112,849,90,88,93,183,151,239,5834,0,0,0,0
ClassHall-Circle-Rogue,6113,849,90,88,369,459,61,149,5835,0,0,0,0
ClassHall-Circle-Monk,6114,849,90,88,93,183,61,149,5836,0,0,0,0
ClassHall-Circle-DemonHunter,6115,849,90,88,1,91,151,239,5837,0,0,0,0
ClassHall-Circle-Priest,6116,849,90,88,277,367,61,149,5838,0,0,0,0
ClassHall-Circle-Paladin,6117,849,90,88,185,275,61,149,5839,0,0,0,0
!StoneFrameTile-Left,6118,850,28,512,1,29,0,512,5840,0,0,2,0
ClassHall_ParchmentHeaderSelect-End,6119,851,40,41,1,41,441,482,5841,0,0,0,0
_ClassHall_ParchmentHeaderSelect-Mid,6120,851,128,41,0,128,181,222,5842,0,0,4,0
_ClassHall_ParchmentHeader-Mid,6121,851,128,41,0,128,138,179,5843,0,0,4,0
ClassHall_ParchmentHeader-End,6122,851,40,41,138,178,304,345,5844,0,0,0,0
Mobile-CombatIcon-Desaturated,6123,846,128,128,1,129,131,259,5943,0,0,0,0
Mobile-BonusIcon-Desaturated,6124,846,128,128,521,649,1,129,5944,0,0,0,0
Mobile-TreasureIcon-Desaturated,6125,846,128,128,261,389,521,649,5945,0,0,0,0
Mobile-QuestIcon-Desaturated,6126,846,128,128,521,649,261,389,5946,0,0,0,0
Mobile-LegendaryQuestIcon-Desaturated,6127,846,128,128,781,909,131,259,5947,0,0,0,0
ClassHall-TreasureIcon-Desaturated,6128,852,64,64,1,65,1,65,5948,0,0,0,0
ClassHall-LegendaryIcon-Desaturated,6129,852,64,64,67,131,1,65,5949,0,0,0,0
ClassHall-QuestIcon-Desaturated,6130,852,64,64,133,197,1,65,5950,0,0,0,0
ClassHall-BonusIcon-Desaturated,6131,852,64,64,1,65,67,131,5951,0,0,0,0
ClassHall-CombatIcon-Desaturated,6132,852,64,64,1,65,133,197,5952,0,0,0,0
worldquest-icon-dungeon,6133,743,16,17,489,505,149,166,5863,0,0,0,0
honorsystem-bar-lock,6134,696,36,47,902,938,118,165,5984,0,0,0,0
Mobile-Alchemy,6135,846,128,128,1,129,1,129,5953,0,0,0,0
Mobile-Archeology,6136,846,128,128,131,259,1,129,5954,0,0,0,0
Mobile-Blacksmithing,6137,846,128,128,261,389,1,129,5955,0,0,0,0
Mobile-Cooking,6138,846,128,128,1,129,261,389,5956,0,0,0,0
Mobile-Enchanting,6139,846,128,128,1,129,391,519,5957,0,0,0,0
Mobile-Enginnering,6140,846,128,128,1,129,521,649,5958,0,0,0,0
Mobile-FirstAid,6141,846,128,128,1,129,651,779,5959,0,0,0,0
Mobile-Fishing,6142,846,128,128,1,129,781,909,5960,0,0,0,0
Mobile-Herbalism,6143,846,128,128,131,259,131,259,5961,0,0,0,0
Mobile-Inscription,6144,846,128,128,261,389,131,259,5962,0,0,0,0
Mobile-Jewelcrafting,6145,846,128,128,391,519,131,259,5963,0,0,0,0
Mobile-Leatherworking,6146,846,128,128,521,649,131,259,5964,0,0,0,0
Mobile-MechanicIcon-Curse,6147,846,128,128,131,259,261,389,5965,0,0,0,0
Mobile-MechanicIcon-Disorienting,6148,846,128,128,131,259,391,519,5966,0,0,0,0
Mobile-MechanicIcon-Lethal,6149,846,128,128,131,259,521,649,5967,0,0,0,0
Mobile-MechanicIcon-Slowing,6150,846,128,128,131,259,651,779,5968,0,0,0,0
Mobile-Mining,6151,846,128,128,131,259,781,909,5969,0,0,0,0
Mobile-Pets,6152,846,128,128,261,389,261,389,5970,0,0,0,0
Mobile-Skinning,6153,846,128,128,651,779,261,389,5971,0,0,0,0
Mobile-Tailoring,6154,846,128,128,781,909,261,389,5972,0,0,0,0
taxi_frame_gray,6155,853,74,74,1,75,35,109,5780,0,0,0,0
taxi_frame_green,6156,853,74,74,1,75,111,185,5781,0,0,0,0
ui-taxi-icon-nub,6157,853,16,16,77,93,35,51,5782,0,0,0,0
!UI-Taxi-Line,6159,854,32,32,1,33,0,32,5784,0,0,2,0
_ui-taxi-line-horizontal,6161,853,32,32,0,32,1,33,5783,0,0,4,0
Mobile-MechanicIcon-Powerful,6162,846,128,128,261,389,651,779,5973,0,0,0,0
GarrMission_ClassIcon-DemonHunter-Outcast,6163,823,55,49,1,56,1,50,5864,0,0,0,0
splash-703-botleft,6165,855,137,371,374,511,587,958,5785,0,0,0,0
splash-703-right,6166,855,510,584,1,511,1,585,5786,0,0,0,0
splash-703-topleft,6167,855,371,434,1,372,587,1021,5787,0,0,0,0
splash-704-botleft,6168,856,137,371,374,511,587,958,5788,0,0,0,0
splash-704-right,6169,856,510,584,1,511,1,585,5789,0,0,0,0
splash-704-topleft,6170,856,371,434,1,372,587,1021,5790,0,0,0,0
splash-705-botleft,6171,857,137,371,374,511,587,958,5791,0,0,0,0
splash-705-right,6172,857,510,584,1,511,1,585,5792,0,0,0,0
splash-705-topleft,6173,857,371,434,1,372,587,1021,5793,0,0,0,0
inspect-talent-selected,6174,858,38,38,1,39,1,39,5986,0,0,0,0
loottab-background,6175,859,786,381,1,787,1,382,5910,0,0,0,0
loottab-set-background,6176,859,744,41,1,745,384,425,5911,0,0,0,0
autoquest-badgeborder,6177,860,44,45,131,175,1,46,5794,0,0,0,0
ClassHall_Follower-EquipmentBG,6178,851,78,78,138,216,224,302,5987,0,0,0,0
ClassHall_Follower-EquipmentFrame,6179,851,78,78,1,79,361,439,5988,0,0,0,0
ClassHall_InfoBoxMission-Corner,6180,851,135,135,1,136,224,359,5989,0,0,0,0
_ClassHall_InfoBoxMission-Top,6181,851,256,135,0,256,1,136,5990,0,0,4,0
!ClassHall_InfoBoxMission-Left,6182,861,135,256,1,136,0,256,5991,0,0,2,0
ClassHall_ParchmentHeader-End-2,6183,851,40,41,180,220,304,345,5992,0,0,0,0
ClassHall_ParchmentHeaderSelect-End-2,6184,851,40,41,81,121,361,402,5993,0,0,0,0
ClassHall-CombatAlly,6197,864,890,115,1,891,1,116,5795,0,0,0,0
nameplates-icon-elite-gold,6198,731,37,35,1,38,30,65,5444,0,0,0,0
nameplates-icon-elite-silver,6199,731,37,35,1,38,67,102,5470,0,0,0,0
streamcinematic-legion-down,6200,557,176,78,713,889,1,79,5994,0,0,0,0
streamcinematic-legion-up,6201,557,176,78,535,711,81,159,5995,0,0,0,0
GarrMission_ClassIcon-Karazhan,6219,823,55,49,1,56,103,152,5447,0,0,0,0
WhiteCircle-RaidBlips,6220,867,19,18,1,20,1,19,5448,0,0,0,0
WhiteDotCircle-RaidBlips,6221,867,19,18,22,41,1,19,5449,0,0,0,0
friendslist-categorybutton-arrow-down,6222,869,16,11,296,312,1,12,5845,0,0,0,0
friendslist-categorybutton-arrow-right,6223,869,11,16,314,325,1,17,5846,0,0,0,0
friendslist-categorybutton,6224,869,293,26,1,294,1,27,5847,0,0,0,0
taxi_frame_yellow,6225,853,74,74,1,75,187,261,5450,0,0,0,0
pvprated-loottoast-bg-alliance,6226,870,277,113,1,278,118,231,5848,0,0,0,0
pvprated-loottoast-bg-horde,6227,870,281,115,1,282,1,116,5849,0,0,0,0
128-redbutton-highlight,6228,871,441,128,1,442,391,519,5451,0,0,0,0
bags-greenarrow,6238,202,20,22,66,86,93,115,5985,0,0,0,0
socialqueuing-icon-clock,6239,845,13,11,304,317,35,46,5865,0,0,0,0
socialqueuing-icon-eye,6240,845,24,25,382,406,29,54,5866,0,0,0,0
socialqueuing-icon-group,6241,845,29,26,382,411,1,27,5867,0,0,0,0
quickjoin-button-friendslist-down,6242,872,32,32,304,336,1,33,5868,0,0,0,0
quickjoin-button-friendslist-up,6243,872,32,32,338,370,1,33,5869,0,0,0,0
quickjoin-button-quickjoin-down,6244,872,32,32,440,472,1,33,5870,0,0,0,0
quickjoin-button-quickjoin-up,6245,872,32,32,474,506,1,33,5871,0,0,0,0
quickjoin-toast-background,6248,872,301,32,1,302,1,33,5874,0,0,0,0
quickjoin-toast-lines,6249,872,287,23,1,288,35,58,5875,0,0,0,0
macropopup-bottomleft,6253,873,18,39,81,99,172,211,5879,0,0,0,0
macropopup-bottomright,6254,873,174,39,1,175,131,170,5880,0,0,0,0
macropopup-topleft,6255,873,18,71,1,19,172,243,5881,0,0,0,0
macropopup-topright,6256,873,18,71,21,39,172,243,5882,0,0,0,0
_macropopup-bottom,6257,873,256,39,0,256,71,110,5883,0,0,4,0
_macropopup-top,6258,873,256,68,0,256,1,69,5884,0,0,4,0
!macropopup-left,6259,874,17,256,33,50,0,256,5885,0,0,2,0
!macropopup-right,6260,874,17,256,52,69,0,256,5886,0,0,2,0
macropopup-scrollbar-bottom,6261,873,30,24,209,239,131,155,5877,0,0,0,0
macropopup-scrollbar-top,6262,873,30,25,177,207,131,156,5878,0,0,0,0
!macropopup-scrollbar-middle,6263,874,30,256,1,31,0,256,5887,0,0,2,0
socialqueuing-row-highlight,6264,845,301,55,1,302,1,56,5904,0,0,0,0
socialqueuing-row-select,6265,845,301,55,1,302,58,113,5912,0,0,0,0
splash-710-botleft,6266,875,137,371,374,511,587,958,5850,0,0,0,0
splash-710-right,6267,875,510,584,1,511,1,585,5851,0,0,0,0
splash-710-topleft,6268,875,371,434,1,372,587,1021,5852,0,0,0,0
groupfinder-icon-class-demonhunter,6269,236,29,29,293,322,969,998,5905,0,0,0,0
ancientmana,6270,647,32,32,445,477,375,407,5940,0,0,0,0
quickjoin-button-group-down,6271,872,32,32,372,404,1,33,5906,0,0,0,0
quickjoin-button-group-up,6272,872,32,32,406,438,1,33,5907,0,0,0,0
socialqueuing-friendlist-summonbutton-disabled,6276,845,24,32,304,328,1,33,5974,0,0,0,0
socialqueuing-friendlist-summonbutton-down,6277,845,24,32,330,354,1,33,5975,0,0,0,0
socialqueuing-friendlist-summonbutton-up,6278,845,24,32,356,380,1,33,5976,0,0,0,0
worldquest-icon-burninglegion,6291,743,16,15,181,197,450,465,5981,0,0,0,0
worldquest-icon-raid,6292,743,16,17,489,505,168,185,5982,0,0,0,0
GarrMission-AbilityHighlight-Error,6293,156,58,58,401,459,406,464,5983,0,0,0,0
transmog-set-border-collected,6295,877,152,208,1,153,1,209,5872,0,0,0,0
transmog-set-border-current-transmogged,6296,877,132,188,301,433,1,189,5873,0,0,0,0
transmog-set-border-current,6297,877,132,188,155,287,203,391,5888,0,0,0,0
transmog-set-border-highlighted,6298,877,132,188,289,421,203,391,5889,0,0,0,0
transmog-set-border-selected,6299,877,150,206,1,151,211,417,5890,0,0,0,0
transmog-set-border-unusable,6300,877,144,200,155,299,1,201,5891,0,0,0,0
transmog-set-iconrow-background,6301,876,418,64,1,419,181,245,5892,0,0,0,0
ParagonReputation_Bag,6302,878,15,18,38,53,1,19,4668,0,0,0,0
ParagonReputation_Checkmark,6303,878,16,14,38,54,21,35,4669,0,0,0,0
ParagonReputation_Glow,6304,878,35,35,1,36,1,36,4667,0,0,0,0
Legionfall_Background,6305,879,871,576,1,872,1,577,5876,0,0,0,0
Legionfall_Banner,6306,879,252,39,586,838,745,784,5893,0,0,0,0
Legionfall_BarBackground,6307,879,230,18,606,836,861,879,5894,0,0,0,0
Legionfall_BarFrame,6308,879,240,31,397,637,828,859,5895,0,0,0,0
Legionfall_BarSpark,6309,879,16,64,874,890,48,112,5896,0,0,0,0
Legionfall_BuildingInfoBackground,6310,879,207,30,397,604,861,891,5897,0,0,0,0
Legionfall_GrayFrame,6311,879,205,97,1,206,579,676,5898,0,0,0,0
Legionfall_Padlock,6312,879,38,45,874,912,1,46,5899,0,0,0,0
_Legionfall_BarFill_Active,6313,880,256,17,0,256,1,18,5900,0,0,4,0
_Legionfall_BarFill_UnderAttack,6314,880,256,17,0,256,20,37,5913,0,0,4,0
_Legionfall_BarFill_UnderConstruction,6315,880,256,17,0,256,39,56,5914,0,0,4,0
legionmission-portraitring-epicplus,6316,783,68,61,64,132,158,219,5915,0,0,0,0
legionmission-portraitring_levelborder_epicplus,6317,783,58,24,1,59,221,245,5916,0,0,0,0
Legionfall_CommandCenter_Completed,6318,879,187,81,208,395,579,660,5917,0,0,0,0
Legionfall_CommandCenter_Destroyed,6319,879,187,81,397,584,579,660,5918,0,0,0,0
Legionfall_CommandCenter_UnderAttack,6320,879,187,81,586,773,579,660,5919,0,0,0,0
Legionfall_CommandCenter_UnderConstruction,6321,879,187,81,775,962,579,660,5920,0,0,0,0
Legionfall_MageTower_Completed,6322,879,187,81,208,395,662,743,5921,0,0,0,0
Legionfall_MageTower_Destroyed,6323,879,187,81,397,584,662,743,5922,0,0,0,0
Legionfall_MageTower_UnderAttack,6324,879,187,81,586,773,662,743,5923,0,0,0,0
Legionfall_MageTower_UnderConstruction,6325,879,187,81,775,962,662,743,5924,0,0,0,0
Legionfall_NetherDisruptor_Completed,6326,879,187,81,208,395,745,826,5925,0,0,0,0
Legionfall_NetherDisruptor_Destroyed,6327,879,187,81,208,395,828,909,5926,0,0,0,0
Legionfall_NetherDisruptor_UnderAttack,6328,879,187,81,208,395,911,992,5927,0,0,0,0
Legionfall_NetherDisruptor_UnderConstruction,6329,879,187,81,397,584,745,826,5928,0,0,0,0
Artifacts-DeathKnightFrost-BG-Rune,6330,677,204,204,1,205,745,949,5996,0,0,0,0
Artifacts-ItemIconBorder,6331,607,86,86,937,1023,75,161,5997,0,0,0,0
Artifacts-PerkRing-Final,6332,607,111,111,624,735,576,687,5929,0,0,0,0
Artifacts-DeathKnightFrost-FinalIcon,6333,677,86,86,899,985,1,87,5930,0,0,0,0
Legionfall_GrayBanner,6334,879,252,39,586,838,786,825,5853,0,0,0,0
Legionfall_GreenFrame,6335,879,205,97,1,206,678,775,5854,0,0,0,0
Legionfall_RedFrame,6336,879,205,97,1,206,777,874,5855,0,0,0,0
Legionfall_YellowFrame,6337,879,205,97,1,206,876,973,5856,0,0,0,0
Legionfall_ExitFrame,6338,879,33,32,955,988,1,33,5857,0,0,0,0
equipmentmanager-spec-border,6339,881,28,28,1,29,1,29,5998,0,0,0,0
Artifacts-DemonHunter-BG-rune,6340,649,270,270,1,271,746,1016,5931,0,0,0,0
Artifacts-Druid-BG-rune,6341,680,220,220,1,221,800,1020,5932,0,0,0,0
Artifacts-Hunter-BG-rune,6342,710,210,210,1,211,685,895,5933,0,0,0,0
Artifacts-MageArcane-BG-rune,6343,662,204,204,1,205,758,962,5934,0,0,0,0
Artifacts-Monk-BG-rune,6344,712,226,226,1,227,765,991,5935,0,0,0,0
Artifacts-Paladin-BG-rune,6345,650,204,204,1,205,703,907,5936,0,0,0,0
Artifacts-Priest-BG-rune,6346,711,246,246,1,247,730,976,5937,0,0,0,0
Artifacts-PriestShadow-BG-rune,6347,724,246,246,1,247,734,980,5938,0,0,0,0
Artifacts-Rogue-BG-rune,6348,679,204,204,1,205,699,903,5939,0,0,0,0
Artifacts-Shaman-BG-rune,6349,709,204,204,1,205,719,923,5999,0,0,0,0
Artifacts-Warlock-BG-rune,6350,713,204,204,1,205,712,916,6000,0,0,0,0
Artifacts-Warrior-BG-rune,6351,678,280,280,1,281,618,898,6001,0,0,0,0
Artifacts-PerkRing-Final-Shine,6352,607,111,111,870,981,439,550,6002,0,0,0,0
Talent-Selection-Legendary,6353,110,190,45,1,191,521,566,5803,0,0,0,0
Artifacts-DemonHunter-FinalIcon,6354,649,86,86,899,985,1,87,6003,0,0,0,0
Artifacts-Druid-FinalIcon,6355,680,86,86,899,985,1,87,6004,0,0,0,0
Artifacts-Hunter-FinalIcon,6356,710,86,86,899,985,1,87,6005,0,0,0,0
Artifacts-MageArcane-FinalIcon,6357,662,86,86,899,985,1,87,6006,0,0,0,0
Artifacts-Monk-FinalIcon,6358,712,86,86,899,985,1,87,6007,0,0,0,0
Artifacts-Paladin-FinalIcon,6359,650,86,86,899,985,1,87,6008,0,0,0,0
Artifacts-Priest-FinalIcon,6360,711,86,86,899,985,1,87,6009,0,0,0,0
Artifacts-PriestShadow-FinalIcon,6361,724,86,86,899,985,1,87,6010,0,0,0,0
Artifacts-Rogue-FinalIcon,6362,679,86,86,899,985,1,87,6011,0,0,0,0
Artifacts-Shaman-FinalIcon,6363,709,86,86,899,985,1,87,6012,0,0,0,0
Artifacts-Warlock-FinalIcon,6364,713,86,86,899,985,1,87,6013,0,0,0,0
Artifacts-Warrior-FinalIcon,6365,678,86,86,899,985,1,87,6014,0,0,0,0
Artifacts-CrestRune-Gold,6366,688,203,204,1,204,19,223,5804,0,0,0,0
legionfallmapbanner,6367,647,64,64,71,135,329,393,5805,0,0,0,0
QuestBG-Legionfall,6368,843,299,407,302,601,1,408,5806,0,0,0,0
Quest-Legionfall-WaxSeal,6369,843,96,90,100,196,819,909,5807,0,0,0,0
poi-transmogrifier,6370,647,29,36,992,1021,263,299,4937,0,0,0,0
Artifacts-Anim-Sparks,6371,882,680,680,1,681,1,681,5808,0,0,0,0
worldquest-emissary-ring,6372,743,30,30,67,97,394,424,5809,0,0,0,0
worldquest-emissary-tracker-checkmark,6373,743,18,16,489,507,131,147,5810,0,0,0,0
splash-720-botleft,6375,883,137,371,374,511,587,958,4938,0,0,0,0
splash-720-right,6376,883,510,584,1,511,1,585,4939,0,0,0,0
splash-720-topleft,6377,883,371,434,1,372,587,1021,4940,0,0,0,0
demonship,6378,647,31,56,987,1018,1,57,5812,0,0,0,0
Artifacts-Anim-Orb,6379,882,256,256,683,939,341,597,5811,0,0,0,0
Artifacts-Anim-Glowies,6380,882,338,338,683,1021,1,339,5813,0,0,0,0
Legionfall_BarFrame-Glow,6381,879,240,31,639,879,828,859,5814,0,0,0,0
transmog-set-model-cutoff-fade,6382,876,403,178,1,404,1,179,4941,0,0,0,0
MountToast-Background,6383,884,276,109,1,277,1,110,4942,0,0,0,0
PetToast-background,6384,885,276,98,1,277,1,99,4943,0,0,0,0
honorsystem-icon-enlistmentbonus,6385,696,29,29,902,931,167,196,5815,0,0,0,0
artifacts-anim-crackedground,6386,886,510,510,1,511,1,511,6269,0,0,0,0
Legionfall_GrayFrame_Buffs,6387,879,39,39,914,953,1,40,6231,0,0,0,0
demonship_east,6388,647,56,31,71,127,989,1020,6145,0,0,0,0
DK-Blood-Rune-CDFill,6460,894,34,37,1,35,1,38,6189,0,0,0,0
DK-BloodUnholy-Rune-CDSpark,6461,894,34,37,1,35,40,77,6190,0,0,0,0
DK-Frost-Rune-CDFill,6462,894,34,37,1,35,79,116,6191,0,0,0,0
DK-Frost-Rune-CDSpark,6463,894,34,37,37,71,1,38,6192,0,0,0,0
DK-Unholy-Rune-CDFill,6464,894,32,32,73,105,1,33,6193,0,0,0,0
Warlock-Bar-EmptyShards,6465,895,133,29,42,175,6,35,6270,0,0,0,0
Warlock-EmptyShard,6466,895,17,22,1,18,38,60,6271,0,0,0,0
Warlock-FillShard,6467,895,17,22,23,40,1,23,6272,0,0,0,0
Warlock-ReadyShard-Glow,6468,895,20,35,1,21,1,36,6273,0,0,0,0
Warlock-ReadyShard,6469,895,17,22,23,40,25,47,6274,0,0,0,0
Warlock-Shard-Spark,6470,895,21,3,42,63,1,4,6275,0,0,0,0
CastBar,6472,695,256,64,67,323,131,195,6146,0,0,0,0
CurrentPlayer-Glow,6473,695,128,128,873,1001,1,129,6147,0,0,0,0
DarkTutorialFrameBackground,6474,695,32,32,773,805,1,33,6148,0,0,0,0
DeathIcon,6475,695,64,128,1,65,302,430,6149,0,0,0,0
HealerBadge,6476,695,64,64,1,65,432,496,6150,0,0,0,0
HealingDampening,6477,695,256,128,67,323,197,325,6151,0,0,0,0
InterruptOverlay,6478,695,256,128,583,839,327,455,6152,0,0,0,0
RedCCIconGlow,6479,695,128,128,325,453,197,325,6153,0,0,0,0
ScoreDivider,6480,695,64,128,1,65,498,626,6154,0,0,0,0
ScoreTeam,6481,695,512,128,1,513,1,129,6155,0,0,0,0
TankBadge,6482,695,64,64,1,65,197,261,6156,0,0,0,0
TargetCrosshairs,6483,695,128,128,713,841,197,325,6157,0,0,0,0
tournamentarena-frame-bg-corner-blue,6484,695,32,32,773,805,69,101,6158,0,0,0,0
tournamentarena-frame-bg-corner-red,6485,695,32,32,773,805,35,67,6159,0,0,0,0
UI-Feedback-Border,6486,695,256,32,325,581,131,163,6160,0,0,0,0
UnitFrame-NoMana,6487,695,256,128,67,323,327,455,6161,0,0,0,0
UnitFrame-NoTrinket,6488,695,256,128,67,323,840,968,6162,0,0,0,0
UnitFrame,6489,695,256,128,455,711,197,325,6163,0,0,0,0
UnitFrame_CCOverlay-NoMana,6490,695,256,128,67,323,457,585,6164,0,0,0,0
UnitFrame_CCOverlay,6491,695,256,128,325,581,327,455,6165,0,0,0,0
UnitFrame_DeathOverlay-NoMana,6492,695,256,128,515,771,1,129,6166,0,0,0,0
UnitFrame_DeathOverlay,6493,695,256,128,325,581,457,585,6167,0,0,0,0
UnitFrame_FocusFireOverlay-NoMana,6494,695,256,128,67,323,710,838,6168,0,0,0,0
UnitFrame_FocusFireOverlay,6495,695,256,128,583,839,457,585,6169,0,0,0,0
UnitFrame_CurrentPlayer_CCOverlay,6497,896,512,256,1,513,1,257,6171,0,0,0,0
UnitFrame_CurrentPlayer_DeathOverlay,6498,896,512,256,1,513,259,515,6172,0,0,0,0
UnitFrame_CurrentPlayer-NoMana,6499,896,345,130,339,684,670,800,6173,0,0,0,0
UnitFrame_CurrentPlayer-NoTrinket,6500,896,345,151,1,346,517,668,6174,0,0,0,0
UnitFrame_CurrentPlayer,6501,896,345,151,515,860,259,410,6175,0,0,0,0
UnitFrame_CurrentPlayerGlow,6502,896,336,142,1,337,670,812,6176,0,0,0,0
UnitFrame_CurrentPlayer_FocusFireOverlay-NoMana,6503,896,371,130,348,719,517,647,6177,0,0,0,0
UnitFrame_CurrentPlayer_FocusFireOverlay,6504,896,372,151,515,887,1,152,6178,0,0,0,0
UnitFrame_CurrentPlayer_CCOverlay-NoMana,6505,896,330,115,1,331,814,929,6179,0,0,0,0
UnitFrame_CurrentPlayer_DeathOverlay-NoMana,6506,896,330,115,686,1016,670,785,6180,0,0,0,0
UnitFrame_CurrentPlayerGlow-NoMana,6507,695,336,121,67,403,587,708,6170,0,0,0,0
DK-Blood-Rune-Ready,6508,893,32,32,1,33,1,33,6181,0,0,0,0
DK-Rune-CD,6509,893,32,32,69,101,1,33,6182,0,0,0,0
DK-Rune-Glow,6510,893,32,32,1,33,35,67,6183,0,0,0,0
DK-Unholy-Rune-Ready,6511,893,32,32,1,33,69,101,6184,0,0,0,0
DK-Frost-Rune-Ready,6512,893,32,32,35,67,1,33,6185,0,0,0,0
raceicon-bloodelf-male,6537,897,64,64,1435,1499,131,195,6121,0,0,0,0
raceicon-draenei-female,6538,897,64,64,1897,1961,131,195,6122,0,0,0,0
raceicon-draenei-male,6539,897,64,64,1963,2027,131,195,6123,0,0,0,0
raceicon-dwarf-female,6540,897,64,64,1171,1235,197,261,6124,0,0,0,0
raceicon-dwarf-male,6541,897,64,64,1171,1235,263,327,6125,0,0,0,0
raceicon-gnome-female,6542,897,64,64,1171,1235,329,393,6126,0,0,0,0
raceicon-gnome-male,6543,897,64,64,1171,1235,395,459,6127,0,0,0,0
raceicon-goblin-male,6544,897,64,64,1171,1235,527,591,6128,0,0,0,0
raceicon-human-female,6545,897,64,64,1171,1235,725,789,6129,0,0,0,0
raceicon-human-male,6546,897,64,64,1171,1235,791,855,6130,0,0,0,0
raceicon-nightelf-female,6547,897,64,64,1765,1829,197,261,6131,0,0,0,0
raceicon-nightelf-male,6548,897,64,64,1831,1895,197,261,6132,0,0,0,0
raceicon-orc-female,6549,897,64,64,1897,1961,197,261,6133,0,0,0,0
raceicon-orc-male,6550,897,64,64,1963,2027,197,261,6134,0,0,0,0
raceicon-pandaren-female,6551,897,64,64,1237,1301,263,327,6135,0,0,0,0
raceicon-pandaren-male,6552,897,64,64,1237,1301,329,393,6136,0,0,0,0
raceicon-tauren-female,6553,897,64,64,1237,1301,395,459,6137,0,0,0,0
raceicon-tauren-male,6554,897,64,64,1237,1301,461,525,6138,0,0,0,0
raceicon-troll-female,6555,897,64,64,1237,1301,527,591,6139,0,0,0,0
raceicon-troll-male,6556,897,64,64,1237,1301,593,657,6140,0,0,0,0
raceicon-undead-female,6557,897,64,64,1237,1301,659,723,6141,0,0,0,0
raceicon-undead-male,6558,897,64,64,1237,1301,725,789,6142,0,0,0,0
raceicon-worgen-female,6559,897,64,64,1501,1565,263,327,6143,0,0,0,0
raceicon-worgen-male,6560,897,64,64,1567,1631,263,327,6144,0,0,0,0
poi-graveyard-neutral,6561,647,12,16,606,618,107,123,6232,0,0,0,0
poi-door-arrow-down,6562,647,13,14,806,819,99,113,6233,0,0,0,0
poi-door-arrow-up,6563,647,13,14,806,819,115,129,6234,0,0,0,0
poi-door,6564,647,25,24,725,750,99,123,6235,0,0,0,0
tournamentarena-winnerline,6565,695,418,1,405,823,653,654,6057,0,0,0,0
ui-moneyframe-large,6566,898,172,120,1,173,1,121,6058,0,0,0,0
talenttree-chromie-background,6568,900,322,438,1,323,1,439,6099,0,0,0,0
splash-725-botleft,6575,902,137,371,374,511,587,958,6106,0,0,0,0
splash-725-right,6576,902,510,584,1,511,1,585,6107,0,0,0,0
splash-725-topleft,6577,902,371,434,1,372,587,1021,6108,0,0,0,0
taxinode_alliance,6617,647,32,32,513,545,885,917,6197,21,21,0,0
taxinode_horde,6618,647,32,32,513,545,919,951,6198,21,21,0,0
taxinode_neutral,6619,647,32,32,513,545,953,985,6199,21,21,0,0
flightmaster_argus-taxinode_neutral,6622,647,42,36,203,245,836,872,6200,0,0,0,0
FlightMaster_Argus-Taxi_Frame_Gray,6623,905,64,54,229,293,1,55,6201,0,0,0,0
FlightMaster_Argus-Taxi_Frame_Yellow,6625,905,64,54,295,359,1,55,6202,0,0,0,0
Darklink-ball,6627,906,44,44,425,469,558,602,6194,0,0,0,0
Darklink-glow,6628,906,87,101,913,1000,175,276,6195,0,0,0,0
Darklink,6629,906,61,82,599,660,752,834,6196,0,0,0,0
Darkstone1,6630,906,52,43,913,965,278,321,6203,0,0,0,0
Darkstone2,6631,906,27,29,995,1022,532,561,6204,0,0,0,0
Darkstone3,6632,906,29,39,992,1021,47,86,6205,0,0,0,0
Darkstone4,6633,906,43,35,425,468,782,817,6206,0,0,0,0
Darkstone5,6634,906,31,44,425,456,895,939,6207,0,0,0,0
Darkstone6,6635,906,47,40,822,869,420,460,6208,0,0,0,0
Darkstone7,6636,906,27,26,551,578,990,1016,6209,0,0,0,0
Darktrait-border,6637,906,56,54,414,470,958,1012,6210,0,0,0,0
Lightlink-ball,6638,906,44,44,425,469,604,648,6211,0,0,0,0
Lightlink-glow,6639,906,87,101,733,820,327,428,6212,0,0,0,0
Lightlink,6640,906,61,82,599,660,836,918,6213,0,0,0,0
Lightstone1,6641,906,34,35,980,1014,368,403,6214,0,0,0,0
Lightstone2,6642,906,28,32,995,1023,498,530,6215,0,0,0,0
Lightstone3,6643,906,31,31,992,1023,129,160,6216,0,0,0,0
Lightstone4,6644,906,31,29,765,796,430,459,6217,0,0,0,0
Lightstone5,6645,906,45,39,425,470,695,734,6218,0,0,0,0
Lightstone6,6646,906,33,39,980,1013,327,366,6219,0,0,0,0
Lightstone7,6647,906,38,44,425,463,736,780,6220,0,0,0,0
Lighttrait-border,6648,906,56,54,812,868,656,710,6221,0,0,0,0
simplecheckout-close-hover-1x,6649,907,20,20,1,21,43,63,6222,0,0,0,0
simplecheckout-close-hover-2x,6650,907,40,40,1,41,1,41,6223,0,0,0,0
simplecheckout-close-normal-1x,6651,907,20,20,43,63,43,63,6224,0,0,0,0
simplecheckout-close-normal-2x,6652,907,40,40,43,83,1,41,6225,0,0,0,0
simplecheckout-close-pressed-1x,6653,907,20,20,85,105,43,63,6226,0,0,0,0
simplecheckout-close-pressed-2x,6654,907,40,40,85,125,1,41,6227,0,0,0,0
Darktrait-Glow,6655,906,74,74,667,741,580,654,6109,0,0,0,0
Lighttrait-glow,6656,906,74,74,743,817,580,654,6110,0,0,0,0
Mixedtrait-border,6657,906,56,54,870,926,656,710,6111,0,0,0,0
Relic-Rankframe-glow,6658,906,30,30,733,763,430,460,6112,0,0,0,0
Relic-Rankframe,6659,906,23,23,871,894,420,443,6113,0,0,0,0
Relic-Rankselected-circle,6660,906,43,43,425,468,650,693,6114,0,0,0,0
Relic-Rankselected-UpperGlow,6661,906,151,150,625,776,175,325,6115,0,0,0,0
Relicforge-background,6662,906,469,555,1,470,1,556,6116,0,0,0,0
Relicforge-Bottomframe,6663,906,469,16,522,991,462,478,6117,0,0,0,0
Relicforge-Bottomleft-corner,6664,906,71,63,341,412,958,1021,6118,0,0,0,0
Relicforge-Bottomright-corner,6665,906,71,63,739,810,656,719,6119,0,0,0,0
Relicforge-Leftframe,6666,906,23,537,472,495,462,999,6120,0,0,0,0
Relicforge-Relicsbackground,6667,906,422,398,1,423,558,956,6186,0,0,0,0
Relicforge-Rightframe,6668,906,23,537,497,520,462,999,6187,0,0,0,0
Relicforge-Slot-background,6669,906,37,37,425,462,856,893,6188,0,0,0,0
Relicforge-Slot-frame,6670,906,67,67,667,734,886,953,6228,0,0,0,0
Relicforge-Topdecoration,6671,906,261,50,1,262,958,1008,6229,0,0,0,0
Relicforge-Topframe,6672,906,469,16,522,991,480,496,6230,0,0,0,0
Relicforge-Topleft-corner,6673,906,49,68,667,716,955,1023,6248,0,0,0,0
Relicforge-Topright-corner,6674,906,49,68,739,788,795,863,6249,0,0,0,0
Darklink-active,6675,906,66,84,522,588,904,988,6250,0,0,0,0
Disablelink,6676,906,66,84,599,665,666,750,6251,0,0,0,0
Lightlink-active,6677,906,67,85,522,589,817,902,6252,0,0,0,0
Darktrait-backglow,6678,906,172,172,472,644,1,173,6307,0,0,0,0
Lighttrait-backglow,6679,906,172,172,646,818,1,173,6308,0,0,0,0
dressingroom-background-deathknight,6680,908,478,500,1,479,1,501,6253,0,0,0,0
dressingroom-background-demonhunter,6681,909,478,500,1,479,1,501,6254,0,0,0,0
dressingroom-background-druid,6682,910,478,500,1,479,1,501,6255,0,0,0,0
dressingroom-background-hunter,6683,911,478,500,1,479,1,501,6256,0,0,0,0
dressingroom-background-mage,6684,912,478,500,1,479,1,501,6257,0,0,0,0
dressingroom-background-monk,6685,913,478,500,1,479,1,501,6258,0,0,0,0
dressingroom-background-paladin,6686,914,478,500,1,479,1,501,6259,0,0,0,0
dressingroom-background-priest,6687,915,478,500,1,479,1,501,6260,0,0,0,0
dressingroom-background-rogue,6688,916,478,500,1,479,1,501,6261,0,0,0,0
dressingroom-background-shaman,6689,917,478,500,1,479,1,501,6262,0,0,0,0
dressingroom-background-warlock,6690,918,478,500,1,479,1,501,6263,0,0,0,0
dressingroom-background-warrior,6691,919,478,500,1,479,1,501,6264,0,0,0,0
Darklink-blackinside,6692,906,66,84,599,665,580,664,6030,0,0,0,0
Lightlink-blackinside,6693,906,74,91,822,896,327,418,6031,0,0,0,0
worldstate-capturebar-frame-factions,6694,901,173,26,1,174,639,665,6265,0,0,0,0
worldstate-capturebar-arrow,6701,901,9,15,199,208,499,514,6279,0,0,0,0
worldstate-capturebar-frame-separater,6702,901,3,8,252,255,421,429,6277,0,0,0,0
poi-rift1,6703,647,27,26,691,718,99,125,6280,0,0,0,0
poi-rift2,6704,647,33,32,989,1022,197,229,6281,0,0,0,0
countdown-swords,6707,920,256,256,1,257,1,257,6282,0,0,0,0
countdown-swords-glow,6708,920,256,256,259,515,1,257,6283,0,0,0,0
alliedrace-traitsborder,6709,921,35,35,724,759,98,133,6284,0,0,0,0
alliedrace-unlockingframe-background,6710,921,680,583,1,681,1,584,6285,0,0,0,0
alliedrace-unlockingframe-bottombuttonsmouseoverglow,6711,921,34,32,761,795,98,130,6286,0,0,0,0
alliedrace-unlockingframe-bottombuttonsselectionglow,6712,921,34,32,797,831,98,130,6287,0,0,0,0
alliedrace-unlockingframe-female,6713,921,35,31,833,868,98,129,6288,0,0,0,0
alliedrace-unlockingframe-gendermouseoverglow,6714,921,39,36,972,1011,1,37,6289,0,0,0,0
alliedrace-unlockingframe-genderselectionglow,6715,921,39,36,683,722,98,134,6290,0,0,0,0
alliedrace-unlockingframe-leftrotation,6716,921,26,22,972,998,39,61,6291,0,0,0,0
alliedrace-unlockingframe-male,6717,921,35,31,870,905,98,129,6292,0,0,0,0
alliedrace-unlockingframe-rightrotation,6719,921,26,22,968,994,68,90,6293,0,0,0,0
alliedrace-unlockingframe-zoomin,6720,921,26,22,996,1022,68,90,6294,0,0,0,0
alliedrace-unlockingframe-zoomout,6721,921,26,22,907,933,98,120,6295,0,0,0,0
AlliedRace-UnlockingFrame-ModelBackground-Highmountain,6722,922,314,578,317,631,1,579,6296,0,0,0,0
AlliedRace-UnlockingFrame-ModelBackground-Nightborne,6724,922,314,578,633,947,1,579,6297,0,0,0,0
AlliedRace-UnlockingFrame-ModelBackground-Voidelf,6725,922,314,578,949,1263,1,579,6298,0,0,0,0
alliedrace-crest-highmountain,6726,923,64,64,1,65,67,131,6299,0,0,0,0
alliedrace-crest-lightforge,6727,923,64,64,67,131,1,65,6300,0,0,0,0
alliedrace-crest-nightborne,6728,923,64,64,133,197,1,65,6301,0,0,0,0
alliedrace-crest-voidelf,6729,923,64,64,133,197,67,131,6302,0,0,0,0
FlightMaster_VindicaarArgus-Taxi_Frame_Gray,6732,905,74,79,1,75,1,80,6309,0,0,0,0
FlightMaster_VindicaarArgus-Taxi_Frame_Green,6733,905,74,79,1,75,82,161,6310,0,0,0,0
FlightMaster_VindicaarArgus-Taxi_Frame_Yellow,6734,905,74,79,1,75,163,242,6311,0,0,0,0
FlightMaster_VindicaarMacAree-Taxi_Frame_Gray,6735,905,74,79,77,151,1,80,6312,0,0,0,0
FlightMaster_VindicaarMacAree-Taxi_Frame_Green,6736,905,74,79,77,151,82,161,6313,0,0,0,0
FlightMaster_VindicaarMacAree-Taxi_Frame_Yellow,6737,905,74,79,77,151,163,242,6314,0,0,0,0
FlightMaster_VindicaarStygianWake-Taxi_Frame_Gray,6738,905,74,79,153,227,1,80,6315,0,0,0,0
FlightMaster_VindicaarStygianWake-Taxi_Frame_Green,6739,905,74,79,153,227,82,161,6316,0,0,0,0
FlightMaster_VindicaarStygianWake-Taxi_Frame_Yellow,6740,905,74,79,153,227,163,242,6317,0,0,0,0
Relic-Rankdisable-DarkGlow,6741,906,151,150,472,623,175,325,6318,0,0,0,0
flightmasterargus,6748,647,32,32,377,409,987,1019,6322,0,0,0,0
ArtifactsFX-PointSideBurstLeft-Purple,6756,906,33,35,986,1019,656,691,6032,0,0,0,0
ArtifactsFX-PointSideBurstRight-Purple,6757,906,33,35,799,832,721,756,6033,0,0,0,0
ArtifactsFX-SpinningGlowys-Purple,6758,906,70,70,895,965,580,650,6034,0,0,0,0
ArtifactsFX-StarBurst-Purple,6759,906,133,133,472,605,327,460,6035,0,0,0,0
ArtifactsFX-Whirls-Purple,6760,906,76,76,686,762,498,574,6036,0,0,0,0
ArtifactsFX-YellowRing-Purple,6761,906,50,50,739,789,917,967,6037,0,0,0,0
AdventureMap_TileBg_Parchment,6762,925,512,512,0,512,0,512,6319,0,0,6,0
_GarrMissionLocation-Argus-Mid,6763,926,1024,285,0,1024,1,286,6320,0,0,4,0
GarrMissionLocation-Argus-List,6764,832,792,78,1,793,561,639,6321,0,0,0,0
Darktrait-border-selected,6769,906,80,80,898,978,327,407,6326,0,0,0,0
Lighttrait-border-selected,6771,906,80,80,522,602,498,578,6327,0,0,0,0
Neutralstone1,6772,906,52,43,967,1019,278,321,6328,0,0,0,0
Neutralstone2,6773,906,27,29,522,549,990,1019,6329,0,0,0,0
Neutralstone3,6774,906,29,39,992,1021,88,127,6330,0,0,0,0
Neutralstone4,6775,906,43,35,425,468,819,854,6331,0,0,0,0
Neutralstone5,6776,906,31,44,992,1023,1,45,6332,0,0,0,0
Neutralstone6,6777,906,47,40,739,786,969,1009,6333,0,0,0,0
Neutralstone7,6778,906,27,26,986,1013,693,719,6334,0,0,0,0
Neutraltrait-border-selected,6779,906,80,80,604,684,498,578,6038,0,0,0,0
Neutraltrait-border,6780,906,56,54,928,984,656,710,6039,0,0,0,0
poi-door-down,6781,647,25,24,752,777,99,123,6040,0,0,0,0
poi-door-left,6782,647,25,24,779,804,99,123,6041,0,0,0,0
poi-door-right,6783,647,25,24,1,26,993,1017,6042,0,0,0,0
poi-door-up,6784,647,25,24,28,53,993,1017,6043,0,0,0,0
QuestBG-TheHandofFate,6786,843,299,407,603,902,1,408,6059,0,0,0,0
splash-730-botleft,6787,927,137,371,374,511,587,958,6045,0,0,0,0
splash-730-right,6788,927,510,584,1,511,1,585,6046,0,0,0,0
splash-730-topleft,6789,927,371,434,1,372,587,1021,6047,0,0,0,0
Neutraltrait-backglow,6790,906,170,169,820,990,1,170,6048,0,0,0,0
Neutraltrait-Glow,6791,906,74,74,819,893,580,654,6049,0,0,0,0
AftLevelup-NeutralStarBurst,6792,906,124,123,607,731,327,450,6050,0,0,0,0
AftLevelup-PurpleStarBurst,6793,906,133,133,778,911,175,308,6051,0,0,0,0
Artifacts-PerkRing-NeutralGlow,6794,906,50,50,898,948,409,459,6052,0,0,0,0
Artifacts-PerkRing-PurpleGlow,6795,906,50,50,950,1000,409,459,6053,0,0,0,0
ArtifactsFX-Whirls-Neutral,6796,906,67,76,667,734,734,810,6054,0,0,0,0
ArtifactsFX-YellowRing-Neutral,6797,906,50,50,739,789,865,915,6055,0,0,0,0
Rune-01-neutral,6798,906,67,72,667,734,812,884,6056,0,0,0,0
Rune-01-purple,6799,906,75,77,764,839,498,575,6060,0,0,0,0
Rune-02-neutral,6800,906,75,64,264,339,958,1022,6061,0,0,0,0
Rune-02-purple,6801,906,75,77,841,916,498,575,6062,0,0,0,0
Rune-03-neutral,6802,906,70,76,667,737,656,732,6063,0,0,0,0
Rune-03-purple,6803,906,75,77,918,993,498,575,6064,0,0,0,0
Rune-04-neutral,6804,906,60,77,599,659,920,997,6065,0,0,0,0
Rune-04-purple,6805,906,75,77,522,597,580,657,6066,0,0,0,0
Rune-05-neutral,6806,906,52,74,967,1019,580,654,6067,0,0,0,0
Rune-05-purple,6807,906,75,77,522,597,659,736,6068,0,0,0,0
Rune-06-neutral,6808,906,58,72,739,797,721,793,6069,0,0,0,0
Rune-06-purple,6809,906,75,77,522,597,738,815,6070,0,0,0,0
GarrMission_ClassIcon-Voidscarred,6816,823,55,49,58,113,52,101,6071,0,0,0,0
GarrMission_ClassIcon-ArgussianReach,6817,823,55,49,1,56,460,509,6072,0,0,0,0
GarrMission_ClassIcon-ArmyoftheLight,6818,823,55,49,58,113,103,152,6073,0,0,0,0
AntoranWastes_Highlight,6819,928,512,512,0,512,0,512,6077,0,0,6,0
Relicforge-Relicsbackground-Previewtraits,6824,929,412,387,1,413,1,388,6076,0,0,0,0
Relicforge-Slot-frame-Active,6825,929,67,67,415,482,1,68,6078,0,0,0,0
Krokuun_Highlight,6826,930,768,512,1,769,0,512,6074,0,0,2,0
MacAree_Highlight,6829,933,768,512,1,769,0,512,6075,0,0,2,0
FlightMaster_Argus-Taxi_Frame_Green,6830,905,64,54,361,425,1,55,6079,0,0,0,0
voicechat-channellist-row-background,6850,938,20,20,482,502,1,21,6080,0,0,0,0
voicechat-channellist-row-highlight,6851,938,304,32,1,305,1,33,6081,0,0,0,0
voicechat-channellist-row-selected,6852,938,304,32,1,305,35,67,6082,0,0,0,0
voicechat-icon-headphone-off,6853,938,64,64,1,65,135,199,6083,0,0,0,0
voicechat-icon-headphone-on,6854,938,64,64,87,151,69,133,6084,0,0,0,0
voicechat-icon-headphone-pending,6855,938,64,64,87,151,135,199,6085,0,0,0,0
voicechat-icon-headphone-pendingdot-1,6856,938,64,64,153,217,69,133,6086,0,0,0,0
voicechat-icon-headphone-pendingdot-2,6857,938,64,64,153,217,135,199,6087,0,0,0,0
voicechat-icon-headphone-pendingdot-3,6858,938,64,64,219,283,69,133,6088,0,0,0,0
voicechat-icon-headphone-switch,6859,938,84,64,1,85,69,133,6089,0,0,0,0
voicechat-icon-loudnessbar-1,6860,938,32,32,48,80,201,233,6090,0,0,0,0
voicechat-icon-loudnessbar-2,6861,938,32,32,285,317,179,211,6091,0,0,0,0
voicechat-icon-loudnessbar-3,6862,938,32,32,285,317,213,245,6092,0,0,0,0
voicechat-icon-mic-mute,6863,938,32,32,385,417,69,101,6093,0,0,0,0
voicechat-icon-mic-silenced,6864,938,32,32,453,485,69,101,6094,0,0,0,0
voicechat-icon-mic,6865,938,32,32,351,383,69,101,6095,0,0,0,0
voicechat-icon-speaker-mute,6866,938,32,32,351,383,137,169,6096,0,0,0,0
voicechat-icon-speaker-silenced,6867,938,32,32,351,383,205,237,6097,0,0,0,0
voicechat-icon-speaker,6868,938,32,32,351,383,103,135,6098,0,0,0,0
hud-mainmenubar-arrowdown-disabled,6870,940,21,19,1,22,229,248,6236,0,0,0,0
hud-mainmenubar-arrowdown-down,6871,940,21,19,929,950,22,41,6237,0,0,0,0
hud-mainmenubar-arrowdown-highlight,6872,940,21,19,583,604,22,41,6238,0,0,0,0
hud-mainmenubar-arrowdown-up,6873,940,21,19,666,687,1,20,6239,0,0,0,0
hud-mainmenubar-arrowup-disabled,6874,940,21,19,929,950,1,20,6240,0,0,0,0
hud-mainmenubar-arrowup-down,6875,940,21,19,666,687,22,41,6241,0,0,0,0
hud-mainmenubar-arrowup-highlight,6876,940,21,19,583,604,1,20,6242,0,0,0,0
hud-mainmenubar-arrowup-up,6877,940,21,19,952,973,1,20,6243,0,0,0,0
hud-mainmenubar-gryphon,6880,940,128,76,31,159,84,160,6244,0,0,0,0
AlliedRace-UnlockingFrame-ModelFrame,6882,941,328,589,1,329,1,590,6245,0,0,0,0
AlliedRace-UnlockingFrame-RaceBanner,6883,941,130,584,331,461,1,585,6246,0,0,0,0
alliedrace-unlockingframe-modelbackground-lightforge,6884,942,314,578,317,631,1,579,6247,0,0,0,0
voicechat-channellist-category-background,6885,938,173,20,307,480,1,21,6304,0,0,0,0
voicechat-channellist-category-minus,6886,938,7,7,504,511,1,8,6305,0,0,0,0
voicechat-channellist-category-plus,6887,938,7,7,504,511,10,17,6306,0,0,0,0
Front-Gold-Icon,6888,892,32,32,1,33,1,33,6324,0,0,0,0
Front-Tree-Icon,6889,892,32,32,35,67,1,33,6323,0,0,0,0
shop-card-half-brownbox,6891,943,286,471,1,287,1,472,6325,0,0,0,0
shop-card-half-brownboxlegionbundle,6892,943,286,471,289,575,1,472,6044,0,0,0,0
shop-card-half-legion,6895,944,286,471,1,287,1,472,6017,0,0,0,0
shop-card-half-legiondeluxe,6896,944,286,471,289,575,1,472,6018,0,0,0,0
shop-card-full-legiondeluxe,6897,945,568,463,1,569,1,464,6019,0,0,0,0
hud-mainmenubar-experiencebar-large-double,6898,940,804,14,31,835,52,66,6015,0,0,0,0
hud-mainmenubar-experiencebar-large-single,6899,940,804,14,161,965,84,98,6016,0,0,0,0
hud-mainmenubar-experiencebar-small-double,6900,940,550,14,161,711,151,165,6020,0,0,0,0
hud-mainmenubar-experiencebar-small-single,6901,940,550,14,31,581,68,82,6021,0,0,0,0
hud-mainmenubar-large,6902,940,804,49,161,965,100,149,6022,0,0,0,0
hud-mainmenubar-small,6903,940,550,49,31,581,1,50,6023,0,0,0,0
chatframe-button-down,6904,924,27,26,225,252,1,27,6024,0,0,0,0
chatframe-button-up,6905,924,27,26,132,159,60,86,6025,0,0,0,0
chatframe-button-icon-voicechat,6906,924,29,29,194,223,1,30,6026,0,0,0,0
chatframe-button-highlight,6907,924,27,26,132,159,32,58,6027,0,0,0,0
shop-card-half-hover,6908,946,278,463,1,279,1,464,6028,0,0,0,0
hud-microbutton-lfg-up,6909,940,28,36,839,867,1,37,6029,0,0,0,0
hud-microbutton-achievement-disabled,6910,940,28,36,1,29,39,75,6344,0,0,0,0
hud-microbutton-lfg-down,6911,940,28,36,1,29,115,151,6345,0,0,0,0
hud-microbutton-bstore-down,6912,940,28,36,689,717,1,37,6346,0,0,0,0
hud-microbutton-socials-disabled,6913,940,28,36,191,219,167,203,6347,0,0,0,0
hud-microbutton-mainmenu-up,6914,940,28,36,551,579,205,241,6348,0,0,0,0
hud-microbutton-quest-disabled,6915,940,28,36,967,995,100,136,6349,0,0,0,0
hud-microbutton-achievement-down,6916,940,28,36,1,29,77,113,6350,0,0,0,0
hud-microbutton-bstore-up,6917,940,28,36,31,59,162,198,6351,0,0,0,0
hud-microbutton-quest-up,6918,940,28,36,121,149,162,198,6352,0,0,0,0
hud-microbutton-quest-down,6919,940,28,36,161,189,167,203,6353,0,0,0,0
hud-microbutton-spellbook-down,6920,940,28,36,521,549,167,203,6354,0,0,0,0
hud-microbutton-ej-down,6921,940,28,36,91,119,200,236,6355,0,0,0,0
hud-microbutton-socials-up,6922,940,28,36,191,219,205,241,6356,0,0,0,0
hud-microbutton-lfg-disabled,6923,940,28,36,1,29,153,189,6357,0,0,0,0
hud-microbutton-streamdl-up,6924,940,28,36,869,897,1,37,6358,0,0,0,0
hud-microbutton-character-down,6925,940,28,36,61,89,162,198,6359,0,0,0,0
hud-microbutton-streamdl-down,6926,940,28,36,636,664,1,37,6360,0,0,0,0
hud-microbutton-mainmenu-down,6927,940,28,36,1,29,1,37,6361,0,0,0,0
hud-microbutton-mainmenu-disabled,6928,940,28,36,809,837,1,37,6362,0,0,0,0
hud-microbutton-talents-disabled,6929,940,28,36,719,747,1,37,6363,0,0,0,0
hud-microbutton-bstore-disabled,6930,940,28,36,975,1003,1,37,6364,0,0,0,0
hud-microbutton-mounts-disabled,6931,940,28,36,749,777,1,37,6365,0,0,0,0
hud-microbutton-mounts-up,6932,940,28,36,161,189,205,241,6366,0,0,0,0
hud-microbutton-character-up,6933,940,28,36,31,59,200,236,6367,0,0,0,0
hud-microbutton-socials-down,6934,940,28,36,121,149,200,236,6368,0,0,0,0
hud-microbutton-spellbook-up,6935,940,28,36,521,549,205,241,6369,0,0,0,0
hud-microbutton-talents-down,6936,940,28,36,581,609,205,241,6370,0,0,0,0
hud-microbutton-mounts-down,6937,940,28,36,779,807,1,37,6371,0,0,0,0
hud-microbutton-ej-disabled,6938,940,28,36,61,89,200,236,6372,0,0,0,0
hud-microbutton-ej-up,6939,940,28,36,91,119,162,198,6373,0,0,0,0
hud-microbutton-spellbook-disabled,6940,940,28,36,1,29,191,227,6374,0,0,0,0
hud-microbutton-talents-up,6941,940,28,36,551,579,167,203,6375,0,0,0,0
hud-microbagbar,6942,940,298,88,221,519,167,255,6376,0,0,0,0
hud-microbutton-achievement-up,6943,940,28,36,606,634,1,37,6377,0,0,0,0
AlliedRaces-AllianceHordeBanner,6944,947,212,520,1,213,1,521,6406,0,0,0,0
loottoast-itemborder-gold,6946,332,58,58,807,865,218,276,6339,0,0,0,0
hud-microbutton-highlight,6947,940,28,36,619,647,209,245,6419,0,0,0,0
UI-Frame-InnerTopLeft,6948,948,6,6,97,103,71,77,6379,0,0,0,0
UI-Frame-Portrait,6949,948,78,78,1,79,1,79,6380,0,0,0,0
UI-Frame-InnerBotLeftCorner,6950,948,6,6,81,87,71,77,6381,0,0,0,0
UI-Frame-BtnDivRight,6951,948,11,25,44,55,81,106,6382,0,0,0,0
UI-Frame-TopCornerRight,6952,948,33,33,81,114,36,69,6383,0,0,0,0
UI-Frame-BtnDivMiddle,6953,948,13,25,29,42,81,106,6384,0,0,0,0
UI-Frame-BotCornerRight,6954,948,11,11,116,127,63,74,6385,0,0,0,0
UI-Frame-BotCornerLeft,6955,948,14,14,57,71,81,95,6386,0,0,0,0
UI-Frame-TopCornerRightSimple,6956,948,11,11,1,12,115,126,6387,0,0,0,0
UI-Frame-InnerBotRight,6957,948,6,6,89,95,71,77,6388,0,0,0,0
UI-Frame-InnerTopRight,6958,948,6,6,105,111,71,77,6389,0,0,0,0
UI-Frame-InnerSplitRight,6959,948,9,14,117,126,17,31,6390,0,0,0,0
UI-Frame-BtnDivLeft,6960,948,11,25,116,127,36,61,6391,0,0,0,0
UI-Frame-InnerSplitLeft,6961,948,9,14,117,126,1,15,6392,0,0,0,0
UI-Frame-BtnCornerLeft,6963,948,12,32,1,13,81,113,6394,0,0,0,0
UI-Frame-BtnCornerRight,6964,948,12,32,15,27,81,113,6395,0,0,0,0
!UI-Frame-InnerLeftTile,6965,949,3,256,31,34,0,256,6378,0,0,2,0
!UI-Frame-InnerRightTile,6966,949,3,256,36,39,0,256,6396,0,0,2,0
!UI-Frame-RightTile,6967,949,10,256,19,29,0,256,6397,0,0,2,0
!UI-Frame-LeftTile,6968,949,16,256,1,17,0,256,6398,0,0,2,0
_UI-Frame-InnerTopTile,6969,950,256,3,0,256,116,119,6399,0,0,4,0
_UI-Frame-TitleTile,6971,950,256,28,0,256,46,74,6401,0,0,4,1
_UI-Frame-InnerBotTile,6972,950,256,3,0,256,111,114,6402,0,0,4,0
_UI-Frame-Bot,6973,950,256,9,0,256,95,104,6403,0,0,4,0
_UI-Frame-TitleTileBg,6974,950,256,17,0,256,76,93,6404,0,0,4,0
_UI-Frame-BtnBotTile,6975,950,256,3,0,256,106,109,6405,0,0,4,0
UI-Frame-TopLeftCorner,6976,948,14,14,57,71,97,111,6393,0,0,0,0
_UI-Frame-TopTileStreaks,6977,950,256,43,0,256,1,44,6400,0,0,4,0
UI-Frame-TopCornerRight-HiRes,6986,954,158,138,238,396,1,139,6407,0,0,0,0
UI-Frame-Portrait-HiRes,6987,954,235,240,1,236,1,241,6408,0,0,0,0
UI-Frame-BotCornerLeft-HiRes,6988,954,45,49,447,492,1,50,6409,0,0,0,0
UI-Frame-BotCornerRight-HiRes,6989,954,47,49,398,445,1,50,6410,0,0,0,0
!UI-Frame-LeftTile-HiRes,6995,955,16,512,20,36,0,512,6411,0,0,2,0
!UI-Frame-RightTile-HiRes,6996,955,17,512,1,18,0,512,6412,0,0,2,0
_UI-Frame-Bot-HiRes,6997,956,512,16,0,512,73,89,6413,0,0,4,0
_UI-Frame-TittleTile-HiRes,6998,956,512,70,0,512,1,71,6414,0,0,4,0
BlizzCon2017Splash-button-newplayer,6999,958,314,66,1,315,628,694,6415,0,0,0,0
BlizzCon2017Splash-button-playexpansion,7000,958,555,64,1,556,562,626,6416,0,0,0,0
BlizzCon2017Splash-label-newtowow,7001,958,295,30,558,853,562,592,6417,0,0,0,0
BlizzCon2017Splash-logo,7002,958,1022,559,1,1023,1,560,6418,0,0,0,0
hud-PlayerFrame-portraitring-large,7006,964,186,186,1,187,1,187,6455,0,0,0,0
hud-PlayerFrame-levelring,7007,964,36,32,189,225,1,33,6456,0,0,0,0
hud-TargetingFrame,7008,965,256,128,0,256,0,128,6457,0,0,6,0
hud-TargetingFrame-rare-elite,7010,966,256,128,0,256,0,128,6491,0,0,6,0
hud-TargetingFrame-rare,7011,967,256,128,0,256,0,128,6492,0,0,6,0
hud-TargetingFrame-elite,7012,968,256,128,0,256,0,128,6493,0,0,6,0
hud-UnitFrame-Boss,7013,969,256,128,0,256,0,128,6494,0,0,6,0
nameplates-bar-fill,7014,970,256,32,0,256,0,32,6459,0,0,6,0
shop-card-bundle-hover,7015,971,284,201,1,285,212,413,6527,0,0,0,0
shop-card-bundle-legion,7016,971,292,158,581,873,162,320,6528,0,0,0,0
shop-card-bundle,7018,971,292,209,1,293,1,210,6530,0,0,0,0
shop-card-bundle-selected,7019,971,284,201,295,579,1,202,6531,0,0,0,0
raceicon-voidelf-male,7020,897,64,64,1303,1367,263,327,6566,0,0,0,0
raceicon-goblin-female,7021,897,64,64,1171,1235,461,525,6567,0,0,0,0
raceicon-nightborne-male,7022,897,64,64,1699,1763,197,261,6568,0,0,0,0
raceicon-lightforged-male,7023,897,64,64,1303,1367,197,261,6569,0,0,0,0
raceicon-nightborne-female,7024,897,64,64,1633,1697,197,261,6570,0,0,0,0
raceicon-highmountain-female,7025,897,64,64,1171,1235,593,657,6571,0,0,0,0
raceicon-voidelf-female,7026,897,64,64,1237,1301,923,987,6572,0,0,0,0
raceicon-lightforged-female,7027,897,64,64,1237,1301,197,261,6573,0,0,0,0
raceicon-bloodelf-female,7028,897,64,64,1369,1433,131,195,6574,0,0,0,0
raceicon-highmountain-male,7029,897,64,64,1171,1235,659,723,6575,0,0,0,0
bags-icon-addslots,7030,202,42,42,273,315,1,43,6576,0,0,0,0
bags-static,7033,202,178,43,93,271,1,44,6532,0,0,0,0
category-icon-ring,7043,654,74,74,149,223,123,197,6607,0,0,0,0
vas-receipt-icon-characterborder,7045,654,34,34,109,143,212,246,6462,0,0,0,0
warboard-header-alliance,7047,975,708,210,1,709,262,472,6583,0,0,0,0
warboard-header-horde,7048,975,638,240,353,991,474,714,6584,0,0,0,0
warboard-parchment-answerborder,7049,975,190,93,711,901,349,442,6585,0,0,0,0
warboard-parchment,7050,975,350,473,1,351,474,947,6586,0,0,0,0
warboard-title-alliance-left,7051,975,202,85,557,759,716,801,6587,0,0,0,0
warboard-title-alliance-right,7052,975,202,85,353,555,716,801,6588,0,0,0,0
warboard-title-horde-left,7053,975,202,85,711,913,262,347,6589,0,0,0,0
warboard-title-horde-right,7054,975,202,85,761,963,716,801,6590,0,0,0,0
warboard-title-neutral-left,7055,975,202,85,353,555,803,888,6591,0,0,0,0
warboard-title-neutral-right,7056,975,202,85,353,555,890,975,6592,0,0,0,0
_warboard-title-alliance-middle,7057,975,128,85,0,128,1,86,6593,0,0,4,0
_warboard-title-horde-middle,7058,975,128,85,0,128,175,260,6594,0,0,4,0
_warboard-title-neutral-middle,7059,975,128,85,0,128,88,173,6595,0,0,4,0
warboard-background,7060,976,597,502,1,598,1,503,6596,0,0,0,0
accountupgradebanner-bfa,7150,558,200,134,1,201,285,419,6535,0,0,0,0
azeriteready,7152,647,32,32,785,817,375,407,6467,0,0,0,0
azeritespawning,7153,647,32,32,819,851,375,407,6468,0,0,0,0
splash-735-botleft,7154,984,137,371,374,511,587,958,6469,0,0,0,0
splash-735-right,7155,984,510,584,1,511,1,585,6470,0,0,0,0
splash-735-topleft,7156,984,371,434,1,372,587,1021,6471,0,0,0,0
Warfronts-BaseMapIcons-Alliance-Armory,7157,985,37,35,1,38,1,36,6472,0,0,0,0
Warfronts-BaseMapIcons-Alliance-Barracks,7158,985,37,35,40,77,1,36,6473,0,0,0,0
Warfronts-BaseMapIcons-Alliance-Heroes,7159,985,37,35,79,116,1,36,6474,0,0,0,0
Warfronts-BaseMapIcons-Alliance-MainHall,7160,985,37,35,118,155,1,36,6475,0,0,0,0
Warfronts-BaseMapIcons-Alliance-Tower,7161,985,37,35,157,194,1,36,6476,0,0,0,0
Warfronts-BaseMapIcons-Alliance-Workshop,7162,985,37,35,196,233,1,36,6477,0,0,0,0
Warfronts-BaseMapIcons-Empty-Armory,7163,985,37,35,1,38,38,73,6478,0,0,0,0
Warfronts-BaseMapIcons-Empty-Barracks,7164,985,37,35,1,38,75,110,6479,0,0,0,0
Warfronts-BaseMapIcons-Empty-Heroes,7165,985,37,35,1,38,112,147,6480,0,0,0,0
Warfronts-BaseMapIcons-Empty-Tower,7166,985,37,35,1,38,186,221,6481,0,0,0,0
Warfronts-BaseMapIcons-Empty-Workshop,7167,985,37,35,40,77,38,73,6482,0,0,0,0
Warfronts-BaseMapIcons-Horde-Armory,7168,985,37,35,79,116,38,73,6483,0,0,0,0
Warfronts-BaseMapIcons-Horde-Barracks,7169,985,37,35,118,155,38,73,6484,0,0,0,0
Warfronts-BaseMapIcons-Horde-Heroes,7170,985,37,35,157,194,38,73,6485,0,0,0,0
Warfronts-BaseMapIcons-Horde-MainHall,7171,985,37,35,196,233,38,73,6486,0,0,0,0
Warfronts-BaseMapIcons-Horde-Tower,7172,985,37,35,40,77,75,110,6487,0,0,0,0
Warfronts-BaseMapIcons-Horde-Workshop,7173,985,37,35,40,77,112,147,6488,0,0,0,0
shop-card-full-bfadeluxe,7174,986,568,463,1,569,1,464,6534,0,0,0,0
accountupgradebanner-bfa,7175,986,200,134,571,771,162,296,6535,0,0,0,0
shop-card-half-brownboxbfabundle,7176,987,286,471,289,575,1,472,6536,0,0,0,0
shop-card-half-bfadeluxe,7177,987,286,471,1,287,474,945,6537,0,0,0,0
shop-card-half-bfa,7178,987,286,471,1,287,1,472,6538,0,0,0,0
AzeriteArmor-CharacterInfo-Border,7179,988,57,46,133,190,638,684,6495,0,0,0,0
Bfa-boostpopup-bottom,7180,989,430,70,1,431,185,255,6539,0,0,0,0
Bfa-boostpopup-exit-frame,7181,989,32,32,433,465,1,33,6540,0,0,0,0
Bfa-boostpopup-middle,7182,989,430,108,1,431,1,109,6541,0,0,0,0
Bfa-boostpopup-top,7183,989,430,72,1,431,111,183,6542,0,0,0,0
warboard,7184,647,32,32,581,613,681,713,6608,0,0,0,0
FlightMaster_VindicaarArgus-TaxiNode_Neutral,7185,990,91,107,106,197,1,108,6461,0,0,0,0
FlightMaster_VindicaarArgus-TaxiNode_Special,7186,990,91,107,106,197,110,217,6463,0,0,0,0
FlightMaster_VindicaarMacAree-TaxiNode_Neutral,7187,990,85,103,199,284,1,104,6464,0,0,0,0
FlightMaster_VindicaarMacAree-TaxiNode_Special,7188,990,85,103,199,284,106,209,6465,0,0,0,0
FlightMaster_VindicaarStygianWake-TaxiNode_Neutral,7189,990,103,99,1,104,1,100,6466,0,0,0,0
FlightMaster_VindicaarStygianWake-TaxiNode_Special,7190,990,103,99,1,104,102,201,6489,0,0,0,0
warboard-parchment-nail,7191,975,46,45,915,961,262,307,5033,0,0,0,0
shop-card-bundle-battleforazeroth,7192,986,292,159,571,863,1,160,6609,0,0,0,0
shop-card-half-legionbfabundle,7193,987,286,471,289,575,474,945,6543,0,0,0,0
warfront-alliancedot,7195,647,32,32,581,613,749,781,6497,0,0,0,0
warfront-hordedot,7196,647,32,32,615,647,613,645,6498,0,0,0,0
Warfronts-FieldMapIcons-Empty-Banner,7197,985,37,35,118,155,75,110,6544,0,0,0,0
Warfronts-FieldMapIcons-Alliance-LumberMill,7198,985,37,35,40,77,186,221,6545,0,0,0,0
Warfronts-FieldMapIcons-Empty-Mine,7199,985,37,35,196,233,75,110,6546,0,0,0,0
Warfronts-FieldMapIcons-Empty-LumberMill,7200,985,37,35,157,194,75,110,6547,0,0,0,0
Warfronts-FieldMapIcons-Horde-Banner,7201,985,37,35,79,116,112,147,6548,0,0,0,0
Warfronts-FieldMapIcons-Alliance-Mine,7202,985,37,35,79,116,75,110,6549,0,0,0,0
Warfronts-FieldMapIcons-Horde-LumberMill,7203,985,37,35,79,116,149,184,6550,0,0,0,0
Warfronts-FieldMapIcons-Alliance-Banner,7204,985,37,35,40,77,149,184,6551,0,0,0,0
Warfronts-FieldMapIcons-Horde-Mine,7205,985,37,35,79,116,186,221,6552,0,0,0,0
warfront-alliancehero,7207,647,32,32,581,613,783,815,6554,0,0,0,0
warfront-hordehero,7208,647,32,32,649,681,613,645,6555,0,0,0,0
hud-microbutton-highlightalert,7209,940,33,40,619,652,167,207,6556,0,0,0,0
warfronts-basemapicons-alliance-armory-minimap,7210,647,37,35,680,717,263,298,6496,0,0,0,0
warfronts-basemapicons-alliance-barracks-minimap,7211,647,37,35,758,795,263,298,6499,0,0,0,0
warfronts-basemapicons-alliance-heroes-minimap,7212,647,37,35,533,570,301,336,6500,0,0,0,0
warfronts-basemapicons-alliance-mainhall-minimap,7213,647,37,35,611,648,301,336,6501,0,0,0,0
warfronts-basemapicons-alliance-workshop-minimap,7214,647,37,35,767,804,301,336,6502,0,0,0,0
warfronts-basemapicons-empty-armory-minimap,7215,647,37,35,845,882,301,336,6503,0,0,0,0
warfronts-basemapicons-empty-barracks-minimap,7216,647,37,35,923,960,301,336,6504,0,0,0,0
warfronts-basemapicons-empty-heroes-minimap,7217,647,37,35,299,336,338,373,6505,0,0,0,0
warfronts-basemapicons-empty-mainhall-minimap,7218,647,37,35,299,336,412,447,6506,0,0,0,0
warfronts-basemapicons-empty-workshop-minimap,7219,647,37,35,299,336,560,595,6507,0,0,0,0
warfronts-basemapicons-horde-armory-minimap,7220,647,37,35,299,336,634,669,6508,0,0,0,0
warfronts-basemapicons-horde-barracks-minimap,7221,647,37,35,299,336,708,743,6509,0,0,0,0
warfronts-basemapicons-horde-heroes-minimap,7222,647,37,35,494,531,338,373,6510,0,0,0,0
warfronts-basemapicons-horde-mainhall-minimap,7223,647,37,35,572,609,338,373,6511,0,0,0,0
warfronts-basemapicons-horde-workshop-minimap,7224,647,37,35,728,765,338,373,6512,0,0,0,0
Warfronts-BaseMapIcons-Empty-MainHall,7225,985,37,35,1,38,149,184,6421,0,0,0,0
Warfronts-FieldMapIcons-Neutral-Banner,7226,985,37,35,118,155,112,147,6422,0,0,0,0
Warfronts-FieldMapIcons-Neutral-Mine,7227,985,37,35,157,194,112,147,6423,0,0,0,0
pvptalents-background,7228,110,131,379,1,132,568,947,6513,0,0,0,0
pvptalents-list-background-mouseover,7229,110,147,40,67,214,201,241,6514,0,0,0,0
pvptalents-list-background-selected,7230,110,147,40,71,218,258,298,6515,0,0,0,0
pvptalents-list-background,7231,110,147,40,51,198,151,191,6516,0,0,0,0
pvptalents-list-checkmark,7232,110,28,26,200,228,151,177,6517,0,0,0,0
pvptalents-selectedarrow,7233,110,43,44,203,246,466,510,6518,0,0,0,0
pvptalents-talentborder-locked,7234,110,58,58,194,252,650,708,6519,0,0,0,0
pvptalents-talentborder,7235,110,58,58,134,192,650,708,6520,0,0,0,0
pvptalents-warmode-orb,7236,110,80,84,83,163,380,464,6521,0,0,0,0
pvptalents-warmode-ring-disabled,7237,110,80,84,1,81,380,464,6522,0,0,0,0
pvptalents-warmode-ring,7238,110,80,84,165,245,380,464,6523,0,0,0,0
pvptalents-warmode-swords-disabled,7239,110,46,43,203,249,310,353,6524,0,0,0,0
pvptalents-warmode-swords,7240,110,46,43,193,239,104,147,6525,0,0,0,0
transmog-background-race-voidelf,7244,991,294,494,1,295,1,495,6597,0,0,0,0
transmog-background-race-nightborne,7246,993,294,494,1,295,1,495,6598,0,0,0,0
transmog-background-race-highmountaintauren,7248,992,294,494,1,295,1,495,6600,0,0,0,0
transmog-background-race-lightforgeddraenei,7249,994,294,494,1,295,1,495,6582,0,0,0,0
warfronts-fieldmapicons-alliance-banner-minimap,7250,647,37,35,806,843,338,373,6610,0,0,0,0
warfronts-fieldmapicons-alliance-lumbermill-minimap,7251,647,37,35,884,921,338,373,6611,0,0,0,0
warfronts-fieldmapicons-alliance-mine-minimap,7252,647,37,35,962,999,338,373,6612,0,0,0,0
warfronts-fieldmapicons-empty-banner-minimap,7253,647,37,35,338,375,412,447,6613,0,0,0,0
warfronts-fieldmapicons-empty-lumbermill-minimap,7254,647,37,35,338,375,486,521,6614,0,0,0,0
warfronts-fieldmapicons-empty-mine-minimap,7255,647,37,35,338,375,560,595,6615,0,0,0,0
warfronts-fieldmapicons-horde-banner-minimap,7256,647,37,35,338,375,634,669,6616,0,0,0,0
warfronts-fieldmapicons-horde-lumbermill-minimap,7257,647,37,35,338,375,708,743,6617,0,0,0,0
warfronts-fieldmapicons-horde-mine-minimap,7258,647,37,35,338,375,782,817,6618,0,0,0,0
warfronts-fieldmapicons-neutral-banner-minimap,7259,647,37,35,338,375,856,891,6619,0,0,0,0
warfronts-fieldmapicons-neutral-mine-minimap,7260,647,37,35,338,375,930,965,6620,0,0,0,0
warfront-neutralhero,7268,647,32,32,853,885,613,645,6599,0,0,0,0
Azerite-CenterTrait-Ring,7269,988,126,126,1,127,692,818,6420,0,0,0,0
Azerite-Trait-Ring,7270,988,107,107,145,252,15,122,6424,0,0,0,0
Azerite-TitanBG-Rank4,7281,1007,1000,1000,1,1001,1,1001,6427,0,0,0,0
Azerite-TitanBG-Rank3,7282,1007,750,750,1,751,1003,1753,6428,0,0,0,0
Azerite-TitanBG-Rank2,7283,1007,500,500,1505,2005,1003,1503,6429,0,0,0,0
Azerite-GoldRing-Rank2,7286,1008,508,508,1,509,1,509,6431,0,0,0,0
Azerite-CenterBG-4Ranks,7287,1009,410,644,484,894,1,645,6432,0,0,0,0
Azerite-CenterBG-3Ranks,7288,1009,354,520,896,1250,1,521,6433,0,0,0,0
Azerite-TitanBG-Glow-Rank2,7290,1010,480,480,1,481,983,1463,6435,0,0,0,0
Azerite-TitanBG-Glow-Rank3,7291,1010,730,730,983,1713,1,731,6436,0,0,0,0
Azerite-TitanBG-Glow-Rank4,7292,1010,980,980,1,981,1,981,6437,0,0,0,0
warfronts-basemapicons-alliance-constructionarmory-minimap,7293,647,37,35,836,873,263,298,6438,0,0,0,0
warfronts-basemapicons-alliance-constructionbarracks-minimap,7294,647,37,35,914,951,263,298,6439,0,0,0,0
warfronts-basemapicons-alliance-constructionheroes-minimap,7295,647,37,35,299,336,301,336,6440,0,0,0,0
warfronts-basemapicons-alliance-constructionmainhall-minimap,7296,647,37,35,377,414,301,336,6441,0,0,0,0
warfronts-basemapicons-alliance-constructionworkshop-minimap,7297,647,37,35,455,492,301,336,6442,0,0,0,0
warfronts-basemapicons-horde-constructionarmory-minimap,7298,647,37,35,299,336,782,817,6443,0,0,0,0
warfronts-basemapicons-horde-constructionbarracks-minimap,7299,647,37,35,299,336,856,891,6444,0,0,0,0
warfronts-basemapicons-horde-constructionheroes-minimap,7300,647,37,35,299,336,930,965,6445,0,0,0,0
warfronts-basemapicons-horde-constructionmainhall-minimap,7301,647,37,35,338,375,338,373,6446,0,0,0,0
warfronts-basemapicons-horde-constructionworkshop-minimap,7302,647,37,35,416,453,338,373,6447,0,0,0,0
Azerite-Trait-RingGlow,7303,988,135,135,1,136,159,294,6448,0,0,0,0
Azerite-Background,7305,1011,1033,1022,1,1034,1,1023,6621,0,0,0,0
Azerite-Trait-Ring-Open,7306,988,107,107,138,245,159,266,6622,0,0,0,0
Azerite-PointingArrow,7307,988,62,44,133,195,382,426,6623,0,0,0,0
AzeriteArmor-CharacterInfo-Neck,7308,988,92,84,133,225,296,380,6624,0,0,0,0
AzeriteArmor-CharacterInfo-NeckLevelBorder,7309,988,52,35,133,185,514,549,6625,0,0,0,0
pvptalents-talentborder-glow,7310,110,68,68,1,69,310,378,6490,0,0,0,0
pvptalents-warmode-glow,7311,110,105,110,134,239,710,820,6526,0,0,0,0
communities-chat-icon-minus,7313,1012,128,78,871,999,133,211,6601,0,0,0,0
communities-chat-body-remove,7314,1012,868,256,1,869,259,515,6602,0,0,0,0
communities-chat-addtab,7315,1012,194,68,1,195,517,585,6603,0,0,0,0
communities-chat-icon-plus,7316,1012,128,130,871,999,1,131,6604,0,0,0,0
communities-chat-body-add,7317,1012,868,256,1,869,1,257,6605,0,0,0,0
AzeriteIconFrame,7318,988,64,64,152,216,820,884,6626,0,0,0,0
AzeriteArmor-CharacterInfo-NeckHighlight,7321,988,92,84,133,225,428,512,6606,0,0,0,0
AzeriteArmor-CharacterInfo-Border-Glow,7325,988,53,41,197,250,382,423,6627,0,0,0,0
Azerite-TopShadow,7326,988,12,12,0,12,1,13,6450,0,0,4,0
Azerite-Trait-Padlock,7327,988,63,76,133,196,560,636,6451,0,0,0,0
warfront-alliancehero-gold,7328,647,32,32,581,613,817,849,6452,0,0,0,0
warfront-alliancehero-silver,7329,647,32,32,581,613,851,883,6453,0,0,0,0
warfront-hordehero-gold,7330,647,32,32,683,715,613,645,6454,0,0,0,0
warfront-hordehero-silver,7331,647,32,32,717,749,613,645,6553,0,0,0,0
warfront-neutralhero-gold,7332,647,32,32,887,919,613,645,6557,0,0,0,0
warfront-neutralhero-silver,7333,647,32,32,921,953,613,645,6558,0,0,0,0
AzeriteArmor-Notification-Neck,7334,988,66,70,129,195,692,762,6628,0,0,0,0
AzeriteArmor-CharacterInfo-Border-ItemGlow,7335,988,35,35,187,222,514,549,6629,0,0,0,0
AzeriteArmor-CharacterInfo-Border-Smoke,7336,988,9,32,145,154,124,156,6630,0,0,0,0
AzeriteArmor-CharacterInfo-Border-TitanStar,7337,988,14,14,156,170,124,138,6631,0,0,0,0
UI-Frame-TopLeftCornerNoPortrait,7350,948,34,33,81,115,1,34,6637,0,0,0,0
scoreboard-footer-lootbackground,7353,1016,174,40,736,910,531,571,6640,0,0,0,0
scoreboard-frameborder-bottom,7354,1016,359,10,609,968,737,747,12636,0,0,0,0
scoreboard-frameborder-bottomleft,7355,1016,201,201,1,202,588,789,12637,0,0,0,0
scoreboard-frameborder-bottomright,7356,1016,200,201,204,404,588,789,12638,0,0,0,0
scoreboard-frameborder-left,7357,1016,11,148,996,1007,129,277,12639,0,0,0,0
scoreboard-frameborder-right,7358,1016,11,148,1009,1020,129,277,12640,0,0,0,0
scoreboard-frameborder-top,7359,1016,359,11,609,968,724,735,12641,0,0,0,0
scoreboard-frameborder-topleft,7360,1016,201,200,406,607,588,788,12642,0,0,0,0
scoreboard-frameborder-topright,7361,1016,200,200,1,201,791,991,12643,0,0,0,0
scoreboard-header-alliance,7362,1016,993,167,1,994,129,296,6649,0,0,0,0
scoreboard-header-horde,7363,1016,993,167,1,994,298,465,6650,0,0,0,0
communities-chat-icon-plus-tab,7364,1012,20,20,1001,1021,1,21,6661,0,0,0,0
communities-icon-notification,7365,1017,24,24,227,251,485,509,6651,0,0,0,0
scoreboard-background-islands-alliance,7461,1024,1022,602,1,1023,1,603,6925,0,0,0,0
scoreboard-background-islands-horde,7462,1025,1022,602,1,1023,1,603,6926,0,0,0,0
scoreboard-charactermodels-shadow,7463,1016,165,62,736,901,467,529,6927,0,0,0,0
scoreboard-footer-alliance-glow,7480,1016,157,69,418,575,467,536,6948,0,0,0,0
scoreboard-footer-alliance-icon,7481,1016,24,29,996,1020,298,327,6949,0,0,0,0
scoreboard-footer-horde-glow,7482,1016,157,69,577,734,467,536,6950,0,0,0,0
scoreboard-footer-horde-icon,7483,1016,24,29,996,1020,329,358,6951,0,0,0,0
communities-create-button-bnet-down,7484,1017,116,67,713,829,1,68,6920,0,0,0,0
communities-create-button-bnet-up,7485,1017,116,67,616,732,99,166,6921,0,0,0,0
communities-create-button-highlight,7486,1017,132,70,343,475,339,409,6922,0,0,0,0
communities-create-button-wow-down,7487,1017,132,70,477,609,339,409,6923,0,0,0,0
communities-create-button-wow-up,7488,1017,132,70,343,475,411,481,6924,0,0,0,0
communities-create-avatar-border-hover,7489,1017,64,64,734,798,99,163,6928,0,0,0,0
communities-create-avatar-border-selected,7490,1017,64,64,800,864,99,163,6929,0,0,0,0
communities-ring-blue,7491,1017,95,96,477,572,411,507,6930,0,0,0,0
communities-ring-gold,7492,1017,95,96,616,711,1,97,6931,0,0,0,0
warfront-alliancecommander-muradin,7515,647,36,36,413,449,263,299,6911,0,0,0,0
warfront-alliancecommander-trollbane,7516,647,36,36,451,487,263,299,6912,0,0,0,0
warfront-alliancecommander-turalyon,7517,647,36,36,489,525,263,299,6913,0,0,0,0
warfront-alliancewave1,7518,647,32,32,581,613,885,917,6914,0,0,0,0
warfront-alliancewave2,7519,647,32,32,581,613,919,951,6915,0,0,0,0
warfront-alliancewave3,7520,647,32,32,581,613,953,985,6916,0,0,0,0
Fog,7521,1046,64,64,1,65,1,65,6917,0,0,0,0
alliancesymbol,7526,647,32,32,377,409,375,407,6901,0,0,0,0
hordesymbol,7527,647,32,32,717,749,409,441,6902,0,0,0,0
islands-allianceboat,7528,647,64,64,71,135,131,195,6903,0,0,0,0
islands-azeriteboss,7529,647,32,32,785,817,409,441,6904,0,0,0,0
islands-azeritechest,7530,647,32,32,819,851,409,441,6905,0,0,0,0
islands-hordeboat,7531,647,64,64,71,135,197,261,6906,0,0,0,0
islands-markedarea,7532,647,32,32,853,885,409,441,6907,0,0,0,0
warfront-hordewave1,7533,647,32,32,751,783,613,645,6908,0,0,0,0
warfront-hordewave2,7534,647,32,32,785,817,613,645,6909,0,0,0,0
warfront-hordewave3,7535,647,32,32,819,851,613,645,6910,0,0,0,0
chatframe-scrollbar-knob,7536,924,21,19,132,153,88,107,6947,0,0,0,0
FogMaskHardEdge,7545,1051,128,128,0,128,0,128,6898,0,0,16,0
FogMaskSoftEdge,7546,1052,128,128,0,128,0,128,6899,0,0,16,0
campaign_alliance,7574,103,608,138,1157,1765,1,139,6952,0,0,0,2
campaign_horde,7575,103,608,138,1157,1765,141,279,6953,0,0,0,2
questlog_bottomdetail,7576,103,260,18,1767,2027,1,19,6954,0,0,0,0
questlog_divider,7577,103,260,37,579,839,986,1023,6955,0,0,0,0
questlog_topdetail,7578,103,260,24,290,550,993,1017,6956,0,0,0,0
zonestory_divider,7579,103,260,37,868,1128,831,868,6957,0,0,0,0
Objective-Header-CampaignAlliance,7580,197,274,42,223,497,133,175,6958,0,0,0,0
Objective-Header-CampaignHorde,7581,197,274,42,223,497,89,131,6959,0,0,0,0
Objective-Header-CampaignMouseOver-Highlight,7582,197,298,26,1,299,216,242,6960,0,0,0,0
chatframe-button-icon-headset,7619,924,29,29,69,98,33,62,6961,0,0,0,0
chatframe-button-icon-mic-off,7620,924,29,29,69,98,64,93,6962,0,0,0,0
chatframe-button-icon-mic-on,7621,924,29,29,69,98,95,124,6963,0,0,0,0
chatframe-button-icon-mic-silenced,7622,924,29,29,101,130,1,30,6964,0,0,0,0
chatframe-button-icon-speaker-off,7623,924,29,29,101,130,63,92,6965,0,0,0,0
chatframe-button-icon-speaker-on,7624,924,29,29,101,130,94,123,6966,0,0,0,0
chatframe-button-icon-speaker-silenced,7625,924,29,29,132,161,1,30,6967,0,0,0,0
voicechat-channellist-category-highlight,7626,938,117,16,307,424,35,51,6968,0,0,0,0
voicechat-portrait-drag,7627,938,16,16,426,442,35,51,6969,0,0,0,0
voicechat-portrait-ring,7628,938,45,45,1,46,201,246,6970,0,0,0,0
voicechat-channellist-icon-headphone-off,7629,938,42,42,87,129,201,243,6971,0,0,0,0
voicechat-channellist-icon-headphone-on,7630,938,42,42,153,195,201,243,6972,0,0,0,0
alliance_icon_and_flag-dynamicicon,7631,1018,32,32,1,33,199,231,6946,0,0,0,0
alliance_icon_and_flag-flash,7632,1018,32,32,67,99,199,231,6940,0,0,0,0
alliance_icon_and_flag-icon,7633,1018,64,64,1,65,1,65,6943,0,0,0,0
alliance_icon_horde_flag-dynamicicon,7634,1018,32,32,133,165,199,231,6974,0,0,0,0
alliance_icon_horde_flag-flash,7635,1018,32,32,199,231,133,165,6975,0,0,0,0
alliance_icon_horde_flag-icon,7636,1018,64,64,1,65,67,131,6976,0,0,0,0
alliance_tower-icon,7637,1018,32,32,199,231,167,199,6977,0,0,0,0
coin-icon,7638,1018,64,64,1,65,133,197,6978,0,0,0,0
combat_swords-dynamicicon,7639,1018,32,32,199,231,201,233,6944,0,0,0,0
combat_swords-flash,7640,1018,32,32,265,297,1,33,6935,0,0,0,0
combat_swords-icon,7641,1018,64,64,67,131,1,65,6934,0,0,0,0
dreadlord-icon,7642,1018,64,64,67,131,67,131,6936,0,0,0,0
horde_icon_alliance_flag-dynamicicon,7643,1018,32,32,299,331,1,33,6979,0,0,0,0
horde_icon_alliance_flag-flash,7644,1018,32,32,333,365,1,33,6980,0,0,0,0
horde_icon_alliance_flag-icon,7645,1018,64,64,67,131,133,197,6973,0,0,0,0
horde_icon_and_flag-dynamicicon,7646,1018,32,32,367,399,1,33,6941,0,0,0,0
horde_icon_and_flag-flash,7647,1018,32,32,401,433,1,33,6942,0,0,0,0
horde_icon_and_flag-icon,7648,1018,64,64,133,197,1,65,6945,0,0,0,0
horde_tower-icon,7649,1018,32,32,435,467,1,33,6981,0,0,0,0
neutral_tower-icon,7650,1018,32,32,469,501,1,33,6937,0,0,0,0
placeholder-icon,7651,1018,64,64,133,197,67,131,6933,0,0,0,0
pvp_ffa-icon,7652,1018,64,64,133,197,133,197,6939,0,0,0,0
skull_bones-icon,7653,1018,64,64,199,263,1,65,6938,0,0,0,0
sniper_shot-icon,7654,1018,64,64,199,263,67,131,6932,0,0,0,0
iron_and_wood-leftIcon,7660,1047,26,26,1,27,1,27,6918,0,0,0,0
iron_and_wood-rightIcon,7661,1047,26,26,29,55,1,27,6919,0,0,0,0
objectivewidget-bar-background,7662,1015,201,22,1,202,107,129,6561,0,0,0,0
objectivewidget-bar-border-left,7663,1015,10,32,192,202,73,105,6565,0,0,0,0
objectivewidget-bar-border-middle,7664,1015,189,32,1,190,73,105,6632,0,0,0,0
objectivewidget-bar-border-right,7665,1015,10,32,204,214,73,105,6633,0,0,0,0
objectivewidget-bar-fill-left,7666,1015,1,22,0,1,1,23,6562,0,0,4,0
objectivewidget-bar-fill-neutral,7667,1015,1,22,0,1,25,47,6564,0,0,4,0
objectivewidget-bar-fill-right,7668,1015,1,22,0,1,49,71,6563,0,0,4,0
objectivewidget-bar-spark-left,7669,1015,16,39,37,53,131,170,6634,0,0,0,0
objectivewidget-bar-spark-neutral,7670,1015,16,39,37,53,172,211,6636,0,0,0,0
objectivewidget-bar-spark-right,7671,1015,16,39,37,53,213,252,6635,0,0,0,0
objectivewidget-icon-left,7672,1015,34,41,1,35,131,172,6559,0,0,0,0
objectivewidget-icon-right,7673,1015,34,41,1,35,174,215,6560,0,0,0,0
Objective-Tracker-Collapse,7674,197,16,16,318,334,67,83,6987,0,0,0,0
Objective-TrackerTab-ExpandPressed,7675,197,16,16,336,352,67,83,6988,0,0,0,0
Objective-Tracker-Expand,7676,197,16,16,366,382,67,83,6989,0,0,0,0
Objective-TrackerTab-Collapse,7677,197,16,16,384,400,67,83,6990,0,0,0,0
Objective-Tracker-ExpandPressed,7678,197,16,16,402,418,67,83,6991,0,0,0,0
Objective-TrackerTab-Expand,7679,197,16,16,432,448,1,17,6992,0,0,0,0
Objective-Tracker-CollapsePressed,7680,197,16,16,450,466,1,17,6993,0,0,0,0
Objective-TrackerTab-CollapsePressed,7681,197,16,16,468,484,1,17,6994,0,0,0,0
Objective-Header-Collapse,7682,197,220,86,1,221,89,175,6995,0,0,0,0
voicechat-channellist-row-background2,7683,938,20,20,48,68,235,255,6996,0,0,0,0
communities-create-button-wow-alliance,7707,1017,22,28,261,283,483,511,6998,0,0,0,0
communities-create-button-wow-horde,7708,1017,22,28,287,309,451,479,6999,0,0,0,0
GarrMission_ClassIcon-Alliance,7709,324,55,49,1,56,1,50,7000,0,0,0,0
GarrMission_ClassIcon-Horde,7710,324,55,49,172,227,1,50,7001,0,0,0,0
raceicon-darkirondwarf-female,7711,897,64,64,1501,1565,131,195,7002,0,0,0,0
raceicon-darkirondwarf-male,7712,897,64,64,1567,1631,131,195,7003,0,0,0,0
raceicon-magharorc-female,7713,897,64,64,1369,1433,197,261,7004,0,0,0,0
raceicon-magharorc-male,7714,897,64,64,1435,1499,197,261,7005,0,0,0,0
warfronts-basemapicons-alliance-tower-minimap,7716,647,37,35,689,726,301,336,7007,0,0,0,0
warfronts-basemapicons-empty-tower-minimap,7717,647,37,35,299,336,486,521,7008,0,0,0,0
warfronts-basemapicons-horde-tower-minimap,7718,647,37,35,650,687,338,373,7009,0,0,0,0
communities-icon-addgroupplus,7719,1017,64,64,866,930,99,163,7010,0,0,0,0
communities-icon-lock,7720,1017,24,30,261,285,451,481,7011,0,0,0,0
Forge-UnobtainableCover,7721,720,108,108,1,109,723,831,7012,0,0,0,0
islands-queue-card1,7722,1073,457,322,454,911,1,323,7013,0,0,0,0
islands-queue-card2,7723,1073,451,301,1,452,1,302,7014,0,0,0,0
islands-queue-card3,7724,1073,438,302,913,1351,1,303,7015,0,0,0,0
islands-queue-card-namescroll,7725,1073,198,58,63,261,327,385,7016,0,0,0,0
AlliedRace-UnlockingFrame-ModelBackground-DarkIronDwarf,7727,922,314,578,1,315,1,579,7018,0,0,0,0
alliedrace-crest-darkirondwarf,7729,923,64,64,1,65,1,65,7020,0,0,0,0
alliedrace-crest-magharorc,7730,923,64,64,67,131,67,131,7034,0,0,0,0
transmog-background-race-darkirondwarf,7732,1075,294,494,1,295,1,495,7023,0,0,0,0
islands-queue-difficultyselector-1,7733,1073,60,60,1,61,327,387,7024,0,0,0,0
islands-queue-difficultyselector-2,7734,1073,60,60,63,123,387,447,7025,0,0,0,0
islands-queue-difficultyselector-3,7735,1073,60,60,1,61,451,511,7026,0,0,0,0
islands-queue-difficultyselector-4,7736,1073,60,60,1,61,389,449,7027,0,0,0,0
islands-queue-difficultyselector-backboard,7737,1073,433,124,454,887,325,449,7028,0,0,0,0
islands-queue-difficultyselector-ring,7738,1073,70,73,125,195,387,460,7029,0,0,0,0
islands-queue-prop-coins,7739,1073,354,201,913,1267,305,506,7030,0,0,0,0
islands-queue-prop-compass,7740,1073,300,297,1716,2016,73,370,7031,0,0,0,0
islands-queue-background,7741,1076,922,620,1,923,1,621,7033,0,0,0,0
AlliedRace-UnlockingFrame-ModelBackground-Magharorc,7742,922,314,578,1265,1579,1,579,7035,0,0,0,0
communities-icon-invitemail,7743,1017,114,110,227,341,339,449,7036,0,0,0,0
communities-widebackground,7744,1017,613,336,1,614,1,337,7037,0,0,0,0
transmog-background-race-magharorc,7745,1074,294,494,1,295,1,495,7032,0,0,0,0
BfAMission-Icon-HUB,7746,1096,80,80,1,81,1,81,7038,0,0,0,0
BfAMission-Icon-Normal,7747,1096,80,80,165,245,1,81,7039,0,0,0,0
BfAMission-Icon-QuickStrike,7748,1096,80,80,1,81,83,163,7040,0,0,0,0
BfAMission-Icon-Stealth,7749,1096,80,80,1,81,165,245,7041,0,0,0,0
TalkingHeads-Horde-PortraitFrame,7750,604,143,143,718,861,1,144,7473,0,0,0,0
TalkingHeads-Alliance-TextBackground,7751,604,570,155,1,571,158,313,7472,0,0,0,0
TalkingHeads-Horde-TextBackground,7752,604,570,155,1,571,315,470,7474,0,0,0,0
warfront_asset_horde_axe_thrower,7781,1097,64,64,331,395,397,461,7073,0,0,0,0
warfront_asset_horde_bristling_power,7782,1097,64,64,397,461,1,65,7074,0,0,0,0
warfront_asset_horde_call_of_the_storm,7783,1097,64,64,397,461,67,131,7075,0,0,0,0
warfront_asset_horde_demolisher,7784,1097,64,64,397,461,133,197,7076,0,0,0,0
warfront_asset_horde_elemental_spirit,7785,1097,64,64,397,461,199,263,7077,0,0,0,0
warfront_asset_horde_flight_master,7786,1097,64,64,397,461,265,329,7078,0,0,0,0
warfront_asset_horde_fortress,7787,1097,64,64,397,461,331,395,7079,0,0,0,0
warfront_asset_horde_great_hall,7788,1097,64,64,397,461,397,461,7080,0,0,0,0
warfront_asset_horde_grunt,7789,1097,64,64,463,527,1,65,7081,0,0,0,0
warfront_asset_horde_kodo_rider,7790,1097,64,64,463,527,67,131,7082,0,0,0,0
warfront_asset_horde_shaman,7793,1097,64,64,463,527,133,197,7085,0,0,0,0
warfront_asset_horde_stronghold,7794,1097,64,64,463,527,199,263,7086,0,0,0,0
warfront_asset_horde_wolf_raider,7800,1097,64,64,463,527,265,329,7092,0,0,0,0
TalkingHeads-Neutral-PortraitFrame,7801,604,143,143,863,1006,1,144,7475,0,0,0,0
TalkingHeads-Neutral-TextBackground,7802,604,570,155,1,571,472,627,7476,0,0,0,0
poi-bountyplayer-alliance,7823,647,21,20,521,542,107,127,7096,0,0,0,0
poi-bountyplayer-horde,7824,647,21,20,544,565,107,127,7097,0,0,0,0
Azerite-CenterBG-ChannelGlowBar-Shinny,7825,1009,157,591,1556,1713,1,592,7098,0,0,0,0
Azerite-CenterBG-ChannelGlowBar-Filling,7826,1009,143,584,1715,1858,1,585,7099,0,0,0,0
Azerite-SmallChannel-BaseSpark,7831,1009,66,62,1,67,945,1007,7102,0,0,0,0
Azerite-SmallChannel-Reflection1,7832,1009,19,39,69,88,945,984,7103,0,0,0,0
Azerite-SmallChannel-Reflection2,7833,1009,19,39,92,111,963,1002,7104,0,0,0,0
Azerite-SmallChannel-Smoke,7834,1009,18,36,69,87,986,1022,7105,0,0,0,0
Azerite-SmallChannel-Spark,7835,1009,64,16,92,156,945,961,7106,0,0,0,0
Azerite-Center-TraitBG,7836,1009,89,89,1,90,763,852,7107,0,0,0,0
Azerite-Center-TraitPlug-Rune2,7838,1009,89,89,92,181,763,852,7109,0,0,0,0
Azerite-Center-TraitPlug-Rune3,7839,1009,89,89,92,181,854,943,7110,0,0,0,0
Azerite-Center-TraitPlug-Rune1,7840,1009,89,89,1,90,854,943,7111,0,0,0,0
scrappingmachine-background-gnomish,7939,1229,646,454,1,647,1,455,7208,0,0,0,0
scrappingmachine-background-goblin,7940,1229,646,454,1,647,457,911,7209,0,0,0,0
scrappingmachine-background-slots,7941,1229,150,150,649,799,1,151,7210,0,0,0,0
battlefieldminimap-border-bottomleft,7942,1230,16,16,211,227,20,36,7211,0,0,0,0
battlefieldminimap-border-bottomright,7943,1230,16,16,229,245,20,36,7212,0,0,0,0
battlefieldminimap-border-top,7944,1230,208,17,1,209,1,18,7213,0,0,0,0
battlefieldminimap-border-topleft,7945,1230,16,17,211,227,1,18,7214,0,0,0,0
battlefieldminimap-border-topright,7946,1230,16,17,229,245,1,18,7215,0,0,0,0
battlefieldminimap-border-bottom,7947,1230,208,16,1,209,20,36,7216,0,0,0,0
battlefieldminimap-border-left,7948,1230,16,134,1,17,38,172,7217,0,0,0,0
battlefieldminimap-border-right,7949,1230,16,134,19,35,38,172,7218,0,0,0,0
macropopup-bottomright-nobuttons,7950,873,18,39,81,99,213,252,7219,0,0,0,0
macropopup-intersect-left,7951,873,18,17,41,59,228,245,7220,0,0,0,0
macropopup-intersect-right,7952,873,18,17,61,79,228,245,7221,0,0,0,0
macropopup-topleft2,7953,873,18,54,41,59,172,226,7222,0,0,0,0
macropopup-topright2,7954,873,18,54,61,79,172,226,7223,0,0,0,0
_macropopup-top2,7955,873,256,17,0,256,112,129,7224,0,0,4,0
pvpqueue-background-rated,7962,1234,387,291,390,777,20,311,7226,0,0,0,0
pvpqueue-button-down,7963,1234,365,91,390,755,426,517,7227,0,0,0,0
pvpqueue-button-highlight,7964,1234,365,91,1,366,746,837,7228,0,0,0,0
pvpqueue-button-selected,7965,1234,365,91,390,755,313,404,7229,0,0,0,0
pvpqueue-button-up,7966,1234,365,91,526,891,519,610,7230,0,0,0,0
pvpqueue-conquestbar-background,7967,1234,471,18,390,861,406,424,7231,0,0,0,0
pvpqueue-conquestbar-frame,7968,1234,369,42,1,370,979,1021,7232,0,0,0,0
_pvpqueue-conquestbar-fill-red,7971,1234,256,17,1,257,1,18,7235,0,0,0,0
_pvpqueue-conquestbar-fill-yellow,7972,1234,256,17,259,515,1,18,7236,0,0,0,0
pvpqueue-background-casual-alliance,7973,1234,387,291,1,388,313,604,7237,0,0,0,0
pvpqueue-background-casual-horde,7974,1234,387,291,1,388,20,311,7238,0,0,0,0
pvpqueue-button-casual-down,7975,1234,365,68,1,366,606,674,7239,0,0,0,0
pvpqueue-button-casual-highlight,7976,1234,365,68,1,366,839,907,7240,0,0,0,0
pvpqueue-button-casual-selected,7977,1234,365,68,1,366,676,744,7241,0,0,0,0
pvpqueue-button-casual-up,7978,1234,365,68,1,366,909,977,7242,0,0,0,0
pvpqueue-sidebar-background,7979,1234,160,375,526,686,612,987,7243,0,0,0,0
pvpqueue-sidebar-honorbar-background,7980,1234,196,171,688,884,612,783,7244,0,0,0,0
pvpqueue-rewardring-black,7984,1234,60,60,817,877,313,373,7248,0,0,0,0
pvpqueue-rewardring-large,7985,1234,58,58,757,815,313,371,7249,0,0,0,0
pvpqueue-rewardring,7986,1234,60,60,932,992,193,253,7250,0,0,0,0
pvpqueue-rewardring-small,7987,1234,37,37,977,1014,57,94,7251,0,0,0,0
pvpqueue-sidebar-nextarrow,7988,1234,32,50,977,1009,96,146,7252,0,0,0,0
pvpqueue-sidebar-honorbar-background-alliance,7989,1234,134,134,390,524,519,653,7253,0,0,0,0
pvpqueue-sidebar-honorbar-background-horde,7990,1234,134,134,390,524,655,789,7254,0,0,0,0
pvpqueue-rankglow,7991,1234,55,39,779,834,193,232,7255,0,0,0,0
warfront-hordecommander-eitrigg,7992,647,36,36,527,563,263,299,7256,0,0,0,0
warfront-hordecommander-ladyliadrin,7993,647,36,36,565,601,263,299,7257,0,0,0,0
warfront-hordecommander-rokhan,7994,647,36,36,603,639,263,299,7258,0,0,0,0
Azerite-TitanBG-GearRank4,7995,1007,1000,1000,1003,2003,1,1001,7259,0,0,0,0
Azerite-TitanBG-GearRank3,7996,1007,750,750,753,1503,1003,1753,7260,0,0,0,0
Azerite-TitanBG-GearRank2,7997,1007,500,500,1505,2005,1505,2005,7261,0,0,0,0
Azerite-TitanBG-GearRank2-Front,7998,1235,401,403,1575,1976,1,404,7262,0,0,0,0
Azerite-TitanBG-GearRank3-Front,7999,1235,664,662,909,1573,1,663,7263,0,0,0,0
Azerite-TitanBG-GearRank4-Front,8000,1235,906,906,1,907,1,907,7264,0,0,0,0
Azerite-Background-3Ranks,8005,1011,801,793,1036,1837,1,794,7269,0,0,0,0
talenttree-horde-background,8007,1237,341,506,1,342,65,571,7271,0,0,0,0
azeritereforger-background,8008,1238,323,197,1,324,1,198,7272,0,0,0,0
azeritereforger-glow,8009,1238,133,135,326,459,1,136,7273,0,0,0,0
Azerite-TitanBG-LightsRank2,8010,1239,500,500,1,501,1003,1503,7274,0,0,0,0
Azerite-TitanBG-LightsRank3,8011,1239,750,750,1003,1753,1,751,7275,0,0,0,0
Azerite-TitanBG-LightsRank4,8012,1239,1000,1000,1,1001,1,1001,7276,0,0,0,0
warfront_asset_alliance_castle,8013,1097,64,64,199,263,397,461,7277,0,0,0,0
warfront_asset_alliance_elek_rider,8014,1097,64,64,265,329,1,65,7278,0,0,0,0
warfront_asset_alliance_elemental_spirit,8015,1097,64,64,265,329,67,131,7279,0,0,0,0
warfront_asset_alliance_footmen,8016,1097,64,64,265,329,199,263,7280,0,0,0,0
warfront_asset_alliance_keep,8017,1097,64,64,265,329,265,329,7281,0,0,0,0
warfront_asset_alliance_knights,8018,1097,64,64,265,329,331,395,7282,0,0,0,0
warfront_asset_alliance_priests,8019,1097,64,64,265,329,397,461,7283,0,0,0,0
warfront_asset_alliance_riflemen,8020,1097,64,64,331,395,1,65,7284,0,0,0,0
warfront_asset_alliance_siege_engine,8021,1097,64,64,331,395,67,131,7285,0,0,0,0
warfront_asset_alliance_town_hall,8022,1097,64,64,331,395,133,197,7286,0,0,0,0
warfront_asset_alliance_flight_master,8023,1097,64,64,265,329,133,197,7287,0,0,0,0
alliancewarfrontmapbanner,8024,647,64,64,1,65,267,331,7288,0,0,0,0
hordewarfrontmapbanner,8025,647,64,64,1,65,927,991,7289,0,0,0,0
scoreboard-background-warfronts-horde,8026,1240,1022,602,1,1023,1,603,7290,0,0,0,0
scoreboard-background-warfronts-alliance,8027,1241,1022,602,1,1023,1,603,7291,0,0,0,0
islands-questbang,8028,647,32,32,887,919,409,441,7292,0,0,0,0
islands-questbangdisable,8029,647,32,32,921,953,409,441,7293,0,0,0,0
islands-questdisable,8030,647,32,32,955,987,409,441,7294,0,0,0,0
islands-questturnin,8031,647,32,32,989,1021,409,441,7295,0,0,0,0
bfa-landingbutton-alliance-down,8032,1242,46,51,1,47,1,52,7296,0,0,0,0
bfa-landingbutton-alliance-up,8033,1242,46,51,49,95,1,52,7297,0,0,0,0
bfa-landingbutton-horde-down,8034,1243,45,51,52,97,1,52,7298,0,0,0,0
bfa-landingbutton-horde-up,8035,1243,45,51,52,97,54,105,7299,0,0,0,0
mythicplus-chest-collect,8036,1244,500,349,1,501,1,350,7300,0,0,0,0
mythicplus-chest-gold,8037,1244,438,268,1,439,698,966,7301,0,0,0,0
mythicplus-chest-silver,8038,1244,438,268,1287,1725,347,615,7302,0,0,0,0
mythicplus-chest-collect-sparkles,8039,1244,269,188,503,772,693,881,7303,0,0,0,0
roleicon-tiny-dps,8040,1245,16,16,1,17,1,17,7304,0,0,0,0
roleicon-tiny-healer,8041,1245,16,16,19,35,1,17,7305,0,0,0,0
roleicon-tiny-tank,8042,1245,16,16,37,53,1,17,7306,0,0,0,0
Artifacts-Retiring-Gradient,8043,607,1,334,123,124,444,778,7307,0,0,0,0
pvpqueue-sidebar-honorbar-badge-alliance,8044,1234,118,138,886,1004,612,750,7308,0,0,0,0
pvpqueue-sidebar-honorbar-badge-horde,8045,1234,118,138,390,508,791,929,7309,0,0,0,0
BfAMission-Icon-LongCampaign,8046,1096,80,80,83,163,1,81,7310,0,0,0,0
UI-Frame-Horde-CardParchment,8047,1246,254,439,1,255,361,800,7311,0,0,0,0
_UI-Frame-Horde-TileBottom,8048,1246,256,30,0,256,88,118,12650,0,0,4,0
UI-Frame-Horde-PortraitDisable,8049,1246,205,109,774,979,361,470,7313,0,0,0,0
UI-Frame-Horde-Ribbon,8050,1246,281,84,257,538,801,885,7314,0,0,0,0
UI-Frame-Horde-CardParchmentWider,8051,1246,515,438,257,772,361,799,7315,0,0,0,0
_UI-Frame-Horde-TitleMiddle,8052,1246,128,85,0,128,1,86,7316,0,0,4,0
_UI-Frame-Horde-TileTop,8053,1246,256,30,0,256,120,150,12651,0,0,4,0
UI-Frame-Horde-Portrait,8054,1246,205,109,774,979,472,581,7318,0,0,0,0
UI-Frame-Horde-ExitButtonBorder,8055,1246,33,32,854,887,152,184,7319,0,0,0,0
UI-Frame-Horde-Header,8056,1246,459,119,393,852,152,271,7320,0,0,0,0
UI-Frame-Horde-PortraitWiderDisable,8057,1246,390,207,540,930,801,1008,7321,0,0,0,0
UI-Frame-Horde-PortraitWider,8058,1246,390,207,1,391,152,359,7322,0,0,0,0
UI-Frame-Horde-TitleLeft,8059,1246,202,85,806,1008,273,358,7323,0,0,0,0
UI-Frame-Horde-TitleRight,8060,1246,202,85,602,804,273,358,7324,0,0,0,0
UI-Frame-Horde-Corner,8061,1246,166,166,1,167,802,968,12649,0,0,0,0
!UI-Frame-Horde-TileLeft,8062,1247,30,256,1,31,0,256,12652,0,0,2,0
!UI-Frame-Horde-TileRight,8063,1247,30,256,33,63,0,256,12653,0,0,2,0
UI-Frame-Horde-BackgroundTile,8068,1252,256,256,0,256,0,256,7332,0,0,6,0
ui-frame-bar-bgcenter,8088,1253,64,18,0,64,67,85,7352,0,0,4,0
ui-frame-bar-bgleft,8089,1253,29,18,94,123,182,200,7353,0,0,0,0
ui-frame-bar-bgright,8090,1253,29,18,94,123,202,220,7354,0,0,0,0
ui-frame-bar-bordercenter,8091,1253,64,31,0,64,1,32,7355,0,0,4,0
ui-frame-bar-borderleft,8092,1253,35,31,1,36,182,213,7356,0,0,0,0
ui-frame-bar-borderright,8093,1253,35,31,1,36,215,246,7357,0,0,0,0
ui-frame-bar-glowcenter,8094,1253,64,31,0,64,34,65,7358,0,0,4,0
ui-frame-bar-glowleft,8095,1253,35,31,38,73,182,213,7359,0,0,0,0
ui-frame-bar-glowright,8096,1253,34,31,38,72,215,246,7360,0,0,0,0
ui-frame-bar-spark,8097,1253,8,32,75,83,215,247,7361,0,0,0,0
ui-frame-bar-fill-green,8105,1253,256,17,0,256,106,123,7369,0,0,4,0
ui-frame-bar-fill-red,8106,1253,256,17,0,256,125,142,7370,0,0,4,0
ui-frame-bar-fill-yellow,8107,1253,256,17,0,256,144,161,7371,0,0,4,0
UI-Frame-Alliance-Portrait,8108,1254,205,109,1,206,904,1013,7372,0,0,0,0
_UI-Frame-Alliance-TitleMiddle,8109,1254,128,85,0,128,65,150,7373,0,0,4,0
UI-Frame-Alliance-ExitButtonBorder,8110,1254,33,32,169,202,593,625,7374,0,0,0,0
UI-Frame-Alliance-Ribbon,8111,1254,281,84,649,930,801,885,7375,0,0,0,0
UI-Frame-Alliance-PortraitWiderDisable,8112,1254,390,207,257,647,801,1008,7376,0,0,0,0
UI-Frame-Alliance-Corner,8113,1254,166,166,1,167,593,759,12657,0,0,0,0
UI-Frame-Alliance-PortraitWider,8114,1254,390,207,257,647,152,359,7378,0,0,0,0
_UI-Frame-Alliance-TileBottom,8115,1254,256,30,0,256,1,31,12658,0,0,4,0
UI-Frame-Alliance-Header,8116,1254,315,134,649,964,152,286,7380,0,0,0,0
_UI-Frame-Alliance-TileTop,8117,1254,256,30,0,256,33,63,12659,0,0,4,0
UI-Frame-Alliance-CardParchment,8118,1254,254,439,1,255,152,591,7382,0,0,0,0
UI-Frame-Alliance-TitleLeft,8119,1254,202,85,774,976,361,446,7383,0,0,0,0
UI-Frame-Alliance-CardParchmentWider,8120,1254,515,438,257,772,361,799,7384,0,0,0,0
UI-Frame-Alliance-PortraitDisable,8121,1254,205,109,1,206,761,870,7385,0,0,0,0
UI-Frame-Alliance-TitleRight,8122,1254,202,85,774,976,448,533,7386,0,0,0,0
ui-frame-neutral-cardparchment,8123,1255,254,439,1,255,152,591,7387,0,0,0,0
ui-frame-neutral-cardparchmentwider,8124,1255,515,438,257,772,152,590,7388,0,0,0,0
ui-frame-neutral-corner,8125,1255,166,166,1,167,593,759,12654,0,0,0,0
ui-frame-neutral-exitbuttonborder,8126,1255,33,32,169,202,593,625,7390,0,0,0,0
ui-frame-neutral-portrait,8127,1255,205,109,1,206,848,957,7391,0,0,0,0
ui-frame-neutral-portraitdisable,8128,1255,205,109,774,979,152,261,7392,0,0,0,0
ui-frame-neutral-portraitwider,8129,1255,390,207,257,647,592,799,7393,0,0,0,0
ui-frame-neutral-portraitwiderdisable,8130,1255,390,207,257,647,801,1008,7394,0,0,0,0
ui-frame-neutral-ribbon,8131,1255,281,84,649,930,592,676,7395,0,0,0,0
ui-frame-neutral-titleleft,8132,1255,202,85,1,203,761,846,7396,0,0,0,0
ui-frame-neutral-titleright,8133,1255,202,85,774,976,263,348,7397,0,0,0,0
_ui-frame-neutral-tilebottom,8134,1255,256,30,0,256,120,150,12655,0,0,4,0
_ui-frame-neutral-tiletop,8135,1255,256,30,0,256,88,118,12656,0,0,4,0
_ui-frame-neutral-titlemiddle,8136,1255,128,85,0,128,1,86,7400,0,0,4,0
UI-Frame-Alliance-BackgroundTile,8137,1256,256,256,0,256,0,256,7401,0,0,6,0
!UI-Frame-Alliance-TileLeft,8138,1257,30,256,1,31,0,256,12660,0,0,2,0
!UI-Frame-Alliance-TileRight,8139,1257,30,256,33,63,0,256,12661,0,0,2,0
UI-Frame-Neutral-BackgroundTile,8140,1258,256,256,0,256,0,256,7404,0,0,6,0
!UI-Frame-Neutral-TileLeft,8141,1259,30,256,1,31,0,256,12662,0,0,2,0
!UI-Frame-Neutral-TileRight,8142,1259,30,256,33,63,0,256,12663,0,0,2,0
AllianceScenario-TitleBG,8143,1236,467,141,1,468,1,142,7407,0,0,0,0
AllianceScenario-TrackerHeader,8144,1236,243,77,1,244,287,364,7408,0,0,0,0
HordeScenario-TitleBG,8145,1236,467,141,1,468,144,285,7409,0,0,0,0
HordeScenario-TrackerHeader,8146,1236,243,77,246,489,287,364,7410,0,0,0,0
islands-queue-progressbar-checkmark,8147,1073,40,35,275,315,327,362,7411,0,0,0,0
islands-queue-progressbar-frame,8148,1073,566,49,1353,1919,22,71,7412,0,0,0,0
islands-queue-progressbar-spark,8149,1073,10,37,263,273,327,364,7413,0,0,0,0
_islands-queue-progressbar-background,8150,1073,236,21,1,237,304,325,7414,0,0,0,0
_islands-queue-progressbar-fill,8151,1073,471,19,1353,1824,1,20,7415,0,0,0,0
warfront-alliance-siegeengine,8152,647,32,32,581,613,715,747,7416,0,0,0,0
warfront-horde-demolisher,8153,647,32,32,581,613,987,1019,7417,0,0,0,0
islands-queue-card-dreadchain-icetroll,8154,1260,412,268,1,413,1,269,7418,0,0,0,0
islands-queue-card-dreadchain-kvaldir,8155,1260,412,268,415,827,1,269,7419,0,0,0,0
islands-queue-card-dreadchain-mogu,8156,1260,412,268,1,413,271,539,7420,0,0,0,0
islands-queue-card-dreadchain,8157,1260,412,268,415,827,271,539,7421,0,0,0,0
islands-queue-card-moltencay-jungletroll,8160,1261,412,268,1,413,1,269,7422,0,0,0,0
islands-queue-card-moltencay-ogre,8161,1261,412,268,415,827,1,269,7423,0,0,0,0
islands-queue-card-moltencay-sandtroll,8162,1261,412,268,1,413,271,539,7424,0,0,0,0
islands-queue-card-moltencay-yaungol,8163,1261,412,268,415,827,271,539,7425,0,0,0,0
islands-queue-card-moltencay,8164,1261,412,268,1,413,541,809,7426,0,0,0,0
azeritetooltip-bottom,8165,1262,43,11,69,112,58,69,7427,0,0,0,0
azeritetooltip-topper,8166,1262,95,27,1,96,29,56,7428,0,0,0,0
islands-queue-card-rottingmire-jinyu,8167,1263,412,268,1,413,1,269,7429,0,0,0,0
islands-queue-card-rottingmire-saurok,8168,1263,412,268,415,827,1,269,7430,0,0,0,0
islands-queue-card-rottingmire-strandedpirates,8169,1263,412,268,1,413,271,539,7431,0,0,0,0
islands-queue-card-rottingmire,8170,1263,412,268,415,827,271,539,7432,0,0,0,0
islands-queue-card-skitteringhollow-kobolds,8171,1264,412,268,1,413,1,269,7433,0,0,0,0
islands-queue-card-skitteringhollow-nerubians,8172,1264,412,268,415,827,1,269,7434,0,0,0,0
islands-queue-card-skitteringhollow-troggs,8173,1264,412,268,1,413,271,539,7435,0,0,0,0
islands-queue-card-skitteringhollow,8174,1264,412,268,415,827,271,539,7436,0,0,0,0
islands-queue-card-ungolruins-hozen,8175,1265,412,268,1,413,1,269,7437,0,0,0,0
islands-queue-card-ungolruins-pygmy,8176,1265,412,268,415,827,1,269,7438,0,0,0,0
islands-queue-card-ungolruins-quilboar,8177,1265,412,268,1,413,271,539,7439,0,0,0,0
islands-queue-card-ungolruins,8178,1265,412,268,415,827,271,539,7440,0,0,0,0
islands-queue-card-verdantwilds-druids,8179,1266,412,268,1,413,1,269,7441,0,0,0,0
islands-queue-card-verdantwilds-furbolgs,8180,1266,412,268,415,827,1,269,7442,0,0,0,0
islands-queue-card-verdantwilds-keepers,8181,1266,412,268,1,413,271,539,7443,0,0,0,0
islands-queue-card-verdantwilds,8182,1266,412,268,415,827,271,539,7444,0,0,0,0
islands-queue-card-whisperingreef-makrura,8183,1267,412,268,1,413,1,269,7445,0,0,0,0
islands-queue-card-whisperingreef-murlocs,8184,1267,412,268,415,827,1,269,7446,0,0,0,0
islands-queue-card-whisperingreef-naga,8185,1267,412,268,1,413,271,539,7447,0,0,0,0
islands-queue-card-whisperingreef,8186,1267,412,268,415,827,271,539,7448,0,0,0,0
Azerite-CenterBG-ChannelGlowBar-Mask,8188,1269,1024,1024,0,1024,0,1024,7450,0,0,16,0
Azerite-CenterBG-ChannelGlowBar-Effect,8189,1270,128,128,0,128,0,128,7451,0,0,6,0
HordeFrame-Corner-TopLeft,8190,1271,166,166,1,167,331,497,7452,0,0,0,0
HordeFrame-Header,8191,1271,415,119,1,416,210,329,7453,0,0,0,0
_HordeFrameTile-Bottom,8192,1271,256,30,0,256,146,176,7454,0,0,4,0
_HordeFrameTile-Top,8193,1271,256,30,0,256,178,208,7455,0,0,4,0
!HordeFrameTile-Left,8194,1272,30,256,1,31,0,256,7456,0,0,2,0
AllianceFrame-Header,8195,1273,299,134,211,510,210,344,7457,0,0,0,0
AllianceFrameCorner-TopLeft,8196,1273,166,166,43,209,210,376,7458,0,0,0,0
_AllianceFrameTile-Bottom,8197,1273,256,30,0,256,44,74,7459,0,0,4,0
_AllianceFrameTile-Top,8198,1273,256,30,0,256,76,106,7460,0,0,4,0
!AllianceFrameTile-Left,8199,1274,30,256,1,31,0,256,7461,0,0,2,0
Azerite-CenterBG-ChannelGlowBar-Particles,8200,1275,128,512,0,128,0,512,7462,0,0,6,0
Azerite-CenterBG-ChannelGlowBar-Gold,8201,1276,64,512,0,64,0,512,7463,0,0,6,0
Azerite-CenterBG-ChannelGlowBar-FillingMask,8202,1277,128,512,0,128,0,512,7464,0,0,16,0
Azerite-CenterTrait-RingDisable,8203,988,130,130,1,131,296,426,7465,0,0,0,0
flightmaster_ferry-taxi_frame_gray,8205,853,74,49,1,75,263,312,7466,0,0,0,0
flightmaster_ferry-taxi_frame_green,8206,853,74,49,1,75,314,363,7467,0,0,0,0
flightmaster_ferry-taxi_frame_yellow,8207,853,74,49,1,75,365,414,7468,0,0,0,0
flightmasterferry,8208,647,32,32,411,443,409,441,7469,0,0,0,0
flightmaster_ferry-taxinode_alliance,8209,647,20,12,987,1007,59,71,7470,0,0,0,0
pvpqueue-conquestbar-checkmark,8210,1234,40,35,977,1017,20,55,7477,0,0,0,0
communities-chat-date-line-orange,8211,1017,256,8,694,950,178,186,7478,0,0,0,0
communities-chat-date-line,8212,1017,256,8,694,950,168,176,7479,0,0,0,0
streamcinematic-bfa-down,8213,557,176,78,357,533,401,479,7480,0,0,0,0
streamcinematic-bfa-up,8214,557,176,78,713,889,81,159,7481,0,0,0,0
groupfinder-background-raids-battleforazeroth,8215,236,333,96,1671,2004,99,195,7482,0,0,0,0
groupfinder-button-raids-battleforazeroth,8216,236,290,36,1,291,855,891,7483,0,0,0,0
BFA-mission-complete-background-Alliance,8217,1278,690,333,1,691,1,334,7484,0,0,0,0
BFA-mission-complete-background-Horde,8218,1279,690,333,1,691,1,334,7485,0,0,0,0
voicechat-icon-mic-mutesilenced,8219,938,32,32,419,451,69,101,7486,0,0,0,0
voicechat-icon-textchat-silenced,8220,938,32,32,385,417,171,203,7487,0,0,0,0
chatframe-button-icon-mic-silenced-off,8221,924,29,29,101,130,32,61,7488,0,0,0,0
voicechat-icon-speaker-mutesilenced,8222,938,32,32,351,383,171,203,7489,0,0,0,0
AzeriteFX-BlueRing,8223,988,142,142,1,143,15,157,7490,0,0,0,0
AzeriteFX-Whirls,8224,988,149,105,1,150,820,925,7491,0,0,0,0
_GarrMissionLocation-SilverpineForest-Mid,8225,1280,1024,285,0,1024,1,286,7492,0,0,4,0
_GarrMissionLocation-HillsbradFoothills-Mid,8226,1281,1024,285,0,1024,1,286,7493,0,0,4,0
_GarrMissionLocation-ArathiHighlands-Mid,8230,1282,1024,285,0,1024,1,286,7494,0,0,4,0
_GarrMissionLocation-Azshara-Mid,8246,1283,1024,285,0,1024,1,286,7496,0,0,4,0
_GarrMissionLocation-Ashenvale-Mid,8247,1284,1024,285,0,1024,1,286,7495,0,0,4,0
_GarrMissionLocation-Darkshore-Mid,8254,1285,1024,285,0,1024,1,286,7497,0,0,4,0
_GarrMissionLocation-Durotar-Mid,8267,1286,1024,285,0,1024,1,286,7499,0,0,4,0
_GarrMissionLocation-NorthernBarrens-Mid,8268,1287,1024,285,0,1024,1,286,7501,0,0,4,0
_GarrMissionLocation-SouthernBarrens-Mid,8269,1288,1024,285,0,1024,1,286,7502,0,0,4,0
_GarrMissionLocation-Nazmir-Mid,8270,1289,1024,285,0,1024,1,286,7500,0,0,4,0
_GarrMissionLocation-Zuldazar-Mid,8271,1290,1024,285,0,1024,1,286,7506,0,0,4,0
_GarrMissionLocation-Voldun-Mid,8272,1291,1024,285,0,1024,1,286,7505,0,0,4,0
_GarrMissionLocation-Stormsong-Mid,8273,1292,1024,285,0,1024,1,286,7503,0,0,4,0
_GarrMissionLocation-Drustvar-Mid,8274,1293,1024,285,0,1024,1,286,7498,0,0,4,0
_GarrMissionLocation-TiragardeSound-Mid,8275,1294,1024,285,0,1024,1,286,7504,0,0,4,0
GarrMissionLocation-ArathiHighlands-List,8277,1295,792,78,1,793,1,79,7508,0,0,0,0
GarrMissionLocation-Ashenvale-List,8278,1295,792,78,795,1587,1,79,7509,0,0,0,0
GarrMissionLocation-Azshara-List,8279,1295,792,78,1,793,81,159,7510,0,0,0,0
GarrMissionLocation-Darkshore-List,8280,1295,792,78,795,1587,81,159,7511,0,0,0,0
GarrMissionLocation-Drustvar-List,8281,1295,792,78,1,793,161,239,7512,0,0,0,0
GarrMissionLocation-Durotar-List,8282,1295,792,78,795,1587,161,239,7513,0,0,0,0
GarrMissionLocation-HillsbradFoothills-List,8283,1295,792,78,1,793,241,319,7514,0,0,0,0
GarrMissionLocation-Nazmir-List,8284,1295,792,78,795,1587,241,319,7515,0,0,0,0
GarrMissionLocation-NorthernBarrens-List,8285,1295,792,78,1,793,321,399,7516,0,0,0,0
GarrMissionLocation-SilverpineForest-List,8286,1295,792,78,795,1587,321,399,7517,0,0,0,0
GarrMissionLocation-SouthernBarrens-List,8287,1295,792,78,1,793,401,479,7518,0,0,0,0
GarrMissionLocation-Stormsong-List,8288,1295,792,78,795,1587,401,479,7519,0,0,0,0
GarrMissionLocation-TiragardeSound-List,8289,1295,792,78,1,793,481,559,7520,0,0,0,0
GarrMissionLocation-Voldun-List,8290,1295,792,78,795,1587,481,559,7521,0,0,0,0
GarrMissionLocation-Zuldazar-List,8291,1295,792,78,1,793,561,639,7522,0,0,0,0
splash-801-botleft,8292,1296,137,371,374,511,587,958,7523,0,0,0,0
splash-801-right,8293,1296,510,584,1,511,1,585,7524,0,0,0,0
splash-801-topleft,8294,1296,371,434,1,372,587,1021,7525,0,0,0,0
splash-801A-botleft,8295,1297,137,371,374,511,587,958,7526,0,0,0,0
splash-801A-right,8296,1297,510,584,1,511,1,585,7527,0,0,0,0
splash-801A-topleft,8297,1297,371,434,1,372,587,1021,7528,0,0,0,0
splash-801H-botleft,8298,1298,137,371,374,511,587,958,7529,0,0,0,0
splash-801H-right,8299,1298,510,584,1,511,1,585,7530,0,0,0,0
splash-801H-topleft,8300,1298,371,434,1,372,587,1021,7531,0,0,0,0
Azerite-CenterTrait-Off,8301,988,130,130,1,131,428,558,7532,0,0,0,0
Azerite-CenterTrait-On,8302,988,130,130,1,131,560,690,7533,0,0,0,0
HordeFrame_ParchmentHeader-End-2,8303,1271,40,41,460,500,273,314,7534,0,0,0,0
HordeFrame_ParchmentHeader-End,8304,1271,40,41,418,458,273,314,7535,0,0,0,0
HordeFrame_ParchmentHeaderSelect-End-2,8305,1271,40,41,169,209,437,478,7536,0,0,0,0
HordeFrame_ParchmentHeaderSelect-End,8306,1271,40,41,169,209,394,435,7537,0,0,0,0
_HordeFrame_ParchmentHeader-Mid,8307,1271,128,41,0,128,60,101,7538,0,0,4,0
_HordeFrame_ParchmentHeaderSelect-Mid,8308,1271,128,41,0,128,103,144,7539,0,0,4,0
HordeFrame_ExitBorder,8309,1271,33,32,211,244,394,426,7540,0,0,0,0
HordeFrame_Title-End-2,8310,1271,78,61,169,247,331,392,7541,0,0,0,0
HordeFrame_Title-End,8311,1271,78,61,418,496,210,271,7542,0,0,0,0
_HordeFrame_Title-Tile,8312,1271,128,57,0,128,1,58,7543,0,0,4,0
loottoast-azerite,8313,332,277,98,281,558,118,216,7544,0,0,0,0
taxinode_continent_alliance,8316,647,64,64,797,861,131,195,7547,28,28,0,0
taxinode_continent_horde,8317,647,64,64,929,993,131,195,7548,28,28,0,0
taxinode_continent_neutral,8318,647,64,64,137,201,263,327,7549,28,28,0,0
AllianceFrame_Title-End,8319,1273,78,61,123,201,378,439,7550,0,0,0,0
AllianceFrame_Title-End-2,8320,1273,78,61,43,121,378,439,7551,0,0,0,0
AllianceFrame_ParchmentHeaderSelect-End,8321,1273,40,41,1,41,373,414,7552,0,0,0,0
AllianceFrame_ParchmentHeader-End-2,8322,1273,40,41,1,41,253,294,7553,0,0,0,0
AllianceFrame_ExitBorder,8323,1273,33,32,1,34,296,328,7554,0,0,0,0
AllianceFrame_ParchmentHeaderSelect-End-2,8324,1273,40,41,1,41,330,371,7555,0,0,0,0
_AllianceFrame_ParchmentHeader-Mid,8325,1273,128,41,0,128,1,42,7556,0,0,4,0
_AllianceFrame_ParchmentHeaderSelect-Mid,8326,1273,128,41,0,128,167,208,7557,0,0,4,0
_AllianceFrame_Title-Tile,8327,1273,128,57,0,128,108,165,7558,0,0,4,0
pvptalents-warmode-firecover,8328,110,127,73,1,128,949,1022,7559,0,0,0,0
pvptalents-talentborder-empty,8329,110,80,80,134,214,568,648,7560,0,0,0,0
loottoast-azerite-border,8330,332,58,58,627,685,218,276,7561,0,0,0,0
questportraiticon-alliance,8331,703,77,88,921,998,74,162,7562,0,0,0,0
questportraiticon-horde,8332,703,84,96,802,886,171,267,7563,0,0,0,0
AllianceFrame_ParchmentHeader-End,8333,1273,40,41,1,41,210,251,7564,0,0,0,0
communities-guildbanner-background,8334,1017,74,69,949,1023,1,70,7565,0,0,0,0
communities-guildbanner-border,8335,1017,74,69,616,690,246,315,7566,0,0,0,0
BfAMissionsLandingPage-Background-Horde,8336,1299,185,229,1,186,1,230,7567,0,0,0,0
BfAMissionsLandingPage-Background-Alliance,8337,1300,201,232,1,202,1,233,7568,0,0,0,0
communities-nav-button-green-normal,8338,1017,224,80,1,225,339,419,7569,0,0,0,0
communities-nav-button-green-pressed,8339,1017,224,80,1,225,421,501,7570,0,0,0,0
UI-EJ-BurningCrusade,8340,1301,786,425,1,787,1,426,7571,0,0,0,0
UI-EJ-Classic,8341,1301,786,425,1,787,428,853,7572,0,0,0,0
UI-EJ-Cataclysm,8342,1302,786,425,1,787,1,426,7573,0,0,0,0
UI-EJ-WrathoftheLichKing,8343,1302,786,425,1,787,428,853,7574,0,0,0,0
UI-EJ-MistsofPandaria,8344,1303,786,425,1,787,1,426,7575,0,0,0,0
UI-EJ-WarlordsofDraenor,8345,1303,786,425,1,787,428,853,7576,0,0,0,0
ui-ej-battleforazeroth,8346,1304,786,425,1,787,1,426,7577,0,0,0,0
ui-ej-legion,8347,1304,786,425,789,1575,1,426,7578,0,0,0,0
Bfa-expansionTrialPopup-middle,8348,1305,521,235,1,522,1,236,7579,0,0,0,0
Bfa-expansionTrialPopup-top,8349,1305,521,72,1,522,238,310,7580,0,0,0,0
Bfa-expansionTrialPopup-bottom,8350,1305,521,70,1,522,312,382,7581,0,0,0,0
Bfa-expansionTrialPopup-exit-frame,8351,1305,32,32,524,556,1,33,7582,0,0,0,0
questportraiticon-alliance-small,8352,703,55,59,288,343,949,1008,7583,0,0,0,0
questportraiticon-horde-small,8353,703,64,73,288,352,814,887,7584,0,0,0,0
bfa-landingbutton-alliance-shieldglow,8354,1242,43,49,49,92,54,103,7585,0,0,0,0
bfa-landingbutton-alliance-shieldhighlight,8355,1242,46,51,1,47,54,105,7586,0,0,0,0
bfa-landingbutton-horde-diamondglow,8356,1243,49,55,1,50,1,56,7587,0,0,0,0
bfa-landingbutton-horde-diamondhighlight,8357,1243,45,51,1,46,58,109,7588,0,0,0,0
talenttree-horde-corner,8358,1237,166,166,344,510,65,231,7589,0,0,0,0
talenttree-horde-cornerlogo,8359,1237,88,101,344,432,233,334,7590,0,0,0,0
talenttree-horde-currencybg,8360,1237,159,24,344,503,336,360,7591,0,0,0,0
talenttree-horde-exit,8361,1237,33,32,434,467,233,265,7592,0,0,0,0
_talenttree-horde-tilebottom,8362,1237,256,30,0,256,1,31,7593,0,0,4,0
_talenttree-horde-tiletop,8363,1237,256,30,0,256,33,63,7594,0,0,4,0
talenttree-alliance-background,8364,1306,341,506,1,342,65,571,7270,0,0,0,0
talenttree-alliance-corner,8365,1306,166,166,344,510,65,231,7595,0,0,0,0
talenttree-alliance-cornerlogo,8366,1306,82,92,344,426,233,325,7596,0,0,0,0
talenttree-alliance-currencybg,8367,1306,159,24,344,503,327,351,7597,0,0,0,0
talenttree-alliance-exit,8368,1306,33,32,428,461,233,265,7598,0,0,0,0
_talenttree-alliance-tilebottom,8369,1306,256,30,0,256,1,31,7599,0,0,4,0
_talenttree-alliance-tiletop,8370,1306,256,30,0,256,33,63,7600,0,0,4,0
!talenttree-horde-tileleft,8371,1307,30,256,1,31,0,256,7601,0,0,2,0
!talenttree-horde-tileright,8372,1307,30,256,33,63,0,256,7602,0,0,2,0
!talentree-alliance-tileleft,8373,1308,30,256,1,31,0,256,7603,0,0,2,0
!talentree-alliance-tileright,8374,1308,30,256,33,63,0,256,7604,0,0,2,0
scoreboard-alliance-corner,8375,1016,166,166,203,369,791,957,12635,0,0,0,0
scoreboard-horde-corner,8376,1016,166,166,371,537,791,957,12644,0,0,0,0
scoreboard-alliance-header,8377,1016,299,134,609,908,588,722,7607,0,0,0,0
_scoreboard-horde-tilebottom,8378,1016,256,30,0,256,65,95,12633,0,0,4,0
scoreboard-horde-header,8379,1016,415,119,1,416,467,586,7609,0,0,0,0
_scoreboard-alliance-tilebottom,8380,1016,256,30,0,256,1,31,12631,0,0,4,0
_scoreboard-horde-tiletop,8381,1016,256,30,0,256,97,127,12634,0,0,4,0
_scoreboard-alliance-tiletop,8382,1016,256,30,0,256,33,63,12632,0,0,4,0
!scoreboard-alliance-tileleft,8383,1309,30,256,1,31,0,256,12645,0,0,2,0
!scoreboard-alliance-tileright,8384,1309,30,256,33,63,0,256,12646,0,0,2,0
!scoreboard-horde-tileleft,8385,1309,30,256,65,95,0,256,12647,0,0,2,0
!scoreboard-horde-tileright,8386,1309,30,256,97,127,0,256,12648,0,0,2,0
ui-frame-bar-fill-blue,8387,1253,256,17,0,256,87,104,7617,0,0,4,0
GarrMission_ClassIcon-Technician,8390,324,55,49,58,113,103,152,7619,0,0,0,0
worldmap-highlight-cosmic-azeroth,8391,1310,448,423,1,449,1,424,7620,0,0,0,0
worldmap-highlight-cosmic-outland,8392,1310,386,374,1,387,426,800,7621,0,0,0,0
worldmap-highlight-cosmic-draenor,8393,1310,359,364,389,748,426,790,7622,0,0,0,0
chatframe-button-highlightalert,8394,924,34,32,1,35,1,33,7623,0,0,0,0
DarkWoodFrameCorner,8395,1311,64,64,31,95,1,65,7624,0,0,0,0
!DarkWoodFrameTile-Left,8396,1311,28,256,1,29,0,256,7625,0,0,2,0
_DarkWoodFrameTile-Bottom,8397,1312,256,28,0,256,1,29,7626,0,0,4,0
_DarkWoodFrameTile-Top,8398,1312,256,28,0,256,31,59,7627,0,0,4,0
islands-queue-titlesign,8399,1073,283,82,1716,1999,372,454,7628,0,0,0,0
groupfinder-background-islands,8400,236,333,96,1001,1334,99,195,7629,0,0,0,0
groupfinder-button-islands,8401,236,290,36,1,291,779,815,7630,0,0,0,0
islands-queue-popup,8402,1073,361,370,1353,1714,73,443,7631,0,0,0,0
hud-microbutton-guild-banner,8403,940,28,36,899,927,1,37,7632,0,0,0,0
BrokenIslesHighlight,8407,939,302,278,1,303,1,279,7636,0,0,0,0
ClassTrial-DemonHunter-Ring,8408,833,188,188,381,569,538,726,7637,0,0,0,0
communities-icon-chat,8409,1017,64,64,932,996,99,163,7638,0,0,0,0
UI-Frame-DpsIcon,8410,1313,31,30,1,32,1,31,7639,0,0,0,0
UI-Frame-HealerIcon,8411,1313,31,30,34,65,1,31,7640,0,0,0,0
UI-Frame-TankIcon,8412,1313,31,30,67,98,1,31,7641,0,0,0,0
shop-card-full-gametimebundle,8414,1314,568,463,1,569,1,464,7643,0,0,0,0
communities-icon-addchannelplus,8417,1017,32,32,227,259,451,483,7646,0,0,0,0
communities-create-button-bnet-highlight,8418,1017,116,67,831,947,1,68,7647,0,0,0,0
communities-icon-redx,8419,1017,24,24,311,335,451,475,7648,0,0,0,0
hud-microbutton-communities-icon-notification,8420,940,36,36,581,617,167,203,7649,0,0,0,0
alliedrace-unlockingframe-box,8421,921,287,65,683,970,1,66,7650,0,0,0,0
alliedrace-unlockingframe-checkmark,8422,921,21,18,1000,1021,39,57,7651,0,0,0,0
raceicon-kultiran-female,8423,897,64,64,1171,1235,857,921,7652,0,0,0,0
raceicon-kultiran-male,8424,897,64,64,1171,1235,923,987,7653,0,0,0,0
raceicon-zandalari-female,8425,897,64,64,1633,1697,263,327,7654,0,0,0,0
raceicon-zandalari-male,8426,897,64,64,1699,1763,263,327,7655,0,0,0,0
UI-Frame-SimpleMetal-CornerTopLeft,8463,1380,64,64,1,65,67,131,7682,0,0,0,0
_UI-Frame-SimpleMetal-EdgeTop,8464,1380,64,64,0,64,1,65,7683,0,0,4,0
!UI-Frame-SimpleMetal-EdgeLeft,8465,1381,64,64,1,65,0,64,7684,0,0,2,0
map-markeddefeated,8468,647,32,32,411,443,851,883,7687,0,0,0,0
UI-Frame-SimpleMetal-CornerTopRightButton,8478,1380,64,64,1,65,133,197,7696,0,0,0,0
darkshore_warfront_alliance_archer,8479,1097,64,64,1,65,67,131,7697,0,0,0,0
darkshore_warfront_alliance_arch_druid,8480,1097,64,64,1,65,1,65,7698,0,0,0,0
darkshore_warfront_alliance_call_of_nature,8481,1097,64,64,1,65,133,197,7699,0,0,0,0
darkshore_warfront_alliance_chimaera,8482,1097,64,64,1,65,199,263,7700,0,0,0,0
darkshore_warfront_alliance_druid,8483,1097,64,64,1,65,265,329,7701,0,0,0,0
darkshore_warfront_alliance_dryad,8484,1097,64,64,1,65,331,395,7702,0,0,0,0
darkshore_warfront_alliance_faerie_dragon,8485,1097,64,64,1,65,397,461,7703,0,0,0,0
darkshore_warfront_alliance_glaive_thrower,8486,1097,64,64,67,131,1,65,7704,0,0,0,0
darkshore_warfront_alliance_huntress,8487,1097,64,64,67,131,67,131,7705,0,0,0,0
darkshore_warfront_alliance_keeper_of_the_grove,8488,1097,64,64,67,131,133,197,7706,0,0,0,0
darkshore_warfront_alliance_sentinel,8489,1097,64,64,67,131,199,263,7707,0,0,0,0
darkshore_warfront_alliance_tree_of_ages,8490,1097,64,64,67,131,265,329,7708,0,0,0,0
darkshore_warfront_alliance_tree_of_eternity,8491,1097,64,64,67,131,331,395,7709,0,0,0,0
darkshore_warfront_alliance_tree_of_life,8492,1097,64,64,67,131,397,461,7710,0,0,0,0
Azerite-GoldRing-Rank3,8493,1385,758,758,1,759,1,759,6426,0,0,0,0
Azerite-GoldRing-Rank4,8494,1386,1008,1008,1,1009,1,1009,6430,0,0,0,0
shop-card-half-subscription,8497,1389,286,471,1,287,1,472,7712,0,0,0,0
shop-card-half-completecollection,8498,1389,286,471,289,575,1,472,7713,0,0,0,0
ui-frame-metal-cornerbottomleft-2x,8499,1390,64,64,153,217,153,217,7674,0,0,0,2
ui-frame-metal-cornerbottomright-2x,8500,1390,64,64,219,283,153,217,7677,0,0,0,2
ui-frame-metal-cornertopleft-2x,8501,1390,150,150,1,151,1,151,7678,0,0,0,2
ui-frame-metal-cornertopright-2x,8502,1390,150,150,153,303,1,151,7679,0,0,0,2
ui-frame-portraitmetal-cornertopleft-2x,8504,1390,150,150,1,151,153,303,7672,0,0,0,2
ui-frame-metal-cornertoprightdouble-2x,8508,1390,150,150,305,455,1,151,7715,0,0,0,2
!AlliedRace-UnlockingFrame-BoxTile,8509,1391,287,16,1,288,0,16,7716,0,0,2,0
!ui-frame-metal-edgeleft-2x,8514,1394,150,32,1,151,0,32,7680,0,0,2,2
!ui-frame-metal-edgeright-2x,8515,1394,150,32,153,303,0,32,7681,0,0,2,2
_ui-frame-metal-edgebottom-2x,8516,1395,32,64,0,32,153,217,7673,0,0,4,2
_ui-frame-metal-edgetop-2x,8517,1395,64,150,0,64,1,151,7676,0,0,4,2
alliedrace-unlockingframe-boxtopper,8518,921,283,28,683,966,68,96,7719,0,0,0,0
CharacterCreate-NewLabel,8533,837,64,48,59,123,1,49,7727,0,0,0,0
warfront_alliance_double-frame,8537,973,243,77,1,244,1,78,7731,0,0,0,0
warfront_horde_double-frame,8539,973,243,77,246,489,1,78,7733,0,0,0,0
warfront_alliance_left-frame,8542,973,243,77,1,244,80,157,7736,0,0,0,0
warfront_alliance_right-frame,8543,973,243,77,246,489,80,157,7737,0,0,0,0
warfront_horde_left-frame,8544,973,243,77,1,244,159,236,7738,0,0,0,0
warfront_horde_right-frame,8545,973,243,77,246,489,159,236,7739,0,0,0,0
bags-icon-scrappable,8546,202,36,32,261,297,204,236,7740,0,0,0,0
Azerite-Center-TraitPlug-Rune4,8547,1009,89,89,183,272,763,852,7741,0,0,0,0
Azerite-CenterBG-5Ranks,8548,1009,481,760,1,482,1,761,7742,0,0,0,0
Azerite-CenterBG-ChannelGlowBar-MaskRank5,8549,1397,1024,1024,0,1024,0,1024,7743,0,0,16,0
Azerite-GoldRing-Rank5,8550,1398,1260,1260,1,1261,1,1261,7744,0,0,0,0
Azerite-TitanBG-GearRank5-Front,8551,1399,1250,1250,1,1251,1,1251,7745,0,0,0,0
Azerite-TitanBG-Glow-Rank5,8552,1400,1230,1230,1,1231,1,1231,7746,0,0,0,0
Azerite-TitanBG-GearRank5,8553,1401,1250,1250,1,1251,1,1251,7747,0,0,0,0
Azerite-TitanBG-Rank5,8554,1402,1250,1250,1,1251,1,1251,7748,0,0,0,0
Azerite-CenterBG-ChannelGlowBar-Filling-Rank5,8555,1009,143,700,1411,1554,1,701,7749,0,0,0,0
Azerite-CenterBG-ChannelGlowBar-Shinny-Rank5,8556,1009,157,707,1252,1409,1,708,7750,0,0,0,0
UI-Frame-IconBorder,8557,1403,64,64,1,65,1,65,7751,0,0,0,0
UI-Frame-IconMask,8562,1406,64,64,0,64,0,64,7754,0,0,16,0
warfronts-basemapicons-alliance-armory-minimap-small,8563,647,37,35,719,756,263,298,7756,0,0,0,0
warfronts-basemapicons-alliance-barracks-minimap-small,8564,647,37,35,797,834,263,298,7757,0,0,0,0
warfronts-basemapicons-alliance-constructionarmory-minimap-small,8565,647,37,35,875,912,263,298,7758,0,0,0,0
warfronts-basemapicons-alliance-constructionbarracks-minimap-small,8566,647,37,35,953,990,263,298,7759,0,0,0,0
warfronts-basemapicons-alliance-constructionheroes-minimap-small,8567,647,37,35,338,375,301,336,7760,0,0,0,0
warfronts-basemapicons-alliance-constructionmainhall-minimap-small,8568,647,37,35,416,453,301,336,7761,0,0,0,0
warfronts-basemapicons-alliance-constructionworkshop-minimap-small,8569,647,37,35,494,531,301,336,7762,0,0,0,0
warfronts-basemapicons-alliance-heroes-minimap-small,8570,647,37,35,572,609,301,336,7763,0,0,0,0
warfronts-basemapicons-alliance-mainhall-minimap-small,8571,647,37,35,650,687,301,336,7764,0,0,0,0
warfronts-basemapicons-alliance-tower-minimap-small,8572,647,37,35,728,765,301,336,7765,0,0,0,0
warfronts-basemapicons-alliance-workshop-minimap-small,8573,647,37,35,806,843,301,336,7766,0,0,0,0
warfronts-basemapicons-empty-armory-minimap-small,8574,647,37,35,884,921,301,336,7767,0,0,0,0
warfronts-basemapicons-empty-barracks-minimap-small,8575,647,37,35,962,999,301,336,7768,0,0,0,0
warfronts-basemapicons-empty-heroes-minimap-small,8576,647,37,35,299,336,375,410,7769,0,0,0,0
warfronts-basemapicons-empty-mainhall-minimap-small,8577,647,37,35,299,336,449,484,7770,0,0,0,0
warfronts-basemapicons-empty-tower-minimap-small,8578,647,37,35,299,336,523,558,7771,0,0,0,0
warfronts-basemapicons-empty-workshop-minimap-small,8579,647,37,35,299,336,597,632,7772,0,0,0,0
warfronts-basemapicons-horde-armory-minimap-small,8580,647,37,35,299,336,671,706,7773,0,0,0,0
warfronts-basemapicons-horde-barracks-minimap-small,8581,647,37,35,299,336,745,780,7774,0,0,0,0
warfronts-basemapicons-horde-constructionarmory-minimap-small,8582,647,37,35,299,336,819,854,7775,0,0,0,0
warfronts-basemapicons-horde-constructionbarracks-minimap-small,8583,647,37,35,299,336,893,928,7776,0,0,0,0
warfronts-basemapicons-horde-constructionheroes-minimap-small,8584,647,37,35,299,336,967,1002,7777,0,0,0,0
warfronts-basemapicons-horde-constructionmainhall-minimap-small,8585,647,37,35,377,414,338,373,7778,0,0,0,0
warfronts-basemapicons-horde-constructionworkshop-minimap-small,8586,647,37,35,455,492,338,373,7779,0,0,0,0
warfronts-basemapicons-horde-heroes-minimap-small,8587,647,37,35,533,570,338,373,7780,0,0,0,0
warfronts-basemapicons-horde-mainhall-minimap-small,8588,647,37,35,611,648,338,373,7781,0,0,0,0
warfronts-basemapicons-horde-tower-minimap-small,8589,647,37,35,689,726,338,373,7782,0,0,0,0
warfronts-basemapicons-horde-workshop-minimap-small,8590,647,37,35,767,804,338,373,7783,0,0,0,0
warfronts-fieldmapicons-alliance-banner-minimap-small,8591,647,37,35,845,882,338,373,7784,0,0,0,0
warfronts-fieldmapicons-alliance-lumbermill-minimap-small,8592,647,37,35,923,960,338,373,7785,0,0,0,0
warfronts-fieldmapicons-alliance-mine-minimap-small,8593,647,37,35,338,375,375,410,7786,0,0,0,0
warfronts-fieldmapicons-empty-banner-minimap-small,8594,647,37,35,338,375,449,484,7787,0,0,0,0
warfronts-fieldmapicons-empty-lumbermill-minimap-small,8595,647,37,35,338,375,523,558,7788,0,0,0,0
warfronts-fieldmapicons-empty-mine-minimap-small,8596,647,37,35,338,375,597,632,7789,0,0,0,0
warfronts-fieldmapicons-horde-banner-minimap-small,8597,647,37,35,338,375,671,706,7790,0,0,0,0
warfronts-fieldmapicons-horde-lumbermill-minimap-small,8598,647,37,35,338,375,745,780,7791,0,0,0,0
warfronts-fieldmapicons-horde-mine-minimap-small,8599,647,37,35,338,375,819,854,7792,0,0,0,0
warfronts-fieldmapicons-neutral-banner-minimap-small,8600,647,37,35,338,375,893,928,7793,0,0,0,0
warfronts-fieldmapicons-neutral-mine-minimap-small,8601,647,37,35,338,375,967,1002,7794,0,0,0,0
UI-Frame-Horde-DisableSubtitle,8613,1246,207,30,393,600,273,303,7801,0,0,0,0
UI-Frame-Horde-Subtitle,8614,1246,207,30,393,600,305,335,7802,0,0,0,0
UI-Frame-Alliance-Subtitle,8615,1254,207,30,649,856,288,318,7803,0,0,0,0
UI-Frame-Alliance-DisableSubtitle,8616,1254,207,30,1,208,872,902,7804,0,0,0,0
Azerite-TitanBG-Rank5-1Gear,8617,1410,1250,1250,1,1251,1,1251,7805,0,0,0,0
Azerite-TitanBG-LightsRank5,8618,1411,1250,1250,1,1251,1,1251,7806,0,0,0,0
parchmentpopup-background,8619,1412,275,275,1,276,170,445,7807,0,0,0,0
parchmentpopup-bottom,8620,1412,498,167,1,499,1,168,7808,0,0,0,0
parchmentpopup-bottomleft,8621,1412,167,167,278,445,324,491,7809,0,0,0,0
parchmentpopup-bottomright,8622,1412,167,167,278,445,662,829,7810,0,0,0,0
parchmentpopup-hide-bottom,8623,1412,39,125,170,209,447,572,7811,0,0,0,0
parchmentpopup-hide-left,8624,1412,125,39,1,126,934,973,7812,0,0,0,0
parchmentpopup-hide-right,8625,1412,125,39,1,126,893,932,7813,0,0,0,0
parchmentpopup-hide-top,8626,1412,39,125,211,250,447,572,7814,0,0,0,0
parchmentpopup-left,8627,1412,167,221,1,168,447,668,7815,0,0,0,0
parchmentpopup-right,8628,1412,167,221,1,168,670,891,7816,0,0,0,0
parchmentpopup-top,8629,1412,498,167,501,999,1,168,7817,0,0,0,0
parchmentpopup-topleft,8630,1412,167,167,278,445,831,998,7818,0,0,0,0
parchmentpopup-topright,8631,1412,167,167,278,445,493,660,7819,0,0,0,0
worldquest-icon-alliance,8632,743,16,15,117,133,494,509,7820,0,0,0,0
worldquest-icon-horde,8633,743,16,15,181,197,467,482,7821,0,0,0,0
pvpqueue-rewardring-popup,8636,1234,94,95,836,930,193,288,7824,0,0,0,0
mythicplus-popup-ring,8637,1244,77,77,393,470,352,429,7825,0,0,0,0
parchmentpopup-filigree,8638,1412,185,152,278,463,170,322,7826,0,0,0,0
scoreboard-background-warfronts-darkshore-horde,8722,1417,1022,602,1,1023,1,603,7828,0,0,0,0
scoreboard-background-warfronts-darkshore-alliance,8723,1418,1022,602,1,1023,1,603,7829,0,0,0,0
Raid-Icon-SummonAccepted,8724,1419,32,32,1,33,1,33,7830,0,0,0,0
Raid-Icon-SummonDeclined,8725,1419,32,32,35,67,1,33,7831,0,0,0,0
Raid-Icon-SummonPending,8726,1419,32,32,69,101,1,33,7832,0,0,0,0
darkshore_warfront_horde_alchemist,8727,1097,64,64,133,197,67,131,7833,0,0,0,0
darkshore_warfront_horde_deadshot,8728,1097,64,64,133,197,331,395,7834,0,0,0,0
darkshore_warfront_horde_deathguard,8729,1097,64,64,133,197,397,461,7835,0,0,0,0
darkshore_warfront_horde_lancer,8730,1097,64,64,199,263,1,65,7836,0,0,0,0
warfront_asset_armor_upgrade_1,8732,1097,64,64,331,395,199,263,7045,0,0,0,0
warfront_asset_armor_upgrade_2,8733,1097,64,64,331,395,265,329,7046,0,0,0,0
warfront_asset_armor_upgrade_3,8734,1097,64,64,331,395,331,395,7047,0,0,0,0
warfront_asset_weapon_upgrade_1,8735,1097,64,64,463,527,331,395,7064,0,0,0,0
warfront_asset_weapon_upgrade_2,8736,1097,64,64,463,527,397,461,7065,0,0,0,0
warfront_asset_weapon_upgrade_3,8737,1097,64,64,529,593,1,65,7066,0,0,0,0
darkshore_warfront_horde_catapult,8738,1097,64,64,133,197,265,329,7837,0,0,0,0
darkshore_warfront_horde_town_hall_1,8739,1097,64,64,199,263,133,197,7838,0,0,0,0
darkshore_warfront_horde_town_hall_2,8740,1097,64,64,199,263,199,263,7839,0,0,0,0
darkshore_warfront_horde_town_hall_3,8741,1097,64,64,199,263,265,329,7840,0,0,0,0
darkshore_warfront_horde_abomination,8742,1097,64,64,133,197,1,65,7841,0,0,0,0
darkshore_warfront_horde_azermek,8743,1097,64,64,133,197,133,197,7842,0,0,0,0
darkshore_warfront_horde_banshee,8744,1097,64,64,133,197,199,263,7843,0,0,0,0
HordeEmblem,8745,1413,110,110,113,223,1,111,7844,0,0,0,0
AllianceEmblem,8746,1413,110,110,1,111,1,111,7845,0,0,0,0
pvpqueue-chest-alliance-collect,8747,1420,374,304,1,375,1,305,7846,0,0,0,0
pvpqueue-chest-alliance-complete,8748,1420,374,304,1,375,307,611,7847,0,0,0,0
pvpqueue-chest-alliance-incomplete,8749,1420,374,304,1,375,613,917,7848,0,0,0,0
pvpqueue-chest-horde-collect,8750,1421,374,304,1,375,1,305,7849,0,0,0,0
pvpqueue-chest-horde-complete,8751,1421,374,304,1,375,307,611,7850,0,0,0,0
pvpqueue-chest-horde-incomplete,8752,1421,374,304,1,375,613,917,7851,0,0,0,0
poi-scrapper,8753,647,32,32,445,477,851,883,7852,0,0,0,0
poi-islands-table,8760,647,38,38,203,241,874,912,7853,0,0,0,0
pvpqueue-chest-background,8761,1234,196,171,779,975,20,191,7854,0,0,0,0
darkshore_warfront_horde_putrid_abomination,8762,1097,64,64,199,263,67,131,7855,0,0,0,0
darkshore_warfront_horde_vile_screecher,8763,1097,64,64,199,263,331,395,7856,0,0,0,0
_GarrMissionLocation-Islands-Mid,8764,1414,1024,285,0,1024,1,286,7857,0,0,4,0
splash-810-botleft,8765,1422,137,371,374,511,587,958,7858,0,0,0,0
splash-810-right,8766,1422,510,584,1,511,1,585,7859,0,0,0,0
splash-810-topleft,8767,1422,371,434,1,372,587,1021,7860,0,0,0,0
splash-8102-botleft,8768,1423,137,371,374,511,587,958,7861,0,0,0,0
splash-8102-right,8769,1423,510,584,1,511,1,585,7862,0,0,0,0
splash-8102-topleft,8770,1423,371,434,1,372,587,1021,7863,0,0,0,0
pvptalents-warmode-incentive-ring,8775,110,48,48,1,49,151,199,7868,0,0,0,0
BfAMission-Icon-Treasure,8778,1096,80,80,83,163,83,163,7870,0,0,0,0
guildfinder-card-guildbanner-background,8790,1428,246,168,181,427,82,250,7877,0,0,0,0
guildfinder-card-guildbanner-border,8791,1428,246,168,181,427,252,420,7878,0,0,0,0
guildfinder-card-guildbanner-shadow,8792,1428,246,168,429,675,82,250,7879,0,0,0,0
guildfinder-card,8793,1428,178,264,1,179,1,265,7880,0,0,0,0
common-checkbox-partial,8794,1429,16,16,1,17,1,17,7881,0,0,0,0
shop-card-bundle-battleforazeroth,8797,971,292,159,581,873,1,160,6609,0,0,0,0
shop-card-bundle-lastchance2018,8798,971,292,135,581,873,322,457,7884,0,0,0,0
islands-queue-card-jorundall-taunka,8799,1430,412,268,1,413,1,269,7885,0,0,0,0
islands-queue-card-jorundall-vargul,8800,1430,412,268,415,827,1,269,7886,0,0,0,0
islands-queue-card-jorundall-vrykul,8801,1430,412,268,1,413,271,539,7887,0,0,0,0
islands-queue-card-jorundall,8802,1430,412,268,415,827,271,539,7888,0,0,0,0
islands-queue-card-havenswood,8803,1431,412,268,1,413,1,269,7889,0,0,0,0
islands-queue-card-havenswood-cultist,8804,1431,412,268,415,827,1,269,7890,0,0,0,0
islands-queue-card-havenswood-faceless,8805,1431,412,268,1,413,271,539,7891,0,0,0,0
islands-queue-card-havenswood-worgen,8806,1431,412,268,415,827,271,539,7892,0,0,0,0
shop-card-bundle-lastchance2018-featured,8807,1432,568,463,1,569,1,464,7893,0,0,0,0
shop-card-full-gametimebundle2,8808,1433,568,463,1,569,1,464,7894,0,0,0,0
shop-card-full-gametimebundle3,8809,1434,568,463,1,569,1,464,7895,0,0,0,0
alliedrace-unlockingframe-modelbackground-kultiran,8928,942,314,578,1,315,1,579,10884,0,0,0,0
alliedrace-crest-kultiran,8929,923,64,64,1,65,133,197,10885,0,0,0,0
transmog-background-race-kultiran,8930,1443,294,494,1,295,1,495,10886,0,0,0,0
allianceassaultsmapbanner,8931,647,64,64,1,65,201,265,10887,0,0,0,0
hordeassaultsmapbanner,8932,647,64,64,1,65,861,925,10888,0,0,0,0
alliedrace-unlockingframe-modelbackground-zandalari,8943,942,314,578,1265,1579,1,579,10899,0,0,0,0
alliedrace-crest-zandalari,8944,923,64,64,199,263,1,65,10900,0,0,0,0
communities-icon-searchmagnifyingglass,8945,1017,76,76,616,692,168,244,10901,0,0,0,0
communitiesfinder-card,8946,1428,570,71,429,999,252,323,10902,0,0,0,0
transmog-background-race-ZandalariTroll,8947,1446,294,494,1,295,1,495,11080,0,0,0,0
ctf_flags-leftIcon1-state1,8960,1448,32,32,1,33,1,33,10916,0,0,0,0
ctf_flags-leftIcon2-state1,8961,1448,32,32,35,67,1,33,10917,0,0,0,0
ctf_flags-leftIcon3-state1,8962,1448,32,32,69,101,1,33,10918,0,0,0,0
ctf_flags-leftIcon4-state1,8963,1448,32,32,103,135,1,33,10919,0,0,0,0
ctf_flags-leftIcon5-state1,8964,1448,32,32,137,169,1,33,10920,0,0,0,0
ctf_flags-rightIcon1-state1,8965,1448,32,32,171,203,1,33,10921,0,0,0,0
ctf_flags-rightIcon2-state1,8966,1448,32,32,205,237,1,33,10922,0,0,0,0
ctf_flags-rightIcon3-state1,8967,1448,32,32,1,33,35,67,10923,0,0,0,0
ctf_flags-rightIcon4-state1,8968,1448,32,32,1,33,69,101,10924,0,0,0,0
ctf_flags-rightIcon5-state1,8969,1448,32,32,1,33,103,135,10925,0,0,0,0
ab_capPts-leftIcon1-state1,8990,1448,18,18,147,165,35,53,10946,0,0,0,0
ab_capPts-leftIcon1-state2,8991,1448,18,18,167,185,35,53,10947,0,0,0,0
ab_capPts-leftIcon2-state1,8992,1448,18,18,187,205,35,53,10948,0,0,0,0
ab_capPts-leftIcon2-state2,8993,1448,18,18,207,225,35,53,10949,0,0,0,0
ab_capPts-leftIcon3-state1,8994,1448,18,18,227,245,35,53,10950,0,0,0,0
ab_capPts-leftIcon3-state2,8995,1448,18,18,35,53,63,81,10951,0,0,0,0
ab_capPts-leftIcon4-state1,8996,1448,18,18,35,53,83,101,10952,0,0,0,0
ab_capPts-leftIcon4-state2,8997,1448,18,18,35,53,103,121,10953,0,0,0,0
ab_capPts-leftIcon5-state1,8998,1448,18,18,35,53,123,141,10954,0,0,0,0
ab_capPts-leftIcon5-state2,8999,1448,18,18,35,53,143,161,10955,0,0,0,0
ab_capPts-rightIcon1-state1,9000,1448,18,18,35,53,163,181,10956,0,0,0,0
ab_capPts-rightIcon1-state2,9001,1448,18,18,35,53,183,201,10957,0,0,0,0
ab_capPts-rightIcon2-state1,9002,1448,18,18,35,53,203,221,10958,0,0,0,0
ab_capPts-rightIcon2-state2,9003,1448,18,18,35,53,223,241,10959,0,0,0,0
ab_capPts-rightIcon3-state1,9004,1448,18,18,55,73,63,81,10960,0,0,0,0
ab_capPts-rightIcon3-state2,9005,1448,18,18,55,73,83,101,10961,0,0,0,0
ab_capPts-rightIcon4-state1,9006,1448,18,18,55,73,103,121,10962,0,0,0,0
ab_capPts-rightIcon4-state2,9007,1448,18,18,55,73,123,141,10963,0,0,0,0
ab_capPts-rightIcon5-state1,9008,1448,18,18,55,73,143,161,10964,0,0,0,0
ab_capPts-rightIcon5-state2,9009,1448,18,18,55,73,163,181,10965,0,0,0,0
poi-traveldirections-arrow,9018,647,26,34,995,1021,131,165,10974,0,0,0,0
poi-traveldirections-arrow2,9019,647,36,44,203,239,790,834,10975,0,0,0,0
orbs-leftIcon1-state1,9020,1448,26,26,1,27,137,163,10976,0,0,0,0
orbs-leftIcon2-state1,9021,1448,26,26,1,27,165,191,10977,0,0,0,0
orbs-leftIcon3-state1,9022,1448,26,26,1,27,193,219,10978,0,0,0,0
orbs-leftIcon4-state1,9023,1448,26,26,1,27,221,247,10979,0,0,0,0
orbs-rightIcon1-state1,9024,1448,26,26,35,61,35,61,10980,0,0,0,0
orbs-rightIcon2-state1,9025,1448,26,26,63,89,35,61,10981,0,0,0,0
orbs-rightIcon3-state1,9026,1448,26,26,91,117,35,61,10982,0,0,0,0
orbs-rightIcon4-state1,9027,1448,26,26,119,145,35,61,10983,0,0,0,0
dg_capPts-leftIcon1-state1,9028,1448,18,18,75,93,83,101,10984,0,0,0,0
dg_capPts-leftIcon2-state1,9030,1448,18,18,75,93,123,141,10986,0,0,0,0
dg_capPts-leftIcon2-state2,9031,1448,18,18,75,93,143,161,10987,0,0,0,0
dg_capPts-leftIcon3-state1,9032,1448,18,18,75,93,163,181,10988,0,0,0,0
dg_capPts-leftIcon3-state2,9033,1448,18,18,75,93,183,201,10989,0,0,0,0
dg_capPts-leftIcon4-state1,9034,1448,18,18,75,93,203,221,10990,0,0,0,0
dg_capPts-rightIcon1-state1,9035,1448,18,18,195,213,83,101,10991,0,0,0,0
dg_capPts-rightIcon2-state1,9037,1448,18,18,235,253,83,101,10993,0,0,0,0
dg_capPts-rightIcon2-state2,9038,1448,18,18,95,113,103,121,10994,0,0,0,0
dg_capPts-rightIcon3-state1,9039,1448,18,18,95,113,123,141,10995,0,0,0,0
dg_capPts-rightIcon3-state2,9040,1448,18,18,95,113,143,161,10996,0,0,0,0
dg_capPts-rightIcon4-state1,9041,1448,18,18,95,113,163,181,10997,0,0,0,0
dg_capPts-leftIcon4-state2,9042,1448,18,18,75,93,223,241,10998,0,0,0,0
dg_capPts-rightIcon4-state2,9043,1448,18,18,95,113,183,201,10999,0,0,0,0
eots_capPts-leftIcon1-state1,9050,1448,18,18,115,133,103,121,11006,0,0,0,0
eots_capPts-leftIcon2-state1,9052,1448,18,18,135,153,103,121,11008,0,0,0,0
eots_capPts-leftIcon2-state2,9053,1448,18,18,155,173,103,121,11009,0,0,0,0
eots_capPts-leftIcon3-state1,9054,1448,18,18,175,193,103,121,11010,0,0,0,0
eots_capPts-leftIcon3-state2,9055,1448,18,18,195,213,103,121,11011,0,0,0,0
eots_capPts-leftIcon4-state1,9056,1448,18,18,215,233,103,121,11012,0,0,0,0
eots_capPts-leftIcon4-state2,9057,1448,18,18,235,253,103,121,11013,0,0,0,0
eots_capPts-rightIcon1-state1,9058,1448,18,18,135,153,123,141,11014,0,0,0,0
eots_capPts-rightIcon2-state1,9060,1448,18,18,155,173,123,141,11016,0,0,0,0
eots_capPts-rightIcon2-state2,9061,1448,18,18,175,193,123,141,11017,0,0,0,0
eots_capPts-rightIcon3-state1,9062,1448,18,18,195,213,123,141,11018,0,0,0,0
eots_capPts-rightIcon3-state2,9063,1448,18,18,215,233,123,141,11019,0,0,0,0
eots_capPts-rightIcon4-state1,9064,1448,18,18,235,253,123,141,11020,0,0,0,0
eots_capPts-rightIcon4-state2,9065,1448,18,18,135,153,143,161,11021,0,0,0,0
eots_capPts-leftIcon5-state1,9066,1448,18,18,115,133,123,141,11022,0,0,0,0
eots_capPts-leftIcon5-state2,9067,1448,18,18,115,133,143,161,11023,0,0,0,0
eots_capPts-rightIcon5-state1,9068,1448,18,18,135,153,163,181,11024,0,0,0,0
eots_capPts-rightIcon5-state2,9069,1448,18,18,135,153,183,201,11025,0,0,0,0
bfg_capPts-leftIcon1-state1,9070,1448,18,18,55,73,183,201,11026,0,0,0,0
bfg_capPts-leftIcon1-state2,9071,1448,18,18,55,73,203,221,11027,0,0,0,0
bfg_capPts-leftIcon2-state1,9072,1448,18,18,55,73,223,241,11028,0,0,0,0
bfg_capPts-leftIcon2-state2,9073,1448,18,18,75,93,63,81,11029,0,0,0,0
bfg_capPts-leftIcon3-state1,9074,1448,18,18,95,113,63,81,11030,0,0,0,0
bfg_capPts-leftIcon3-state2,9075,1448,18,18,115,133,63,81,11031,0,0,0,0
bfg_capPts-rightIcon1-state1,9076,1448,18,18,135,153,63,81,11032,0,0,0,0
bfg_capPts-rightIcon1-state2,9077,1448,18,18,155,173,63,81,11033,0,0,0,0
bfg_capPts-rightIcon2-state1,9078,1448,18,18,175,193,63,81,11034,0,0,0,0
bfg_capPts-rightIcon2-state2,9079,1448,18,18,195,213,63,81,11035,0,0,0,0
bfg_capPts-rightIcon3-state1,9080,1448,18,18,215,233,63,81,11036,0,0,0,0
bfg_capPts-rightIcon3-state2,9081,1448,18,18,235,253,63,81,11037,0,0,0,0
sm_carts-leftIcon1-state1,9082,1448,18,18,135,153,203,221,11038,0,0,0,0
sm_carts-leftIcon2-state1,9083,1448,18,18,135,153,223,241,11039,0,0,0,0
sm_carts-leftIcon3-state1,9084,1448,18,18,155,173,143,161,11040,0,0,0,0
sm_carts-rightIcon1-state1,9085,1448,18,18,175,193,143,161,11041,0,0,0,0
sm_carts-rightIcon2-state1,9086,1448,18,18,195,213,143,161,11042,0,0,0,0
sm_carts-rightIcon3-state1,9087,1448,18,18,215,233,143,161,11043,0,0,0,0
nameplates-icon-bounty-alliance,9088,731,21,20,102,123,51,71,11044,0,0,0,0
nameplates-icon-bounty-horde,9089,731,21,20,102,123,73,93,11045,0,0,0,0
nameplates-icon-flag-alliance,9090,731,18,18,129,147,65,83,11046,0,0,0,0
nameplates-icon-flag-horde,9091,731,18,18,129,147,85,103,11047,0,0,0,0
nameplates-icon-orb-blue,9092,731,26,26,40,66,98,124,11048,0,0,0,0
nameplates-icon-orb-green,9093,731,26,26,74,100,30,56,11049,0,0,0,0
nameplates-icon-orb-orange,9094,731,26,26,74,100,58,84,11050,0,0,0,0
nameplates-icon-orb-purple,9095,731,26,26,74,100,86,112,11051,0,0,0,0
nameplates-icon-cart-alliance,9096,731,32,32,40,72,30,62,11052,0,0,0,0
nameplates-icon-cart-horde,9097,731,32,32,40,72,64,96,11053,0,0,0,0
nameplates-icon-flag-neutral,9099,731,18,18,129,147,105,123,11055,0,0,0,0
dg_capPts-neutralIcon1-state1,9107,1448,18,18,135,153,83,101,11063,0,0,0,0
dg_capPts-neutralIcon2-state1,9108,1448,18,18,155,173,83,101,11064,0,0,0,0
dg_capPts-neutralIcon3-state1,9109,1448,18,18,175,193,83,101,11065,0,0,0,0
eots_capPts-neutralIcon1-state1,9110,1448,18,18,115,133,163,181,11066,0,0,0,0
eots_capPts-neutralIcon2-state1,9111,1448,18,18,115,133,183,201,11067,0,0,0,0
eots_capPts-neutralIcon3-state1,9112,1448,18,18,115,133,203,221,11068,0,0,0,0
eots_capPts-neutralIcon4-state1,9113,1448,18,18,115,133,223,241,11069,0,0,0,0
splash-815-botleft,9118,1450,137,371,374,511,587,958,11077,0,0,0,0
splash-815-right,9119,1450,510,584,1,511,1,585,11078,0,0,0,0
splash-815-topleft,9120,1450,371,434,1,372,587,1021,11079,0,0,0,0
pvpscoreboard-background-color,9121,1451,755,313,749,1504,1,314,11081,0,0,0,0
pvpscoreboard-background-reward-shadow,9122,1451,16,30,1,17,469,499,11082,0,0,0,0
pvpscoreboard-background-reward,9123,1451,755,80,749,1504,485,565,11083,0,0,0,0
pvpscoreboard-background,9124,1451,746,466,1,747,1,467,11084,0,0,0,0
pvpscoreboard-header-glow,9125,1451,993,167,749,1742,316,483,11085,0,0,0,0
heartofazeroth-list-item-uncollected,9127,1452,356,82,1304,1660,1648,1730,11087,0,0,0,0
heartofazeroth-list-item,9128,1452,356,82,415,771,1666,1748,11088,0,0,0,0
heartofazeroth-list-selected-major,9129,1452,21,26,2025,2046,275,301,11089,0,0,0,0
heartofazeroth-list-selected-minor,9130,1452,22,26,2025,2047,247,273,11090,0,0,0,0
heartofazeroth-slot-major-background,9131,1452,142,106,1777,1919,692,798,11091,0,0,0,0
heartofazeroth-slot-major-glass,9133,1452,142,106,1596,1738,1441,1547,11093,0,0,0,0
heartofazeroth-slot-major-glow,9134,1452,208,184,1596,1804,1255,1439,11094,0,0,0,0
heartofazeroth-slot-major-glowrings,9135,1452,214,214,1777,1991,476,690,11095,0,0,0,0
heartofazeroth-slot-major-ring,9136,1452,110,82,1910,2020,1414,1496,11096,0,0,0,0
heartofazeroth-slot-minor-background,9138,1452,80,80,1963,2043,1,81,11098,0,0,0,0
heartofazeroth-slot-minor-glass,9139,1452,80,80,1963,2043,83,163,11099,0,0,0,0
heartofazeroth-slot-minor-glow,9140,1452,158,157,1806,1964,1255,1412,11100,0,0,0,0
heartofazeroth-slot-minor-ring,9141,1452,80,80,1963,2043,165,245,11101,0,0,0,0
heartofazeroth-orb-glass,9142,1452,440,440,1596,2036,813,1253,11102,0,0,0,0
heartofazeroth-orb-shadow,9143,1452,440,440,862,1302,1564,2004,11103,0,0,0,0
heartofazeroth-slot-minor-unlearned-bottomleft,9145,1452,200,200,405,605,1804,2004,11104,0,0,0,0
heartofazeroth-slot-minor-unlearned-topright,9146,1452,200,200,607,807,1804,2004,11105,0,0,0,0
heartofazeroth-orb-activated,9147,1452,800,800,975,1775,1,801,11106,0,0,0,0
heartofazeroth-list-item-glow,9148,1452,412,136,1,413,1666,1802,11107,0,0,0,0
loottoast-itemborder-shadow,9149,332,68,68,557,625,218,286,11108,0,0,0,0
heartofazeroth-list-item-highlight,9151,1452,356,82,1304,1660,1564,1646,11110,0,0,0,0
heartofazeroth-orb-ring,9158,1452,859,851,1,860,813,1664,11117,0,0,0,0
mountequipment-background,9159,1453,382,98,1,383,1,99,11118,0,0,0,1
mountequipment-slot-background,9160,1453,138,138,1,139,173,311,11119,0,0,0,1
mountequipment-slot-corners,9161,1453,134,134,141,275,173,307,11120,0,0,0,1
mountequipment-slot-iconborder,9162,1453,43,43,385,428,1,44,11121,0,0,0,1
mountequipment-insetshadow,9163,1453,273,70,1,274,101,171,11122,0,0,0,1
UI-Frame-Marine-Corner,9164,1454,166,166,1,167,761,927,12666,0,0,0,0
UI-Frame-Marine-CardParchmentWider,9165,1454,515,438,257,772,361,799,11124,0,0,0,0
UI-Frame-Marine-Portrait,9166,1454,205,109,774,979,361,470,11125,0,0,0,0
UI-Frame-Marine-PortraitDisable,9167,1454,205,109,774,979,472,581,11126,0,0,0,0
UI-Frame-Marine-CornerBottomLeft,9168,1454,166,166,817,983,152,318,12664,0,0,0,0
UI-Frame-Marine-Ribbon,9169,1454,281,84,257,538,801,885,11128,0,0,0,0
UI-Frame-Marine-PortraitWiderDisable,9170,1454,390,207,540,930,801,1008,11129,0,0,0,0
UI-Frame-Marine-PortraitWider,9171,1454,390,207,257,647,152,359,11130,0,0,0,0
UI-Frame-Marine-CornerBottomRight,9172,1454,166,166,649,815,152,318,12665,0,0,0,0
_UI-Frame-Marine-TileBottom,9173,1454,256,30,0,256,1,31,12668,0,0,4,0
UI-Frame-Marine-TitleLeft,9174,1454,202,85,774,976,670,755,11133,0,0,0,0
UI-Frame-Marine-CardParchment,9175,1454,254,439,1,255,152,591,11134,0,0,0,0
UI-Frame-Marine-TitleRight,9176,1454,202,85,774,976,583,668,11135,0,0,0,0
_UI-Frame-Marine-TitleMiddle,9177,1454,128,85,0,128,65,150,11136,0,0,4,0
_UI-Frame-Marine-TileTop,9178,1454,256,30,0,256,33,63,12669,0,0,4,0
UI-Frame-Marine-CornerTopRight,9179,1454,166,166,1,167,593,759,12667,0,0,0,0
UI-Frame-Marine-ExitButtonBorder,9180,1454,33,32,169,202,593,625,11139,0,0,0,0
UI-Frame-Marine-BackgroundTile,9181,1455,256,256,0,256,0,256,11140,0,0,6,0
!UI-Frame-Marine-TileLeft,9182,1456,30,256,1,31,0,256,12670,0,0,2,0
!UI-Frame-Marine-TileRight,9183,1456,30,256,33,63,0,256,12671,0,0,2,0
mountequipment-slot-corners-open,9184,1453,134,138,1,135,313,451,11143,0,0,0,1
UI-Frame-Marine-DisableSubtitle,9185,1454,207,30,1,208,929,959,11144,0,0,0,0
UI-Frame-Marine-Subtitle,9186,1454,207,30,1,208,961,991,11145,0,0,0,0
heartofazeroth-animation-ring-constellation,9187,1457,600,600,736,1336,1,601,11146,0,0,0,0
heartofazeroth-animation-stars,9188,1457,512,512,1338,1850,1,513,11147,0,0,0,0
common-iconmask,9189,1458,64,64,0,64,0,64,11148,0,0,16,0
friendslist-favorite,9190,1459,17,17,1,18,1,18,11149,0,0,0,0
heartofazeroth-animation-ring,9194,1457,511,476,1,512,907,1383,11114,0,0,0,0
heartofazeroth-animation-rune4,9196,1457,300,300,1118,1418,907,1207,11116,0,0,0,0
store-card-splash1-nobanner,9198,1460,576,471,1,577,1,472,11153,0,0,0,0
brewfest-chowdown_1,9203,1461,128,146,1,129,1,147,11158,0,0,0,0
brewfest-chowdown_2,9204,1461,128,146,1,129,149,295,11159,0,0,0,0
brewfest-chowdown_3,9205,1461,128,146,1,129,297,443,11160,0,0,0,0
brewfest-chowdown_4,9206,1461,128,146,131,259,1,147,11161,0,0,0,0
heartofazeroth-animation-lensflareline,9207,1457,1367,187,1,1368,718,905,11162,0,0,0,0
heartofazeroth-animation-glowies,9208,1457,733,715,1,734,1,716,11163,0,0,0,0
socket-blue-background,9209,1462,43,43,462,505,1,44,11164,0,0,0,0
socket-blue-closed,9210,1462,52,53,124,176,1,54,11165,0,0,0,0
socket-blue-open,9211,1462,60,57,1,61,1,58,11166,0,0,0,0
socket-cogwheel-background,9212,1462,43,44,282,325,1,45,11167,0,0,0,0
socket-cogwheel-closed,9213,1462,49,47,178,227,107,154,11168,0,0,0,0
socket-cogwheel-open,9214,1462,49,47,178,227,156,203,11169,0,0,0,0
socket-hydraulic-background,9215,1462,43,43,282,325,47,90,11170,0,0,0,0
socket-hydraulic-closed,9216,1462,59,54,63,122,1,55,11171,0,0,0,0
socket-hydraulic-open,9217,1462,59,54,63,122,57,111,11172,0,0,0,0
socket-meta-background,9218,1462,58,53,63,121,113,166,11173,0,0,0,0
socket-meta-closed,9219,1462,52,53,124,176,56,109,11174,0,0,0,0
socket-meta-open,9220,1462,60,57,1,61,60,117,11175,0,0,0,0
socket-prismatic-background,9221,1462,43,43,282,325,92,135,11176,0,0,0,0
socket-prismatic-closed,9222,1462,43,43,282,325,137,180,11177,0,0,0,0
socket-prismatic-open,9223,1462,43,43,282,325,182,225,11178,0,0,0,0
socket-punchcard-blue-background,9224,1462,43,44,327,370,1,45,11179,0,0,0,0
socket-punchcard-blue-closed,9225,1462,49,47,178,227,205,252,11180,0,0,0,0
socket-punchcard-blue-open,9226,1462,49,47,231,280,1,48,11181,0,0,0,0
socket-punchcard-red-background,9227,1462,43,44,372,415,1,45,11182,0,0,0,0
socket-punchcard-red-closed,9228,1462,49,47,231,280,50,97,11183,0,0,0,0
socket-punchcard-red-open,9229,1462,49,47,231,280,99,146,11184,0,0,0,0
socket-punchcard-yellow-background,9230,1462,43,44,417,460,1,45,11185,0,0,0,0
socket-punchcard-yellow-closed,9231,1462,49,47,231,280,148,195,11186,0,0,0,0
socket-punchcard-yellow-open,9232,1462,49,47,231,280,197,244,11187,0,0,0,0
socket-red-background,9233,1462,43,43,327,370,47,90,11188,0,0,0,0
socket-red-closed,9234,1462,52,53,124,176,111,164,11189,0,0,0,0
socket-red-open,9235,1462,60,57,1,61,119,176,11190,0,0,0,0
socket-yellow-background,9236,1462,43,43,372,415,47,90,11191,0,0,0,0
socket-yellow-closed,9237,1462,52,54,63,115,168,222,11192,0,0,0,0
socket-yellow-open,9238,1462,60,57,1,61,178,235,11193,0,0,0,0
heartofazeroth-slot-yellowglow,9239,1452,102,102,1806,1908,1414,1516,11194,0,0,0,0
worldstate-capturebar-frame-lfd,9240,901,173,26,1,174,667,693,11195,0,0,0,0
worldstate-capturebar-leftfill-factions,9243,901,4,9,0,4,267,276,11198,0,0,4,0
worldstate-capturebar-leftfill-lfd,9244,901,4,9,0,4,278,287,11199,0,0,4,0
worldstate-capturebar-rightfill-factions,9245,901,4,9,0,4,377,386,11200,0,0,4,0
worldstate-capturebar-rightfill-lfd,9246,901,4,9,0,4,388,397,11201,0,0,4,0
worldstate-capturebar-spark-factions,9247,901,5,18,228,233,499,517,11202,0,0,0,0
worldstate-capturebar-spark-lfd,9248,901,5,18,235,240,499,517,11203,0,0,0,0
worldstate-capturebar-leftfill-boss,9249,901,4,9,0,4,256,265,11204,0,0,4,0
worldstate-capturebar-rightfill-boss,9250,901,4,9,0,4,366,375,11205,0,0,4,0
worldstate-capturebar-spark-boss,9251,901,5,18,221,226,499,517,11206,0,0,0,0
worldstate-capturebar-frame-boss,9252,901,130,25,1,131,722,747,11207,0,0,0,0
worldstate-capturebar-leftglow-boss,9254,901,135,24,1,136,776,800,11209,0,0,0,0
worldstate-capturebar-leftglow-factions,9255,901,27,28,194,221,421,449,11210,0,0,0,0
worldstate-capturebar-leftglow-lfd,9256,901,27,28,165,192,460,488,11211,0,0,0,0
worldstate-capturebar-rightglow-factions,9257,901,27,28,1,28,862,890,11212,0,0,0,0
worldstate-capturebar-rightglow-lfd,9258,901,27,28,1,28,922,950,11213,0,0,0,0
worldstate-capturebar-neutralfill-boss,9259,901,4,9,0,4,311,320,11214,0,0,4,0
worldstate-capturebar-neutralfill-factions,9260,901,4,9,0,4,322,331,11215,0,0,4,0
worldstate-capturebar-neutralfill-lfd,9261,901,4,9,0,4,333,342,11216,0,0,4,0
BfAMission-Icon-DeepSea,9262,1096,80,80,165,245,83,163,11217,0,0,0,0
common-roundhighlight,9263,1463,114,114,1,115,1,115,11218,0,0,0,0
heartofazeroth-node-glow,9264,1452,48,47,1963,2011,361,408,11219,0,0,0,0
heartofazeroth-node-off,9265,1452,38,48,1963,2001,410,458,11220,0,0,0,0
heartofazeroth-node-on,9266,1452,38,48,2003,2041,410,458,11221,0,0,0,0
heartofazeroth-node-shadow,9267,1452,46,50,1963,2009,309,359,11222,0,0,0,0
heartofazeroth-list-item-selected,9268,1452,356,82,1662,2018,1564,1646,11223,0,0,0,0
heartofazeroth-animation-rune1,9270,1457,290,290,1722,2012,1209,1499,11109,0,0,0,0
heartofazeroth-animation-rune2,9272,1457,286,286,1420,1706,1511,1797,11111,0,0,0,0
heartofazeroth-animation-rune3,9274,1457,300,300,816,1116,1511,1811,11226,0,0,0,0
UI-Frame-GenericMetal-Corner,9275,1464,166,166,1,167,65,231,11227,0,0,0,0
UI-Frame-GenericMetal-ExitButtonBorder,9276,1464,33,32,169,202,65,97,11228,0,0,0,0
_UI-Frame-GenericMetal-TileBottom,9277,1464,256,30,0,256,1,31,12481,0,0,4,0
_UI-Frame-GenericMetal-TileTop,9278,1464,256,30,0,256,33,63,12482,0,0,4,0
!UI-Frame-GenericMetal-TileLeft,9279,1465,30,256,1,31,0,256,12483,0,0,2,0
!UI-Frame-GenericMetal-TileRight,9280,1465,30,256,33,63,0,256,12484,0,0,2,0
heartofazeroth-slot-minor-unactivated,9281,1452,60,60,1963,2023,247,307,11233,0,0,0,0
heartofazeroth-slot-minor-unactivated-rune,9282,1452,92,98,1304,1396,1732,1830,11234,0,0,0,0
tooltip-heartofazerothessence-major,9283,1466,18,12,1,19,1,13,11235,0,0,0,0
tooltip-heartofazerothessence-minor,9284,1466,18,12,1,19,15,27,11236,0,0,0,0
shop-card-full-gametimebundle4,9285,1467,568,463,1,569,1,464,11237,0,0,0,0
ColumnIcon-FlagCapture0,9286,1468,32,32,1,33,1,33,11238,0,0,0,0
ColumnIcon-FlagCapture1,9287,1468,32,32,35,67,1,33,11239,0,0,0,0
ColumnIcon-FlagCapture2,9288,1468,32,32,69,101,1,33,11240,0,0,0,0
ColumnIcon-FlagReturn0,9289,1468,32,32,1,33,35,67,11241,0,0,0,0
ColumnIcon-FlagReturn1,9290,1468,32,32,1,33,69,101,11242,0,0,0,0
ColumnIcon-GraveyardCapture0,9291,1468,16,16,103,119,1,17,11243,0,0,0,0
ColumnIcon-GraveyardCapture1,9292,1468,16,16,1,17,103,119,11244,0,0,0,0
ColumnIcon-GraveyardDefend0,9293,1468,16,16,35,51,35,51,11245,0,0,0,0
ColumnIcon-GraveyardDefend1,9294,1468,16,16,53,69,35,51,11246,0,0,0,0
ColumnIcon-MineCapture0,9295,1468,16,16,71,87,35,51,11247,0,0,0,0
ColumnIcon-MineCapture1,9296,1468,16,16,89,105,35,51,11248,0,0,0,0
ColumnIcon-TowerCapture0,9297,1468,16,16,107,123,35,51,11249,0,0,0,0
ColumnIcon-TowerCapture1,9298,1468,16,16,35,51,53,69,11250,0,0,0,0
ColumnIcon-TowerDefend0,9299,1468,16,16,35,51,71,87,11251,0,0,0,0
ColumnIcon-TowerDefend1,9300,1468,16,16,35,51,89,105,11252,0,0,0,0
azsharawards-state1-fill,9321,1469,60,59,1,61,374,433,11273,0,0,0,0
azsharawards-state1-zone1-cap,9323,1469,60,59,1,61,435,494,11275,0,0,0,0
azsharawards-state1-zone1,9324,1469,60,59,63,123,374,433,11276,0,0,0,0
azsharawards-state1-zone2-cap,9325,1469,60,59,134,194,132,191,11277,0,0,0,0
azsharawards-state1-zone2,9326,1469,60,59,63,123,435,494,11278,0,0,0,0
azsharawards-state1-zone3-cap,9327,1469,60,59,258,318,132,191,11279,0,0,0,0
azsharawards-state1-zone3,9328,1469,60,59,196,256,132,191,11280,0,0,0,0
azsharawards-state1-zone4-cap,9329,1469,60,59,382,442,132,191,11281,0,0,0,0
azsharawards-state1-zone4,9330,1469,60,59,320,380,132,191,11282,0,0,0,0
azsharawards-state2-fill,9331,1469,60,59,444,504,132,191,11283,0,0,0,0
azsharawards-state2-zone1-cap,9333,1469,60,59,134,194,254,313,11285,0,0,0,0
azsharawards-state2-zone1,9334,1469,60,59,134,194,193,252,11286,0,0,0,0
azsharawards-state2-zone2-cap,9335,1469,60,59,134,194,376,435,11287,0,0,0,0
azsharawards-state2-zone2,9336,1469,60,59,134,194,315,374,11288,0,0,0,0
azsharawards-state2-zone3-cap,9337,1469,60,59,196,256,193,252,11289,0,0,0,0
azsharawards-state2-zone3,9338,1469,60,59,134,194,437,496,11290,0,0,0,0
azsharawards-state2-zone4-cap,9339,1469,60,59,320,380,193,252,11291,0,0,0,0
azsharawards-state2-zone4,9340,1469,60,59,258,318,193,252,11292,0,0,0,0
azsharawards-fullglow,9341,1469,60,59,407,467,62,121,11293,0,0,0,0
azsharawards-state1-fillingglow,9344,1469,107,107,298,405,1,108,11296,0,0,0,0
azsharawards-state2-fillingglow,9345,1469,107,107,1,108,265,372,11297,0,0,0,0
azsharawards-fallingglow,9348,1469,60,59,407,467,1,60,11295,0,0,0,0
LoadingScreen-LeftBookend,9349,1470,350,1154,1,351,1,1155,11300,0,0,0,0
LoadingScreen-Gradient,9350,1470,256,256,1,257,1157,1413,11301,0,0,0,0
LoadingScreen-BottomFill,9352,1472,1127,643,1,1128,1,644,11303,0,0,0,0
LoadingScreen-BottomInner,9353,1473,455,51,0,455,617,668,11304,0,0,4,0
LoadingScreen-BottomLeftInner,9354,1473,256,512,0,256,1,513,11305,0,0,4,0
LoadingScreen-BottomOuter,9355,1473,400,100,0,400,515,615,11306,0,0,4,0
LoadingScreen-leftBackground,9356,1474,2000,1968,1,2001,1,1969,11307,0,0,0,0
LoadingScreen-RightBackground,9357,1475,2000,1793,1,2001,1,1794,11308,0,0,0,0
LoadingScreen-SideFill,9358,1476,2000,1967,1,2001,1,1968,11309,0,0,0,0
LoadingScreen-LeftInner,9359,1477,121,500,1,122,1,501,11310,0,0,0,0
heartofazeroth-tooltip-dash-major,9360,1478,8,4,1,9,7,11,11311,0,0,0,0
heartofazeroth-tooltip-dash-minor,9361,1478,8,4,11,19,1,5,11312,0,0,0,0
_GarrMissionLocation-Mechagon-Mid,9362,1479,1024,285,0,1024,1,286,11313,0,0,4,0
_GarrMissionLocation-Nazjatar-Mid,9363,1480,1024,285,0,1024,1,286,11314,0,0,4,0
splash-820-botleft,9364,1481,137,371,374,511,587,958,11315,0,0,0,0
splash-820-right,9365,1481,510,584,1,511,1,585,11316,0,0,0,0
splash-820-topleft,9366,1481,371,434,1,372,587,1021,11317,0,0,0,0
splash-8202-botleft,9367,1482,137,371,374,511,587,958,11318,0,0,0,0
splash-8202-topleft,9368,1482,371,434,1,372,587,1021,11319,0,0,0,0
splash-8202-right,9369,1482,510,584,1,511,1,585,11320,0,0,0,0
mechagon-projects,9370,647,32,32,411,443,885,917,11321,0,0,0,0
azsharawards-fallingglow-bg,9371,1469,115,115,181,296,1,116,11322,0,0,0,0
azsharawards-lines,9372,1469,178,129,1,179,1,130,11323,0,0,0,0
azsharawards-starglow,9373,1469,131,131,1,132,132,263,11324,0,0,0,0
heartofazeroth-tooltip-dash-gray,9374,1478,8,4,1,9,1,5,11325,0,0,0,0
minimaptrident,9376,647,16,16,588,604,107,123,11327,0,0,0,0
questdaily-mainmap,9377,647,32,32,479,511,987,1019,11328,0,0,0,0
questrepeatableturnin-mainmap,9378,647,32,32,649,681,511,543,11329,0,0,0,0
UI-Frame-Mechagon-Corner,9379,1483,166,166,1,167,593,759,12676,0,0,0,0
UI-Frame-Mechagon-PortraitWiderDisable,9380,1483,390,207,257,647,592,799,11331,0,0,0,0
UI-Frame-Mechagon-CardParchment,9381,1483,254,439,1,255,152,591,11332,0,0,0,0
UI-Frame-Mechagon-ExitButtonBorder,9382,1483,33,32,169,202,593,625,11333,0,0,0,0
UI-Frame-Mechagon-TitleRight,9383,1483,202,85,774,976,263,348,11334,0,0,0,0
_UI-Frame-Mechagon-TitleMiddle,9384,1483,128,85,0,128,1,86,11335,0,0,4,0
UI-Frame-Mechagon-TitleLeft,9385,1483,202,85,1,203,936,1021,11336,0,0,0,0
UI-Frame-Mechagon-PortraitWider,9386,1483,390,207,257,647,801,1008,11337,0,0,0,0
_UI-Frame-Mechagon-TileBottom,9387,1483,256,30,0,256,88,118,12677,0,0,4,0
_UI-Frame-Mechagon-TileTop,9388,1483,256,30,0,256,120,150,12678,0,0,4,0
UI-Frame-Mechagon-PortraitDisable,9389,1483,205,109,1,206,793,902,11340,0,0,0,0
UI-Frame-Mechagon-Portrait,9390,1483,205,109,774,979,152,261,11341,0,0,0,0
UI-Frame-Mechagon-CardParchmentWider,9391,1483,515,438,257,772,152,590,11342,0,0,0,0
UI-Frame-Mechagon-BackgroundTile,9392,1484,256,256,0,256,0,256,11343,0,0,6,0
!UI-Frame-Mechagon-TileLeft,9393,1485,30,256,1,31,0,256,12679,0,0,2,0
!UI-Frame-Mechagon-TileRight,9394,1485,30,256,33,63,0,256,12680,0,0,2,0
UI-Frame-Mechagon-DisableSubtitle,9395,1483,207,30,1,208,761,791,11346,0,0,0,0
UI-Frame-Mechagon-Subtitle,9396,1483,207,30,1,208,904,934,11347,0,0,0,0
UI-Frame-Mechagon-Ribbon,9397,1483,281,84,649,930,592,676,11348,0,0,0,0
Healing_Backing,9406,695,52,53,807,859,67,120,11357,0,0,0,0
Healing_Red,9407,695,37,37,1,38,263,300,11358,0,0,0,0
Frame_Timer,9409,695,122,72,843,965,197,269,11360,0,0,0,0
powerswirlanimation-bluering,9410,1486,142,142,1,143,1,143,11361,0,0,0,0
powerswirlanimation-spinningglowys,9411,1486,70,70,415,485,1,71,11362,0,0,0,0
powerswirlanimation-starburst,9412,1486,133,133,145,278,1,134,11363,0,0,0,0
powerswirlanimation-whirls,9413,1486,149,105,136,285,145,250,11364,0,0,0,0
powerswirlanimation-whitestarburst,9414,1486,133,133,1,134,145,278,11365,0,0,0,0
powerswirlanimation-yellowring,9415,1486,100,100,1,101,280,380,11366,0,0,0,0
heartofazeroth-animation-sunburst,9417,1452,732,749,862,1594,813,1562,11113,0,0,0,0
heartofazeroth-animation-rune10,9418,1457,300,300,1,301,1385,1685,11368,0,0,0,0
heartofazeroth-animation-rune11,9419,1457,300,300,1,301,1687,1987,11369,0,0,0,0
heartofazeroth-animation-rune8,9420,1457,300,300,1118,1418,1511,1811,11370,0,0,0,0
heartofazeroth-animation-rune5,9421,1457,300,300,1420,1720,907,1207,11371,0,0,0,0
heartofazeroth-animation-rune9,9422,1457,300,300,1420,1720,1209,1509,11372,0,0,0,0
heartofazeroth-animation-rune6,9423,1457,300,300,1722,2022,907,1207,11373,0,0,0,0
heartofazeroth-animation-rune7,9424,1457,300,300,1118,1418,1209,1509,11374,0,0,0,0
heartofazeroth-animation-rune13,9425,1457,300,300,514,814,1209,1509,11375,0,0,0,0
heartofazeroth-animation-rune12,9426,1457,300,300,514,814,907,1207,11376,0,0,0,0
heartofazeroth-animation-rune14,9427,1457,300,300,514,814,1511,1811,11377,0,0,0,0
heartofazeroth-animation-rune15,9428,1457,300,300,816,1116,907,1207,11378,0,0,0,0
heartofazeroth-tooltip-dash-white,9429,1478,8,4,21,29,1,5,11379,0,0,0,0
heartofazeroth-tooltip-dash-yellow,9430,1478,8,4,11,19,7,11,11380,0,0,0,0
heartofazeroth-animation-rune16,9431,1457,300,300,816,1116,1209,1509,11381,0,0,0,0
shop-card-full-15thAnniversary,9438,1489,568,463,1,569,1,464,11388,0,0,0,0
Upgrade-Bottom-Tile,9439,1487,32,10,0,32,1,11,11389,0,0,4,0
Upgrade-Top-Tile,9440,1487,32,10,0,32,13,23,11390,0,0,4,0
Upgrade-Bottom-Right-Corner,9441,1488,27,25,1,28,81,106,11391,0,0,0,0
Upgrade-Frame-Metal,9442,1488,78,78,1,79,1,79,11392,0,0,0,0
Upgrade-Right-Tile,9443,1488,9,32,81,90,63,95,11393,0,0,0,0
Upgrade-Top-Right-Corner,9444,1488,27,25,30,57,81,106,11394,0,0,0,0
Upgrade-Highlight,9445,1488,60,60,81,141,1,61,11395,0,0,0,0
islands-queue-card-crestfall-dragon,9446,1490,412,268,415,827,1,269,11396,0,0,0,0
islands-queue-card-crestfall-orc,9447,1490,412,268,1,413,271,539,11397,0,0,0,0
islands-queue-card-crestfall,9448,1490,412,268,1,413,1,269,11398,0,0,0,0
islands-queue-card-snowblossom-mantid,9456,1491,412,268,415,827,1,269,11399,0,0,0,0
islands-queue-card-snowblossom,9458,1491,412,268,1,413,1,269,11401,0,0,0,0
islands-queue-card-crestfall-pirates,9459,1490,412,268,415,827,271,539,11402,0,0,0,0
islands-queue-card-snowblossom-mogu,9460,1491,412,268,1,413,271,539,11403,0,0,0,0
islands-queue-card-snowblossom-vermin,9461,1491,412,268,415,827,271,539,11404,0,0,0,0
heartofazeroth-slot-major-shadow,9462,1457,208,184,1338,1546,515,699,11097,0,0,0,0
heartofazeroth-animation-titans,9465,1452,972,810,1,973,1,811,11405,0,0,0,0
heartofazeroth-list-background,9466,1452,184,473,1777,1961,1,474,11086,0,0,0,0
GarrMissionLocation-Mechagon-List,9467,1295,792,78,795,1587,561,639,11406,0,0,0,0
GarrMissionLocation-Nazjatar-List,9468,1295,792,78,1,793,641,719,11407,0,0,0,0
nazjatar-nagaevent,9469,647,32,32,615,647,443,475,11408,0,0,0,0
brewfest-shield_1,9470,1461,128,144,261,389,1,145,11409,0,0,0,0
brewfest-shield_2,9471,1461,128,144,131,259,149,293,11410,0,0,0,0
brewfest-shield_3,9472,1461,128,144,131,259,295,439,11411,0,0,0,0
brewfest-shield_4,9473,1461,128,144,261,389,149,293,11412,0,0,0,0
azsharawards-red-fill,9474,1469,60,59,382,442,193,252,11413,0,0,0,0
auctionhouse-itemicon-border-account,9488,1495,136,136,687,823,1,137,11425,0,0,0,0
auctionhouse-itemicon-border-artifact,9489,1495,136,136,825,961,1,137,11420,0,0,0,0
auctionhouse-itemicon-border-blue,9490,1495,136,136,293,429,215,351,11422,0,0,0,0
auctionhouse-itemicon-border-gray,9491,1495,136,136,293,429,353,489,11426,0,0,0,0
auctionhouse-itemicon-border-green,9492,1495,136,136,431,567,215,351,11424,0,0,0,0
auctionhouse-itemicon-border-orange,9493,1495,136,136,431,567,353,489,11423,0,0,0,0
auctionhouse-itemicon-border-purple,9494,1495,136,136,569,705,215,351,11418,0,0,0,0
auctionhouse-itemicon-border-white,9495,1495,136,136,569,705,353,489,11419,0,0,0,0
auctionhouse-itemicon-cover,9496,1495,64,64,919,983,147,211,11421,0,0,0,0
auctionhouse-icon-checkmark,9497,1495,18,22,1005,1023,259,281,11427,9,11,0,0
auctionhouse-itemheaderframe,9498,1495,684,144,1,685,1,145,11428,342,72,0,0
auctionhouse-ui-inputfield-left,9499,1495,16,66,985,1001,147,213,11429,8,33,0,0
auctionhouse-ui-inputfield-middle,9500,1495,356,66,293,649,147,213,11430,178,33,0,0
auctionhouse-ui-inputfield-right,9501,1495,16,66,1003,1019,147,213,11431,8,33,0,0
auctionhouse-ui-dropdown-arrow-disabled,9502,1495,27,26,953,980,303,329,11432,0,0,0,0
auctionhouse-ui-dropdown-arrow-down,9503,1495,27,26,982,1009,303,329,11433,0,0,0,0
auctionhouse-ui-dropdown-arrow-up,9504,1495,27,26,953,980,347,373,11434,0,0,0,0
auctionhouse-ui-dropdown-left,9505,1495,14,34,1005,1019,49,83,11435,0,0,0,0
auctionhouse-ui-dropdown-middle,9506,1495,83,34,809,892,391,425,11436,0,0,0,0
auctionhouse-ui-dropdown-right,9507,1495,14,34,1005,1019,87,121,11437,0,0,0,0
auctionhouse-icon-socket,9508,1495,14,14,275,289,484,498,11438,0,0,0,0
auctionhouse-icon-favorite,9509,1495,40,36,963,1003,49,85,11439,0,0,0,0
auctionhouse-nav-button-highlight,9511,1495,264,42,707,971,215,257,11441,0,0,0,0
auctionhouse-nav-button-select,9512,1495,264,42,707,971,259,301,11442,0,0,0,0
auctionhouse-nav-button,9516,1495,272,64,1,273,439,503,11446,0,0,0,0
auctionhouse-itemicon-small-border,9517,1495,32,32,973,1005,215,247,11447,0,0,0,0
auctionhouse-rowstripe-1,9518,1495,16,18,1007,1023,125,143,11448,0,0,0,0
auctionhouse-rowstripe-2,9519,1495,16,18,275,291,439,457,11449,0,0,0,0
auctionhouse-icon-coin-copper,9520,1495,20,20,963,983,125,145,11450,0,0,0,0
auctionhouse-icon-coin-gold,9521,1495,20,20,985,1005,125,145,11451,0,0,0,0
auctionhouse-icon-coin-silver,9522,1495,20,20,991,1011,391,411,11452,0,0,0,0
auctionhouse-nav-button-secondary-highlight,9523,1495,244,42,707,951,303,345,11453,0,0,0,0
auctionhouse-nav-button-secondary-select,9524,1495,244,42,707,951,347,389,11454,0,0,0,0
auctionhouse-nav-button-secondary,9525,1495,266,64,651,917,147,211,11455,0,0,0,0
auctionhouse-nav-button-tertiary-filterline,9528,1495,5,11,286,291,459,470,11458,0,0,0,0
auctionhouse-ui-loadingspinner,9529,1495,290,290,1,291,147,437,11459,0,0,0,0
auctionhouse-itemicon-empty,9530,1495,100,100,707,807,391,491,11460,0,0,0,0
auctionhouse-ui-row-highlight,9531,1495,116,18,293,409,491,509,11461,0,0,0,0
auctionhouse-ui-row-select,9532,1495,116,18,569,685,491,509,11462,0,0,0,0
auctionhouse-background-auctions,9539,1499,595,314,370,965,1,315,11464,0,0,0,0
auctionhouse-background-buy-commodities-market,9540,1499,221,396,1508,1729,400,796,11465,0,0,0,0
auctionhouse-background-buy-commodities,9541,1499,367,396,1,368,1,397,11466,0,0,0,0
auctionhouse-background-buy-noncommodities-header,9542,1499,617,81,370,987,317,398,11467,0,0,0,0
auctionhouse-background-buy-noncommodities-market,9543,1499,595,277,967,1562,1,278,11468,0,0,0,0
auctionhouse-background-categories,9544,1499,138,433,1731,1869,400,833,11469,0,0,0,0
auctionhouse-background-index,9545,1499,595,413,370,965,400,813,11470,0,0,0,0
auctionhouse-background-sell-left,9546,1499,357,437,1,358,399,836,11471,0,0,0,0
auctionhouse-background-sell-right,9547,1499,399,418,1107,1506,400,818,11472,0,0,0,0
auctionhouse-icon-favorite-off,9548,1495,40,36,963,1003,87,123,11473,0,0,0,0
helptip-arrow,9549,1500,65,28,1,66,1,29,11474,0,0,0,0
helptip-arrow-mask,9550,1501,64,32,0,64,0,32,11475,0,0,16,0
ui-frame-diamondmetal-cornerbottomleft-2x,9551,1502,128,128,1,129,261,389,7688,64,64,0,2
ui-frame-diamondmetal-cornerbottomright-2x,9552,1502,128,128,1,129,391,519,7689,64,64,0,2
ui-frame-diamondmetal-cornertopleft-2x,9553,1502,128,128,1,129,521,649,7690,64,64,0,2
ui-frame-diamondmetal-cornertopright-2x,9554,1502,128,128,1,129,651,779,7691,64,64,0,2
_ui-frame-diamondmetal-edgebottom-2x,9555,1502,128,128,0,128,1,129,7692,64,64,4,2
_ui-frame-diamondmetal-edgetop-2x,9556,1502,128,128,0,128,131,259,7693,64,64,4,2
!ui-frame-diamondmetal-edgeleft-2x,9557,1503,128,128,1,129,0,128,7694,64,64,2,0
!ui-frame-diamondmetal-edgeright-2x,9558,1503,128,128,131,259,0,128,7695,64,64,2,0
ui-frame-diamondmetal-header-cornerleft-2x,9562,1505,128,156,1,129,159,315,11476,64,78,0,0
ui-frame-diamondmetal-header-cornerright-2x,9563,1505,128,156,1,129,317,473,11477,64,78,0,0
_ui-frame-diamondmetal-header-tile-2x,9564,1505,128,156,0,128,1,157,11478,64,78,4,0
CharacterSelection_Alliance_Icon,9565,1506,26,33,1,27,1,34,11479,0,0,0,0
CharacterSelection_Horde_Icon,9566,1506,19,34,29,48,1,35,11480,0,0,0,0
QuestSharing-QuestPane-ModifiersBG,9567,1507,74,42,405,479,79,121,11481,0,0,0,0
QuestSharing-QuestLog-Replay,9568,1507,19,16,89,108,100,116,11482,0,0,0,0
QuestSharing-QuestPane-ModifiersReplayIconOff,9569,1507,20,20,253,273,107,127,11483,0,0,0,0
QuestSharing-QuestLog-Details-ModifiersBG,9570,1507,58,26,253,311,79,105,11484,0,0,0,0
QuestSharing-QuestLog-Loot,9571,1507,20,20,67,87,100,120,11485,0,0,0,0
QuestSharing-QuestLog-Details-ModifiersReplayIconOff,9572,1507,20,20,27,47,107,127,11486,0,0,0,0
QuestSharing-Dialog-Portrait,9573,1507,64,64,1,65,5,69,11487,0,0,0,0
_QuestSharing-Dialog-Line,9574,1507,8,2,0,8,1,3,11488,0,0,4,0
QuestSharing-QuestPane-ModifiersLootIconOff,9575,1507,20,20,313,333,79,99,11489,0,0,0,0
QuestSharing-ReplayIconOn,9576,1507,20,20,313,333,101,121,11490,0,0,0,0
QuestSharing-QuestLog-Details-ModifiersLootIconOff,9577,1507,20,20,1,21,102,122,11491,0,0,0,0
QuestSharing-QuestLog-Padlock,9578,1507,24,29,115,139,97,126,11492,0,0,0,0
questlog-waypoint-finaldestination-questionmark,9579,103,22,33,552,574,933,966,11493,0,0,0,0
worldquest-icon-nzoth,9580,743,32,32,334,366,468,500,11494,18,18,0,0
QuestSharing-ReplayIcon,9581,1507,32,29,371,403,79,108,11495,0,0,0,0
QuestSharing-QuestLog-Background,9582,1507,288,51,161,449,5,56,11496,0,0,0,0
QuestSharing-QuestLog-ButtonHighlight,9583,1507,44,44,161,205,79,123,11497,0,0,0,0
QuestSharing-QuestLog-Button,9584,1507,44,44,115,159,51,95,11498,0,0,0,0
QuestSharing-QuestLog-ButtonPressed,9585,1507,44,44,451,495,5,49,11499,0,0,0,0
shop-card-full-blizzconvirtualticket,9588,1509,568,463,1,569,1,464,11502,0,0,0,0
store-card-horizontalfull,9591,1510,566,225,1,567,455,680,11505,0,0,0,0
store-card-quarter,9592,1510,277,224,569,846,454,678,11506,0,0,0,0
bfa-threats-mapborder,9593,1511,1394,928,1,1395,1,929,11507,0,0,0,0
GM_BehaviorMessage_CornerBottomRight_Glow,9594,1512,23,23,40,63,77,100,11508,0,0,0,0
GM_BehaviorMessage_CornerTopRight_Glow,9595,1512,23,23,40,63,102,125,11509,0,0,0,0
GM_BehaviorMessage_CornerTopRight_Frame,9596,1512,16,16,79,95,26,42,11510,0,0,0,0
GM_BehaviorMessage_CornerTopRight_InnerShadow,9597,1512,16,16,97,113,26,42,11511,0,0,0,0
GM_BehaviorMessage_CornerTopLeft_InnerShadow,9598,1512,16,16,79,95,44,60,11512,0,0,0,0
GM_BehaviorMessage_Circle_Frame,9599,1512,35,35,1,36,77,112,11513,0,0,0,0
GM_BehaviorMessage_CornerTopLeft_Frame,9600,1512,16,16,97,113,44,60,11514,0,0,0,0
GM_BehaviorMessage_CornerBottomLeft_Frame,9601,1512,16,16,79,95,62,78,11515,0,0,0,0
GM_BehaviorMessage_CornerBottomLeft_InnerShadow,9602,1512,16,16,97,113,62,78,11516,0,0,0,0
GM_BehaviorMessage_CornerBottomRight_Frame,9603,1512,16,16,79,95,80,96,11517,0,0,0,0
GM_BehaviorMessage_LeftRoundFrame_OuterShadow,9604,1512,37,74,1,38,1,75,11518,0,0,0,0
GM_BehaviorMessage_CornerBottomRight_InnerShadow,9605,1512,16,16,79,95,98,114,11519,0,0,0,0
GM_BehaviorMessage_LeftRoundFrame_Glow,9606,1512,37,74,40,77,1,75,11520,0,0,0,0
GM_BehaviorMessage_CornerBottomRight_OuterShadow,9607,1512,23,23,79,102,1,24,11521,0,0,0,0
GM_BehaviorMessage_CornerTopRight_OuterShadow,9608,1512,23,23,104,127,1,24,11522,0,0,0,0
_GM_BehaviorMessage_Background,9609,1513,256,44,0,256,1,45,11523,0,0,4,0
_GM_BehaviorMessage_Bottom_Frame,9610,1513,256,3,0,256,125,128,11524,0,0,4,0
_GM_BehaviorMessage_Bottom_Glow,9611,1513,256,13,0,256,47,60,11525,0,0,4,0
_GM_BehaviorMessage_Bottom_InnerShadow,9612,1513,256,7,0,256,107,114,11526,0,0,4,0
_GM_BehaviorMessage_Bottom_OuterShadow,9613,1513,256,13,0,256,62,75,11527,0,0,4,0
_GM_BehaviorMessage_Top_Frame,9614,1513,256,3,0,256,130,133,11528,0,0,4,0
_GM_BehaviorMessage_Top_Glow,9615,1513,256,13,0,256,77,90,11529,0,0,4,0
_GM_BehaviorMessage_Top_InnerShadow,9616,1513,256,7,0,256,116,123,11530,0,0,4,0
_GM_BehaviorMessage_Top_OuterShadow,9617,1513,256,13,0,256,92,105,11531,0,0,4,0
!GM_BehaviorMessage_Left_Frame,9618,1514,3,256,49,52,0,256,11532,0,0,2,0
!GM_BehaviorMessage_Left_InnerShadow,9619,1514,7,256,31,38,0,256,11533,0,0,2,0
!GM_BehaviorMessage_Right_Frame,9620,1514,3,256,54,57,0,256,11534,0,0,2,0
!GM_BehaviorMessage_Right_Glow,9621,1514,13,256,1,14,0,256,11535,0,0,2,0
!GM_BehaviorMessage_Right_InnerShadow,9622,1514,7,256,40,47,0,256,11536,0,0,2,0
!GM_BehaviorMessage_Right_OuterShadow,9623,1514,13,256,16,29,0,256,11537,0,0,2,0
communitiesfinder_card_highlight,9624,1428,578,79,181,759,1,80,11538,0,0,0,0
shop-button-large-down-left,9628,654,20,35,448,468,75,110,11542,0,0,0,0
shop-button-large-down-middle,9629,654,106,35,225,331,123,158,11543,0,0,0,0
shop-button-large-down-right,9630,654,20,35,470,490,75,110,11544,0,0,0,0
shop-button-large-up-left,9631,654,20,35,149,169,199,234,11545,0,0,0,0
shop-button-large-up-middle,9632,654,106,35,333,439,123,158,11546,0,0,0,0
shop-button-large-up-right,9633,654,20,35,171,191,199,234,11547,0,0,0,0
shop-button-large-disabled-left,9634,654,20,35,453,473,35,70,11548,0,0,0,0
shop-button-large-disabled-middle,9635,654,106,35,1,107,212,247,11549,0,0,0,0
shop-button-large-disabled-right,9636,654,20,35,475,495,35,70,11550,0,0,0,0
auctionhouse-ui-filter-redx,9637,1495,46,46,963,1009,1,47,11551,0,0,0,0
recruitafriend_claimpane_sepiaring,9639,1508,64,64,26,90,434,498,11553,0,0,0,0
recruitafriend_rewardpane_cornerbracket_lefttop,9640,1508,29,22,907,936,1,23,11554,0,0,0,0
recruitafriend_rewardpane_cornerbracket_leftbottom,9641,1508,29,22,876,905,1,23,11555,0,0,0,0
recruitafriend_rewardpane_iconbackground,9642,1508,39,39,534,573,32,71,11556,0,0,0,0
recruitafriend_rewardpane_checkmark,9643,1508,16,14,1,17,77,91,11557,0,0,0,0
recruitafriend_claimpane_cornerbracket_rightbottom,9644,1508,23,17,1,24,1,18,11558,0,0,0,0
recruitafriend_recruitedfriends_openchest,9645,1508,26,18,848,874,1,19,11559,0,0,0,0
recruitafriend_rewardpane_cornerbracket_rightbottom,9646,1508,29,22,964,993,1,23,11560,0,0,0,0
recruitafriend_claimpane_cornerbracket_lefttop,9647,1508,23,17,1,24,58,75,11561,0,0,0,0
recruitafriend_rewardpane_iconborder,9648,1508,35,35,424,459,32,67,11562,0,0,0,0
recruitafriend_recruitedfriends_activechest,9649,1508,26,18,382,408,71,89,11563,0,0,0,0
recruitafriend_rewardpane_iconmask,9651,1508,39,39,575,614,32,71,11565,0,0,0,0
recruitafriend_rewardpane_cornerbracket_righttop,9652,1508,45,45,461,506,32,77,11566,0,0,0,0
recruitafriend_recruitedfriends_lockedchest,9653,1508,26,18,820,846,1,19,11567,0,0,0,0
recruitafriend_claimpane_cornerbracket_leftbottom,9654,1508,23,17,1,24,20,37,11568,0,0,0,0
recruitafriend_recruitedfriends_claimedchest,9657,1508,26,18,764,790,1,19,11571,0,0,0,0
recruitafriend_claimpane_cornerbracket_righttop,9658,1508,23,17,1,24,39,56,11572,0,0,0,0
QuestSharing-Padlock,9659,1507,24,29,1,25,71,100,11573,0,0,0,0
QuestSharing-QuestLog-ButtonPressedStop,9660,1507,44,44,115,159,5,49,11574,0,0,0,0
QuestSharing-QuestLog-ButtonStop,9661,1507,44,44,207,251,79,123,11575,0,0,0,0
QuestSharing-DialogIcon,9662,1507,34,34,27,61,71,105,11576,0,0,0,0
QuestSharing-Stop-DialogIcon,9663,1507,34,34,335,369,79,113,11577,0,0,0,0
recruitafriend_claimpane_goldring,9670,1508,68,68,354,422,1,69,11580,0,0,0,0
recruitafriend_frame_stonedivider,9671,1508,338,29,424,762,1,30,11581,0,0,0,0
recruitafriend_splash_cornerbracket_rightbottom,9672,1508,24,24,424,448,69,93,11582,0,0,0,0
recruitafriend_splash_pictureframe,9673,1508,286,168,733,1019,97,265,11583,0,0,0,0
recruitafriend_splash_cornerbracket_leftbottom,9674,1508,24,24,938,962,1,25,11584,0,0,0,0
recruitafriend_splash_cornerbracket_righttop,9675,1508,24,24,508,532,32,56,11585,0,0,0,0
recruitafriend_splash_cornerbracket_lefttop,9677,1508,24,24,995,1019,1,25,11587,0,0,0,0
poi-nzothpylon,9679,647,31,44,870,901,83,127,11589,0,0,0,0
QuestSharing-DialogIconShadow,9680,1507,46,46,67,113,5,51,11590,0,0,0,0
QuestSharing-QuestLog-Active,9681,1507,45,45,67,112,53,98,11591,0,0,0,0
shop-icon-purchasedcheckmark,9682,654,16,12,487,503,1,13,11592,0,0,0,0
QuestSharing-QuestLog-BottomDetail,9683,1507,260,19,161,421,58,77,11593,0,0,0,0
splash-825-botleft,9684,1516,137,371,374,511,587,958,11594,0,0,0,0
splash-825-right,9685,1516,510,584,1,511,1,585,11595,0,0,0,0
splash-825-topleft,9686,1516,371,434,1,372,587,1021,11596,0,0,0,0
shop-825-1,9687,1510,277,224,1705,1982,1,225,11597,0,0,0,0
shop-825-10,9688,1510,284,201,848,1132,228,429,11598,0,0,0,0
shop-825-2,9689,1510,277,224,1,278,682,906,11599,0,0,0,0
shop-825-3,9690,1510,566,225,1,567,1,226,11600,0,0,0,0
shop-825-4,9691,1510,277,224,280,557,682,906,11601,0,0,0,0
shop-825-5,9692,1510,277,224,569,846,228,452,11602,0,0,0,0
shop-825-6,9693,1510,566,225,569,1135,1,226,11603,0,0,0,0
shop-825-7,9694,1510,566,225,1137,1703,1,226,11604,0,0,0,0
shop-825-8,9695,1510,566,225,1,567,228,453,11605,0,0,0,0
shop-825-9,9696,1510,284,201,848,1132,431,632,11606,0,0,0,0
QuestSharing-QuestDetails-Padlock,9701,1507,20,20,275,295,107,127,11608,0,0,0,0
UI_Editor_Eye_Icon,9702,1521,14,14,1,15,1,15,11609,0,0,0,0
UI-Panel-HideButton-Disabled,9703,1522,32,32,1,33,1,33,11610,0,0,0,0
UI-Panel-HideButton-Down,9704,1522,32,32,35,67,1,33,11611,0,0,0,0
UI-Panel-HideButton-Up,9705,1522,32,32,69,101,1,33,11612,0,0,0,0
UI-Panel-MinimizeButton-Highlight,9706,1522,32,32,1,33,35,67,11613,0,0,0,0
bfa-threats-cornereye,9707,743,242,220,1,243,1,221,11614,0,0,0,0
heartofazeroth-infinite-numberbox,9708,1452,27,26,2011,2038,309,335,11615,0,0,0,0
heartofazeroth-infinite-unlearned,9709,1452,200,200,1,201,1804,2004,11616,0,0,0,0
heartofazeroth-infinite,9710,1452,108,108,1921,2029,692,800,11617,0,0,0,0
raceicon-mechagnome-female,9711,897,64,64,1501,1565,197,261,11618,0,0,0,0
raceicon-mechagnome-male,9712,897,64,64,1567,1631,197,261,11619,0,0,0,0
raceicon-vulpera-female,9713,897,64,64,1369,1433,263,327,11620,0,0,0,0
raceicon-vulpera-male,9714,897,64,64,1435,1499,263,327,11621,0,0,0,0
worldstate-capturebar-frame-target,9715,901,130,25,1,131,749,774,11622,0,0,0,0
worldstate-capturebar-leftfill-target,9716,901,4,9,0,4,289,298,11623,0,0,4,0
worldstate-capturebar-neutralfill-target,9718,901,4,9,0,4,344,353,11625,0,0,4,0
worldstate-capturebar-rightfill-target,9719,901,4,9,0,4,399,408,11626,0,0,4,0
worldstate-capturebar-spark-target,9721,901,5,18,242,247,499,517,11628,0,0,0,0
worldstate-capturebar-neutralglow-target,9722,901,135,25,1,136,695,720,11629,0,0,0,0
bfa-threats-cornereye-background,9723,743,242,220,245,487,1,221,11630,0,0,0,0
recruitafriend_recruitedfriends_cursorover,9724,1508,26,18,354,380,71,89,11631,0,0,0,0
auctionhouse-selltab-left,9725,1495,9,23,1011,1020,1,24,11632,0,0,0,0
auctionhouse-selltab-middle,9726,1495,95,23,894,989,391,414,11633,0,0,0,0
auctionhouse-selltab-right,9727,1495,9,23,275,284,459,482,11634,0,0,0,0
recruitafriend_recruitedfriends_cursoroverchecked,9728,1508,26,18,792,818,1,19,11635,0,0,0,0
talenttree-mother-background,9729,1523,356,443,1,357,1,444,11664,0,0,0,0
auctionhouse-ui-sortarrow,9736,1495,9,9,1011,1020,26,35,11643,0,0,0,0
heartofazeroth-slot-minor-unlearned-3,9737,1452,200,200,203,403,1804,2004,11644,0,0,0,0
auctionhouse-background-summarylist,9738,1499,138,433,967,1105,400,833,11645,0,0,0,0
Cleanse-reforger-background,9739,1524,337,210,1,338,1,211,11646,0,0,0,0
Cleanse-reforger-glow,9740,1524,202,187,1,203,213,400,11647,0,0,0,0
Cleanse-reforger-portrait,9741,1524,58,58,340,398,1,59,11648,0,0,0,0
Nzoth-charactersheet-icon-glow,9742,1525,61,106,64,125,1,107,11649,0,0,0,0
Nzoth-charactersheet-icon,9743,1525,61,106,1,62,1,107,11650,0,0,0,0
Nzoth-charactersheet-item-glow,9744,1525,66,66,127,193,1,67,11651,0,0,0,0
Nzoth-inventory-icon,9745,1526,64,64,1,65,1,65,11652,0,0,0,0
nzoth-tooltip-topper,9746,1527,95,27,1,96,29,56,11653,0,0,0,0
BlizzCon2019Splash-BG,9747,1528,1920,1080,1,1921,1,1081,11654,0,0,0,0
BlizzCon2019Splash-button-playexpansion,9748,1528,555,64,1,556,1083,1147,11655,0,0,0,0
poi-nzothvision,9756,647,68,68,1,69,131,199,11659,34,34,0,0
orderhalltalents-prerequisite-arrow,9757,758,31,23,352,383,123,146,11660,0,0,0,0
orderhalltalents-spellborder-green-large,9758,758,70,70,1,71,155,225,11661,0,0,0,0
orderhalltalents-spellborder-large,9759,758,70,70,1,71,227,297,11662,0,0,0,0
orderhalltalents-spellborder-yellow-large,9760,758,70,70,1,71,299,369,11663,0,0,0,0
orderhalltalents-rankborder-green,9761,758,33,22,468,501,62,84,11665,0,0,0,0
orderhalltalents-rankborder-yellow,9762,758,33,22,468,501,86,108,11666,0,0,0,0
orderhalltalents-rankborder,9763,758,33,22,468,501,38,60,11667,0,0,0,0
NzothScenario-TitleBG,9764,1533,467,141,1,468,1,142,11668,0,0,0,0
NzothScenario-Tracker-frame,9765,1533,243,77,1,244,144,221,11669,0,0,0,0
NzothScenario-TrackerHeader,9766,1533,243,77,246,489,144,221,11670,0,0,0,0
alliedrace-crest-mechagnome,9767,923,64,64,67,131,133,197,11671,0,0,0,0
alliedrace-crest-vulpera,9768,923,64,64,133,197,133,197,11672,0,0,0,0
dg_capPts-leftIcon1-state2,9769,1448,18,18,75,93,103,121,10985,0,0,0,0
dg_capPts-leftIcon5-state1,9770,1448,18,18,95,113,83,101,11673,0,0,0,0
dg_capPts-leftIcon5-state2,9771,1448,18,18,115,133,83,101,11674,0,0,0,0
dg_capPts-rightIcon1-state2,9772,1448,18,18,215,233,83,101,10992,0,0,0,0
dg_capPts-rightIcon5-state1,9773,1448,18,18,95,113,203,221,11675,0,0,0,0
dg_capPts-rightIcon5-state2,9774,1448,18,18,95,113,223,241,11676,0,0,0,0
alliedrace-unlockingframe-modelbackground-mechagnome,9775,942,314,578,633,947,1,579,11677,0,0,0,0
alliedrace-unlockingframe-modelbackground-vulpera,9776,942,314,578,949,1263,1,579,11678,0,0,0,0
transmog-background-race-vulpera,9777,1534,294,494,1,295,1,495,11679,0,0,0,0
transmog-background-race-mechagnome,9778,1535,294,494,1,295,1,495,11680,0,0,0,0
UI-RefreshButton,9792,1522,32,32,1,33,69,101,11694,0,0,0,0
splash-830-botleft,9794,1537,137,371,374,511,587,958,11696,0,0,0,0
splash-830-topleft,9795,1537,371,434,1,372,587,1021,11697,0,0,0,0
splash-830-right,9796,1537,510,584,1,511,1,585,11698,0,0,0,0
splash-8302-botleft,9797,1538,137,371,374,511,587,958,11699,0,0,0,0
splash-8302-right,9798,1538,510,584,1,511,1,585,11700,0,0,0,0
splash-8302-topleft,9799,1538,371,434,1,372,587,1021,11701,0,0,0,0
transmog-background-race-scourge,9800,781,294,494,1,295,1,495,11702,0,0,0,0
charcreatetest-logo-alliance,9802,1539,168,198,1219,1387,1,199,11704,0,0,0,0
charcreatetest-logo-horde,9803,1539,168,198,1219,1387,201,399,11705,0,0,0,0
charcreatetest-tutorialbox-class,9804,1539,852,252,1,853,405,657,11706,0,0,0,0
charcreatetest-tutorialbox-race,9805,1539,1216,402,1,1217,1,403,11707,0,0,0,0
loottoast-nzoth,9806,332,277,98,560,837,118,216,11708,0,0,0,0
common-search-clearbutton,9808,1541,20,20,45,65,85,105,11710,0,0,0,0
common-search-magnifyingglass,9809,1541,24,24,19,43,85,109,11711,0,0,0,0
common-search-border-left,9810,1541,16,40,227,243,43,83,11712,0,0,0,0
common-search-border-middle,9811,1541,224,40,1,225,43,83,11713,0,0,0,0
common-search-border-right,9812,1541,16,40,1,17,85,125,11714,0,0,0,0
shop-card-full-blizzconvirtualticket2020,9813,1542,568,463,1,569,1,464,11715,0,0,0,0
CGuy_AOI,9862,1545,32,32,199,231,1,33,11771,0,0,0,0
CGuy_AOIAsset,9863,1545,32,32,1,33,199,231,11772,0,0,0,0
CGuy_Arrow,9864,1545,64,64,1,65,1,65,11773,0,0,0,0
CGuy_BottomArrow,9865,1545,16,16,233,249,1,17,11774,0,0,0,0
CGuy_BottomArrowHighlight,9866,1545,16,16,199,215,35,51,11775,0,0,0,0
CGuy_ConfigReplace,9867,1545,32,32,169,201,67,99,11776,0,0,0,0
CGuy_Control,9868,1545,32,32,203,235,67,99,11777,0,0,0,0
CGuy_ControlDefaults,9869,1545,32,32,67,99,101,133,11778,0,0,0,0
CGuy_Export,9870,1545,32,32,67,99,135,167,11779,0,0,0,0
CGuy_GafferPushed,9871,1545,64,64,67,131,1,65,11780,0,0,0,0
CGuy_GafferUp,9872,1545,64,64,133,197,1,65,11781,0,0,0,0
CGuy_Import,9873,1545,32,32,101,133,101,133,11782,0,0,0,0
CGuy_New,9874,1545,32,32,135,167,101,133,11783,0,0,0,0
CGuy_NewConfig,9875,1545,32,32,169,201,101,133,11784,0,0,0,0
CGuy_Path,9876,1545,16,16,217,233,35,51,11785,0,0,0,0
CGuy_Pause,9877,1545,64,64,1,65,67,131,11786,0,0,0,0
CGuy_Play,9878,1545,32,32,203,235,101,133,11787,0,0,0,0
CGuy_Point,9879,1545,16,16,235,251,35,51,11788,0,0,0,0
CGuy_Record,9880,1545,32,32,101,133,169,201,11789,0,0,0,0
CGuy_Rename,9881,1545,64,64,1,65,133,197,11790,0,0,0,0
CGuy_Replace,9882,1545,32,32,203,235,135,167,11791,0,0,0,0
CGuy_Stop,9883,1545,32,32,135,167,169,201,11792,0,0,0,0
CGuy_TopArrow,9884,1545,16,16,1,17,233,249,11793,0,0,0,0
CGuy_TopArrowHighlight,9885,1545,16,16,35,51,199,215,11794,0,0,0,0
CGuy_AOIFollowsCamera,9886,1545,32,32,67,99,67,99,11795,0,0,0,0
CGuy_FixedTimeStep,9887,1545,32,32,67,99,169,201,11796,0,0,0,0
CGuy_ReorientToUnit,9888,1545,32,32,135,167,135,167,11797,0,0,0,0
Navigation-Tracked-Arrow,9889,1546,22,18,1,23,36,54,11798,0,0,0,0
Navigation-Tracked-Icon,9890,1546,23,35,29,52,1,36,11799,0,0,0,0
ui-frame-jailerstower-portrait-qualityepic,9897,1549,178,180,861,1039,614,794,11692,0,0,0,0
ui-frame-jailerstower-portrait-qualityrare,9898,1549,178,180,1041,1219,614,794,11688,0,0,0,0
ui-frame-jailerstower-portrait-qualityuncommon,9899,1549,178,180,1291,1469,303,483,11689,0,0,0,0
ui-frame-jailerstower-portrait,9900,1549,178,180,660,838,765,945,11693,0,0,0,0
ui-frame-jailerstower-cardparchment-style2,9902,1549,428,611,431,859,1,612,11806,0,0,0,0
ui-frame-jailerstower-cardparchment-style3,9903,1549,428,611,861,1289,1,612,11807,0,0,0,0
ui-frame-jailerstower-cardparchment-style1,9904,1549,428,611,1,429,1,612,11808,0,0,0,0
ui-frame-jailerstower-rankborder,9905,1549,25,26,280,305,614,640,11809,0,0,0,0
jailerstower-animapowerbutton-normal,9907,1550,253,50,213,466,161,211,11811,0,0,0,0
jailerstower-animapowerbutton-pressed,9908,1550,268,50,703,971,1,51,11812,0,0,0,0
jailerstower-animapowerlist-defense,9909,1550,21,18,1,22,493,511,11813,0,0,0,0
jailerstower-animapowerlist-dropdown-closed,9910,1550,9,14,193,202,379,393,11814,0,0,0,0
jailerstower-animapowerlist-dropdown-closedbg,9911,1550,190,79,1,191,359,438,11815,0,0,0,0
jailerstower-animapowerlist-dropdown-open,9912,1550,14,9,193,207,395,404,11816,0,0,0,0
jailerstower-animapowerlist-dropdown-openbg,9913,1550,190,79,213,403,80,159,11817,0,0,0,0
jailerstower-animapowerlist-offense,9914,1550,22,20,168,190,482,502,11818,0,0,0,0
jailerstower-animapowerlist-rank,9915,1550,23,23,54,77,487,510,11819,0,0,0,0
jailerstower-animapowerlist-utility,9916,1550,19,23,79,98,487,510,11820,0,0,0,0
jailerstower-scenario-death,9917,1550,14,18,193,207,359,377,11821,0,0,0,0
jailerstower-scenario-frame,9918,1550,243,77,213,456,1,78,11822,0,0,0,0
jailerstower-animapowerbutton-normalpressed,9919,1550,253,50,468,721,161,211,11823,0,0,0,0
jailerstower-animapowerlist-bottombg,9921,1550,210,78,1,211,279,357,11825,0,0,0,0
jailerstower-animapowerlist-topbg,9922,1550,210,81,1,211,196,277,11826,0,0,0,0
questlog_divider_normalquests,9924,103,260,37,868,1128,792,829,11827,0,0,0,0
campaign_ardenweald,9925,1552,608,138,1,609,1,139,11828,0,0,0,2
campaign_bastion,9926,1552,608,138,611,1219,1,139,11829,0,0,0,2
campaign_fey,9927,1552,608,138,1221,1829,1,139,11830,0,0,0,2
campaign_kyrian,9928,1552,608,138,1,609,141,279,11831,0,0,0,2
campaign_maldraxxus,9929,1552,608,138,611,1219,141,279,11832,0,0,0,2
campaign_maw,9930,1552,608,138,1221,1829,141,279,11833,0,0,0,2
campaign_necrolord,9931,1552,608,138,1,609,281,419,11834,0,0,0,2
campaign_revendreth,9932,1552,608,138,1221,1829,281,419,11835,0,0,0,2
campaign_venthyr,9933,1552,608,138,1221,1829,421,559,11836,0,0,0,2
jailerstower-scenario-fantasma,9934,1550,20,20,703,723,53,73,11837,0,0,0,0
campaignheader_selectedglow,9935,103,260,58,290,550,933,991,11838,0,0,0,0
campaign_headericon_closed,9936,103,22,22,552,574,968,990,11839,0,0,0,0
campaign_headericon_closedpressed,9937,103,22,22,552,574,993,1015,11840,0,0,0,0
campaign_headericon_open,9938,103,22,22,1130,1152,831,853,11841,0,0,0,0
campaign_headericon_openpressed,9939,103,22,22,916,938,996,1018,11842,0,0,0,0
jailerstower-animapowerbutton-highlight,9941,1550,253,50,675,928,80,130,11844,0,0,0,0
jailerstower-animapowerbutton-pressed-highlight,9942,1550,268,50,405,673,80,130,11845,0,0,0,0
ui-questpoicampaign-innerglow,9944,1555,32,32,67,99,35,67,11847,0,0,0,0
ui-questpoicampaign-outerglow,9945,1555,64,64,1,65,1,65,11848,0,0,0,0
ui-questpoicampaign-questnumber-pressed-supertracked,9950,1555,32,32,135,167,1,33,11853,0,0,0,0
ui-questpoicampaign-questnumber-pressed,9951,1555,32,32,101,133,69,101,11854,0,0,0,0
ui-questpoicampaign-questnumber-supertracked,9952,1555,32,32,169,201,1,33,11855,0,0,0,0
ui-questpoicampaign-questnumber,9953,1555,32,32,101,133,35,67,11856,0,0,0,0
ui-questpoicampaign-questbang,9958,1555,32,32,67,99,69,101,11861,0,0,0,0
ui-questpoicampaign-questbangturnin,9959,1555,32,32,101,133,1,33,11862,0,0,0,0
CGuy_AOIFollowsCameraActive,9961,1545,32,32,101,133,67,99,11864,0,0,0,0
CGuy_FixedTimeStepActive,9962,1545,32,32,67,99,203,235,11865,0,0,0,0
CGuy_PlayActive,9963,1545,32,32,101,133,135,167,11866,0,0,0,0
CGuy_RecordActive,9964,1545,32,32,101,133,203,235,11867,0,0,0,0
CGuy_ReorientToUnitActive,9965,1545,32,32,169,201,135,167,11868,0,0,0,0
CGuy_StopActive,9966,1545,32,32,135,167,203,235,11869,0,0,0,0
CGuy_CalcOrientation,9967,1545,32,32,135,167,67,99,11870,0,0,0,0
ui-frame-jailerstower-hidebutton,9968,1549,277,149,1,278,614,763,11871,0,0,0,0
ui-frame-jailerstower-pendingbutton,9969,1549,465,149,1291,1756,1,150,11872,0,0,0,0
jailerstower-animapowerlist-medium,9970,1550,210,110,1,211,1,111,11873,0,0,0,0
jailerstower-animapowerlist-small,9971,1550,210,81,1,211,113,194,11874,0,0,0,0
!jailerstower-animapowerlist-tile,9972,1556,210,16,1,211,0,16,11824,0,0,2,0
adventure-mission-gold-dragon,9973,1557,97,93,1,98,1770,1863,11875,0,0,0,0
adventure-mission-silver-dragon,9974,1557,97,93,100,197,1770,1863,11876,0,0,0,0
adventure-mission-silver-ring,9975,1557,67,68,79,146,1935,2003,11877,0,0,0,0
adventure-missionend-burst,9976,1557,288,305,1,289,1040,1345,11878,0,0,0,0
adventure-missionend-line,9977,1557,553,25,291,844,1093,1118,11879,0,0,0,0
adventurers-followers-epic-gem,9979,1557,14,20,1005,1019,338,358,11881,0,0,0,0
adventurers-followers-frame,9980,1557,94,96,928,1022,806,902,11882,0,0,0,0
adventurers-followers-legendary-gem,9982,1557,14,15,1005,1019,360,375,11884,0,0,0,0
adventurers-followers-rare-gem,9984,1557,14,15,1005,1019,377,392,11886,0,0,0,0
adventurers-followers-uncommon-base,9985,1557,70,62,291,361,1165,1227,11887,0,0,0,0
adventurers-followers-uncommon-gem,9986,1557,20,15,256,276,1649,1664,11888,0,0,0,0
adventurers-followers-xp,9987,1557,46,47,975,1021,1040,1087,11889,0,0,0,0
adventures-checkmark,9988,1557,42,41,79,121,2005,2046,11890,0,0,0,0
adventures-mission-enemy-socket-01,9989,1557,76,76,503,579,961,1037,11891,0,0,0,0
adventures-mission-enemy-socket-02,9990,1557,76,76,581,657,961,1037,11892,0,0,0,0
adventures-mission-enemy-socket-03,9991,1557,76,76,1,77,1865,1941,11893,0,0,0,0
adventures-mission-enemy-socket-04,9992,1557,76,76,1,77,1943,2019,11894,0,0,0,0
adventures-mission-follower-socket-01,9993,1557,108,108,817,925,917,1025,11895,0,0,0,0
adventures-mission-follower-socket-02,9994,1557,108,108,1,109,1347,1455,11896,0,0,0,0
adventures-mission-follower-socket-03,9995,1557,108,108,111,219,1347,1455,11897,0,0,0,0
adventures-mission-follower-socket-04,9996,1557,108,108,1,109,1457,1565,11898,0,0,0,0
adventures-mission-highlight-left,9997,1557,47,87,768,815,946,1033,11899,0,0,0,0
adventures-mission-highlight-right,9998,1557,47,87,223,270,1934,2021,11900,0,0,0,0
adventures-mission-maw-left,9999,1557,55,93,221,276,1347,1440,11901,0,0,0,0
adventures-mission-maw-right,10000,1557,55,93,221,276,1457,1550,11902,0,0,0,0
adventures-parchment-tile-left,10001,1557,62,49,151,213,1998,2047,11903,0,0,0,0
adventures-parchment-tile-right,10002,1557,62,49,363,425,1165,1214,11904,0,0,0,0
adventures-ring-gold-dragon,10003,1557,70,68,79,149,1865,1933,11905,0,0,0,0
adventures-ring-gold,10004,1557,40,40,774,814,1120,1160,11906,0,0,0,0
adventures-scroll-arrow-down,10005,1557,21,19,659,680,987,1006,11907,0,0,0,0
adventures-scroll-arrow-up,10006,1557,21,19,659,680,1008,1027,11908,0,0,0,0
adventures-scroll-knob,10007,1557,21,19,233,254,1649,1668,11909,0,0,0,0
adventures-scrollbar-bottom,10008,1557,27,128,291,318,1229,1357,11910,0,0,0,0
adventures-scrollbar-top,10009,1557,27,128,291,318,1359,1487,11911,0,0,0,0
adventuresframe-corner-small-topleft,10010,1557,37,37,816,853,1120,1157,11912,0,0,0,0
_adventures-mission-highlight-mid,10011,1557,128,87,0,128,96,183,11913,0,0,4,0
_adventures-mission-maw-bg,10012,1557,128,75,0,128,185,260,11914,0,0,4,0
_adventures-mission-maw-mid,10013,1557,128,93,0,128,1,94,11915,0,0,4,0
_adventures-parchment-tile-mid,10014,1557,102,46,0,102,262,308,11916,0,0,4,0
!adventuresframe-left,10015,1558,16,128,65,81,0,128,11917,0,0,2,0
!adventuresframe-right,10016,1558,16,128,83,99,0,128,11918,0,0,2,0
!adventuresframetile-left,10017,1558,30,256,1,31,0,256,11919,0,0,2,0
!adventuresframetile-right,10018,1558,30,256,33,63,0,256,11920,0,0,2,0
adventures-missions-bg-01,10019,1559,256,256,0,256,0,256,11921,0,0,6,0
adventures-missions-bg-02,10020,1560,256,256,0,256,0,256,11922,0,0,6,0
_adventuresframe-small-top,10021,1561,128,16,0,128,65,81,11923,0,0,4,0
_adventuresframetile-bottom,10022,1561,256,30,0,256,1,31,11924,0,0,4,0
_adventuresframetile-median,10023,1561,128,10,0,128,83,93,11925,0,0,4,0
_adventuresframetile-top,10024,1561,256,30,0,256,33,63,11926,0,0,4,0
ui-frame-jailerstower-hidebuttonhighlight,10036,1549,277,130,1,278,765,895,11939,0,0,0,0
ui-frame-jailerstower-pendingbuttonhighlight,10037,1549,465,149,1291,1756,152,301,11938,0,0,0,0
quest-campaign-available,10038,647,32,32,785,817,477,509,11940,0,0,0,0
quest-campaign-turnin,10039,647,32,32,853,885,477,509,11941,0,0,0,0
128-redbutton-left-disabled,10045,871,114,128,391,505,1041,1169,11947,0,0,0,0
128-redbutton-left-pressed,10046,871,114,128,391,505,1171,1299,11948,0,0,0,0
128-redbutton-left,10047,871,114,128,391,505,911,1039,11949,0,0,0,0
128-redbutton-right-disabled,10048,871,292,128,1,293,651,779,11950,0,0,0,0
128-redbutton-right-pressed,10049,871,292,128,1,293,781,909,11951,0,0,0,0
128-redbutton-right,10050,871,292,128,1,293,521,649,11952,0,0,0,0
_128-redbutton-center-disabled,10051,871,64,128,0,64,131,259,11953,0,0,4,0
_128-redbutton-center-pressed,10052,871,64,128,0,64,261,389,11954,0,0,4,0
_128-redbutton-center,10053,871,64,128,0,64,1,129,11955,0,0,4,0
jailerstower-scenario-titlebg,10056,1562,472,141,1,473,1,142,11958,0,0,0,0
jailerstower-scenario-trackerheader,10057,1562,243,77,1,244,144,221,11959,0,0,0,0
ui-frame-jailerstower-portrait-border,10058,1549,178,180,1291,1469,667,847,11960,0,0,0,0
ui-frame-jailerstower-portrait-qualityepic-border,10059,1549,178,180,861,1039,796,976,11961,0,0,0,0
ui-frame-jailerstower-portrait-qualityrare-border,10060,1549,178,180,1041,1219,796,976,11962,0,0,0,0
ui-frame-jailerstower-portrait-qualityuncommon-border,10061,1549,178,180,1291,1469,485,665,11963,0,0,0,0
common-icon-backarrow,10062,1563,256,256,1,257,1,257,11964,45,45,0,0
common-icon-checkmark,10063,1563,256,256,1,257,517,773,11965,25,25,0,0
common-icon-redx,10064,1563,256,256,517,773,1,257,11966,25,25,0,0
common-icon-rotateleft,10065,1563,100,100,1,101,775,875,11967,20,20,0,0
common-icon-rotateright,10066,1563,100,100,1,101,877,977,11968,20,20,0,0
common-icon-undo,10067,1563,256,256,517,773,259,515,11969,25,25,0,0
common-icon-zoomin,10068,1563,256,256,517,773,517,773,11970,25,25,0,0
common-icon-zoomout,10069,1563,256,256,775,1031,259,515,11971,25,25,0,0
128-redbutton-refresh-pressed,10070,871,128,128,131,259,1691,1819,11972,0,0,0,0
128-redbutton-refresh,10071,871,128,128,1,129,1821,1949,11973,0,0,0,0
128-redbutton-refresh-highlight,10072,871,128,128,261,389,1561,1689,11974,0,0,0,0
128-redbutton-refresh-disabled,10074,871,128,128,131,259,1561,1689,11976,0,0,0,0
common-input-left,10075,1564,38,108,237,275,67,175,11977,0,0,0,0
common-input-middle,10076,1564,1,108,277,278,67,175,11978,0,0,0,0
common-radiobutton-circle,10077,1564,116,116,1,117,67,183,11979,0,0,0,0
common-radiobutton-dot,10078,1564,116,116,119,235,67,183,11980,0,0,0,0
common-slider-thumb,10079,1564,48,48,327,375,1,49,11981,0,0,0,0
common-slider-track,10080,1564,324,64,1,325,1,65,11982,0,0,0,0
charactercreate-icon-alliance,10081,708,184,200,1351,1535,259,459,11983,92,100,0,0
charactercreate-icon-customize-accessories-selected,10082,708,156,158,1881,2037,259,417,11984,104,105,0,0
charactercreate-icon-customize-accessories,10083,708,156,158,1723,1879,259,417,11985,104,105,0,0
charactercreate-icon-customize-body-selected,10084,708,156,158,281,437,657,815,11986,104,105,0,0
charactercreate-icon-customize-body,10085,708,156,158,281,437,497,655,11987,104,105,0,0
charactercreate-icon-customize-hair-selected,10086,708,208,210,519,727,259,469,11988,104,105,0,0
charactercreate-icon-customize-hair,10087,708,208,210,1819,2027,1,211,11989,104,105,0,0
charactercreate-icon-customize-head-selected,10088,708,156,158,281,437,977,1135,11990,104,105,0,0
charactercreate-icon-customize-head,10089,708,156,158,281,437,817,975,11991,104,105,0,0
charactercreate-icon-customize-torso-selected,10090,708,208,210,939,1147,259,469,11992,104,105,0,0
charactercreate-icon-customize-torso,10091,708,208,210,729,937,259,469,11993,104,105,0,0
charactercreate-icon-dice,10092,708,256,256,1313,1569,1,257,11994,24,24,0,0
charactercreate-icon-horde,10093,708,184,200,1537,1721,259,459,11995,92,100,0,0
charactercreate-ring-alliance,10094,708,278,280,1,279,1,281,11996,0,0,0,0
charactercreate-ring-customizebackground,10095,708,246,246,1571,1817,1,247,11997,123,123,0,0
charactercreate-ring-horde,10096,708,278,280,1,279,565,845,11998,0,0,0,0
charactercreate-ring-metaldark,10097,708,278,280,1,279,1129,1409,11999,0,0,0,0
charactercreate-ring-metallight,10098,708,278,280,1,279,1693,1973,12000,0,0,0,0
charactercreate-ring-select,10099,708,236,236,281,517,259,495,12001,0,0,0,0
common-icon-forwardarrow,10100,1563,256,256,259,515,259,515,12002,45,45,0,0
chromietime-button-background,10101,1565,208,115,1,209,1924,2039,12003,0,0,0,0
chromietime-button-frame,10102,1565,226,133,1346,1572,769,902,12004,0,0,0,0
chromietime-button-highlight,10103,1565,204,111,1802,2006,769,880,12005,0,0,0,0
chromietime-parchment,10104,1565,401,514,1,402,1,515,12006,0,0,0,0
chromietime-portrait-chrome,10105,1565,325,167,1,326,705,872,12007,0,0,0,0
chromietime-portrait-frame,10106,1565,344,186,1,345,517,703,12008,0,0,0,0
charactercreate-vignette-bottom,10107,708,1,577,439,440,643,1220,12009,0,0,0,0
charactercreate-vignette-sides,10108,708,703,1,521,1224,575,576,12010,0,0,0,0
charactercreate-vignette-top,10109,708,1,451,439,440,1222,1673,12011,0,0,0,0
raceicon128-bloodelf-female,10110,897,128,128,131,259,781,909,12012,0,0,0,0
raceicon128-bloodelf-male,10111,897,128,128,261,389,1,129,12013,0,0,0,0
raceicon128-darkirondwarf-female,10112,897,128,128,261,389,131,259,12014,0,0,0,0
raceicon128-darkirondwarf-male,10113,897,128,128,261,389,261,389,12015,0,0,0,0
raceicon128-draenei-female,10114,897,128,128,391,519,1,129,12016,0,0,0,0
raceicon128-draenei-male,10115,897,128,128,391,519,131,259,12017,0,0,0,0
raceicon128-dwarf-female,10116,897,128,128,391,519,261,389,12018,0,0,0,0
raceicon128-dwarf-male,10117,897,128,128,391,519,391,519,12019,0,0,0,0
raceicon128-gnome-female,10118,897,128,128,391,519,781,909,12020,0,0,0,0
raceicon128-gnome-male,10119,897,128,128,521,649,1,129,12021,0,0,0,0
raceicon128-goblin-female,10120,897,128,128,521,649,131,259,12022,0,0,0,0
raceicon128-goblin-male,10121,897,128,128,521,649,261,389,12023,0,0,0,0
raceicon128-highmountain-female,10122,897,128,128,521,649,391,519,12024,0,0,0,0
raceicon128-highmountain-male,10123,897,128,128,521,649,521,649,12025,0,0,0,0
raceicon128-human-female,10124,897,128,128,521,649,651,779,12026,0,0,0,0
raceicon128-human-male,10125,897,128,128,521,649,781,909,12027,0,0,0,0
raceicon128-kultiran-female,10126,897,128,128,651,779,1,129,12028,0,0,0,0
raceicon128-kultiran-male,10127,897,128,128,651,779,131,259,12029,0,0,0,0
raceicon128-lightforged-female,10128,897,128,128,651,779,261,389,12030,0,0,0,0
raceicon128-lightforged-male,10129,897,128,128,651,779,391,519,12031,0,0,0,0
raceicon128-magharorc-female,10130,897,128,128,651,779,521,649,12032,0,0,0,0
raceicon128-magharorc-male,10131,897,128,128,651,779,651,779,12033,0,0,0,0
raceicon128-mechagnome-female,10132,897,128,128,651,779,781,909,12034,0,0,0,0
raceicon128-mechagnome-male,10133,897,128,128,781,909,1,129,12035,0,0,0,0
raceicon128-nightborne-female,10134,897,128,128,781,909,131,259,12036,0,0,0,0
raceicon128-nightborne-male,10135,897,128,128,781,909,261,389,12037,0,0,0,0
raceicon128-nightelf-female,10136,897,128,128,781,909,391,519,12038,0,0,0,0
raceicon128-nightelf-male,10137,897,128,128,781,909,521,649,12039,0,0,0,0
raceicon128-orc-female,10138,897,128,128,781,909,651,779,12040,0,0,0,0
raceicon128-orc-male,10139,897,128,128,781,909,781,909,12041,0,0,0,0
raceicon128-pandaren-female,10140,897,128,128,911,1039,1,129,12042,0,0,0,0
raceicon128-pandaren-male,10141,897,128,128,911,1039,131,259,12043,0,0,0,0
raceicon128-tauren-female,10142,897,128,128,911,1039,261,389,12044,0,0,0,0
raceicon128-tauren-male,10143,897,128,128,911,1039,391,519,12045,0,0,0,0
raceicon128-troll-female,10144,897,128,128,911,1039,521,649,12046,0,0,0,0
raceicon128-troll-male,10145,897,128,128,911,1039,651,779,12047,0,0,0,0
raceicon128-undead-female,10146,897,128,128,911,1039,781,909,12048,0,0,0,0
raceicon128-undead-male,10147,897,128,128,1041,1169,1,129,12049,0,0,0,0
raceicon128-voidelf-female,10148,897,128,128,1431,1559,1,129,12050,0,0,0,0
raceicon128-voidelf-male,10149,897,128,128,1561,1689,1,129,12051,0,0,0,0
raceicon128-vulpera-female,10150,897,128,128,1691,1819,1,129,12052,0,0,0,0
raceicon128-vulpera-male,10151,897,128,128,1821,1949,1,129,12053,0,0,0,0
raceicon128-worgen-female,10152,897,128,128,1041,1169,131,259,12054,0,0,0,0
raceicon128-worgen-male,10153,897,128,128,1041,1169,261,389,12055,0,0,0,0
raceicon128-zandalari-female,10154,897,128,128,1041,1169,391,519,12056,0,0,0,0
raceicon128-zandalari-male,10155,897,128,128,1041,1169,521,649,12057,0,0,0,0
classicon-deathknight,10156,897,128,128,1,129,1,129,12058,0,0,0,0
classicon-demonhunter,10157,897,128,128,1,129,131,259,12059,0,0,0,0
classicon-druid,10158,897,128,128,1,129,261,389,12060,0,0,0,0
classicon-hunter,10159,897,128,128,1,129,521,649,12061,0,0,0,0
classicon-mage,10160,897,128,128,1,129,651,779,12062,0,0,0,0
classicon-monk,10161,897,128,128,1,129,781,909,12063,0,0,0,0
classicon-paladin,10162,897,128,128,131,259,1,129,12064,0,0,0,0
classicon-priest,10163,897,128,128,131,259,131,259,12065,0,0,0,0
classicon-rogue,10164,897,128,128,131,259,261,389,12066,0,0,0,0
classicon-shaman,10165,897,128,128,131,259,391,519,12067,0,0,0,0
classicon-warlock,10166,897,128,128,131,259,521,649,12068,0,0,0,0
classicon-warrior,10167,897,128,128,131,259,651,779,12069,0,0,0,0
chromietime-button-selection,10168,1565,226,133,1574,1800,769,902,12070,0,0,0,0
charactercreate-gendericon-male,10169,708,256,256,797,1053,1,257,12071,0,0,0,0
charactercreate-gendericon-female,10170,708,256,256,281,537,1,257,12072,0,0,0,0
campaign-questlog-lorebook-highlight,10171,1566,36,31,928,964,82,113,12073,0,0,0,0
campaign-questlog-lorebook-back,10172,1566,36,31,928,964,49,80,12074,0,0,0,0
campaign-questlog-lorebackground,10173,1566,307,510,1,308,1,511,12075,0,0,0,0
campaign-questlog-loredivider,10174,1566,285,58,619,904,581,639,12076,0,0,0,0
campaign-questlog-lorebook-back-glow,10175,1566,36,31,966,1002,49,80,12077,0,0,0,0
campaign-questlog-lorebook,10176,1566,36,31,975,1011,1,32,12078,0,0,0,0
campaign-questlog-lorebook-glow,10177,1566,45,46,928,973,1,47,12079,0,0,0,0
campaign-questlog-lorebottomshadow,10178,1566,307,66,619,926,513,579,12080,0,0,0,0
charactercreate-ring-alliance-disabled,10179,708,278,280,1,279,283,563,12081,0,0,0,0
charactercreate-ring-metaldark-disabled,10180,708,278,280,1,279,1411,1691,12082,0,0,0,0
charactercreate-ring-horde-disabled,10181,708,278,280,1,279,847,1127,12083,0,0,0,0
Waypoint-MapPin-Tracked,10182,1567,30,30,41,71,33,63,12084,0,0,0,0
Waypoint-MapPin-Untracked,10183,1567,30,30,73,103,1,31,12085,0,0,0,0
charactercreate-tooltip-background,10188,708,1,1,92,93,2041,2042,12090,0,0,0,0
charactercreate-tooltip-corner,10189,708,68,68,203,271,1975,2043,12091,0,0,0,0
charactercreate-tooltip-side,10190,708,1,68,273,274,1975,2043,12092,0,0,0,0
charactercreate-tooltip-top,10193,708,1,68,276,277,1975,2043,12095,0,0,0,0
Waypoint-MapPin-Highlight,10194,1567,30,30,41,71,1,31,12096,0,0,0,0
Soulbind_Shot_Fey_Dreamweaver,10195,1569,603,558,1,604,1,559,12760,402,372,0,0
Soulbind_Shot_Fey_Niya,10196,1569,578,558,1211,1789,1,559,12762,385,372,0,0
Soulbind_Shot_Venthyr_Draven,10197,1570,603,558,1242,1845,1,559,12759,402,372,0,0
Soulbind_Shot_Necrolords_Emeni,10198,1571,629,558,1,630,1,559,12756,419,372,0,0
Soulbind_Shot_Necrolords_Marileth,10199,1571,572,558,1206,1778,1,559,12758,381,372,0,0
UI-Frame-Oribos-CornerBottomLeft,10200,1572,166,166,1,167,152,318,12681,0,0,0,0
UI-Frame-Oribos-CornerBottomRight,10201,1572,166,166,1,167,320,486,12682,0,0,0,0
UI-Frame-Oribos-CornerTopLeft,10202,1572,166,166,1,167,488,654,12683,0,0,0,0
UI-Frame-Oribos-CornerTopRight,10203,1572,166,166,1,167,656,822,12684,0,0,0,0
UI-Frame-Oribos-ExitButtonBorder,10204,1572,33,32,169,202,152,184,12106,0,0,0,0
_UI-Frame-Oribos-TileBottom,10205,1572,256,30,0,256,88,118,12720,0,0,4,0
_UI-Frame-Oribos-TileTop,10206,1572,256,30,0,256,120,150,12721,0,0,4,0
UI-Frame-Oribos-BackgroundTile,10207,1573,256,256,0,256,0,256,12109,0,0,6,0
!UI-Frame-Oribos-TileLeft,10208,1574,30,256,1,31,0,256,12687,0,0,2,0
!UI-Frame-Oribos-TileRight,10209,1574,30,256,33,63,0,256,12688,0,0,2,0
UI-Frame-Oribos-TitleLeft,10210,1572,202,85,1,203,824,909,12112,0,0,0,0
UI-Frame-Oribos-TitleRight,10211,1572,202,85,1,203,911,996,12113,0,0,0,0
_UI-Frame-Oribos-TitleMiddle,10212,1572,128,85,0,128,1,86,12114,0,0,4,0
Waypoint-MapPin-ChatIcon,10218,1567,13,13,1,14,41,54,12120,0,0,0,0
UI-QuestIcon-TurnIn-Daily,10219,1575,32,32,1,33,1,33,12121,0,0,0,0
UI-QuestIcon-TurnIn-Legendary,10220,1575,32,32,35,67,1,33,12122,0,0,0,0
UI-QuestIcon-TurnIn-Normal,10221,1575,32,32,69,101,1,33,12123,0,0,0,0
charactercreate-ring-racialtrait,10222,708,38,38,1191,1229,455,493,12124,0,0,0,0
campaign_shadowlands,10223,1552,608,138,611,1219,421,559,12125,0,0,0,2
_adventuresframe-inner-top,10225,1561,70,5,0,70,95,100,12127,0,0,4,0
!adventuresframe-inner-left,10226,1558,8,70,101,109,0,70,12128,0,0,2,0
Waypoint-MapPin-ButtonToggle,10227,1567,38,38,1,39,1,39,12133,0,0,0,0
soulbinds_portrait_background,10234,1578,113,150,1849,1962,49,199,12140,0,0,0,0
soulbinds_portrait_border,10235,1578,252,324,85,337,726,1050,12141,126,162,0,0
soulbinds_portrait_selected,10236,1578,252,324,85,337,1052,1376,12142,126,162,0,0
Soulbinds_Background_Venthyr,10238,1577,888,607,891,1779,1,608,12144,0,0,0,0
soulbinds_portrait_active,10241,1578,108,106,1481,1589,238,344,12147,65,64,0,0
waypoint-mappin-minimap-tracked,10243,647,32,32,615,647,715,747,12138,0,0,0,0
waypoint-mappin-minimap-untracked,10244,647,32,32,615,647,749,781,12139,0,0,0,0
soulbinds_portrait_highlight,10245,1578,276,348,79,355,376,724,12149,0,0,0,0
common-icon-backarrow-disable,10246,1563,256,256,1,257,259,515,12150,45,45,0,0
common-icon-forwardarrow-disable,10247,1563,256,256,259,515,517,773,12151,45,45,0,0
Soulbind_Shot_Fey_Korayn,10248,1569,603,558,606,1209,1,559,12761,402,372,0,0
!Soulbinds_ShadowVertical,10249,1579,68,16,1,69,0,16,12153,0,0,2,0
_Soulbinds_ShadowHorizontal,10250,1580,16,68,0,16,1,69,12154,0,0,4,0
soulbinds_tree_conduit_background,10251,1578,112,114,1591,1703,238,352,12155,56,57,0,0
soulbinds_tree_conduit_icon_attack,10252,1578,52,62,1793,1845,171,233,12156,0,0,0,0
soulbinds_tree_conduit_icon_protect,10253,1578,52,62,1819,1871,306,368,12157,0,0,0,0
soulbinds_tree_conduit_icon_utility,10254,1578,52,62,1964,2016,115,177,12158,0,0,0,0
soulbinds_tree_conduit_ring,10255,1578,112,114,1446,1558,49,163,12159,56,57,0,0
soulbinds_tree_ring,10259,1578,112,112,233,345,1622,1734,12163,56,56,0,0
CircleMask,10261,1582,64,64,0,64,0,64,12165,0,0,16,0
soulbinds_tree_conduit_background_disabled,10262,1578,112,114,1705,1817,238,352,12166,56,57,0,0
soulbinds_tree_conduit_ring_disabled,10263,1578,112,114,1887,1999,238,352,12167,56,57,0,0
soulbinds_tree_conduit_ring_glow,10264,1578,120,120,1727,1847,49,169,12168,60,60,0,0
soulbinds_tree_ring_disabled,10265,1578,112,112,233,345,1736,1848,12169,56,56,0,0
soulbinds_tree_ring_glow,10266,1578,120,120,211,331,1378,1498,12170,60,60,0,0
ardenweald-zone-ability-2,10267,1583,256,128,1,257,131,259,12171,0,0,0,0
ardenweald-zone-ability,10268,1583,256,128,1,257,1,129,12172,0,0,0,0
bastion-zone-ability-2,10269,1583,256,128,259,515,1,129,12173,0,0,0,0
bastion-zone-ability,10270,1583,256,128,1,257,261,389,12174,0,0,0,0
maldraxxus-zone-ability-2,10271,1583,256,128,259,515,131,259,12175,0,0,0,0
maldraxxus-zone-ability,10272,1583,256,128,517,773,1,129,12176,0,0,0,0
revendreth-zone-ability-2,10273,1583,256,128,517,773,131,259,12177,0,0,0,0
revendreth-zone-ability,10274,1583,256,128,259,515,261,389,12178,0,0,0,0
garrzoneability-armory,10275,1584,256,128,1,257,1,129,12179,0,0,0,0
garrzoneability-barracksalliance,10276,1584,256,128,259,515,1,129,12180,0,0,0,0
garrzoneability-barrackshorde,10277,1584,256,128,517,773,1,129,12181,0,0,0,0
garrzoneability-inn,10278,1584,256,128,1,257,131,259,12182,0,0,0,0
garrzoneability-lumbermill,10279,1584,256,128,259,515,131,259,12183,0,0,0,0
garrzoneability-magetower,10280,1584,256,128,517,773,131,259,12184,0,0,0,0
garrzoneability-stables,10281,1584,256,128,1,257,261,389,12185,0,0,0,0
garrzoneability-tradingpost,10282,1584,256,128,259,515,261,389,12186,0,0,0,0
garrzoneability-trainingpit,10283,1584,256,128,517,773,261,389,12187,0,0,0,0
garrzoneability-workshop,10284,1584,256,128,1,257,391,519,12188,0,0,0,0
soulbinds_tree_activatearrow,10336,1578,56,34,477,533,1,35,12240,28,17,0,0
Soulbind_Shot_Necrolords_Heirmir,10337,1571,572,558,632,1204,1,559,12757,381,372,0,0
common-button-square-gray-down,10338,1598,256,256,1,257,291,547,12242,42,42,0,0
common-button-square-gray-up,10339,1598,256,256,1,257,549,805,12243,42,42,0,0
soulbinds_tree_connector_vertical_mask,10352,1603,128,128,0,128,0,128,12254,64,64,16,0
soulbinds_tree_connector_diagonal_close_mask,10353,1604,128,128,0,128,0,128,12255,64,64,16,0
soulbinds_tree_connector_diagonal_far_mask,10354,1605,128,256,0,128,0,256,12256,64,128,16,0
soulbinds_tree_connector_diagonal_close,10355,1578,128,128,357,485,1896,2024,12160,64,64,0,0
soulbinds_tree_connector_diagonal_far,10356,1578,128,256,1450,1578,376,632,12161,64,128,0,0
soulbinds_tree_connector_vertical,10357,1578,128,128,487,615,1896,2024,12162,64,64,0,0
newplayertutorial-icon-key,10361,575,80,70,963,1043,261,331,12260,40,35,0,0
newplayertutorial-icon-mouse-rightbutton,10362,575,152,202,539,691,697,899,12261,52,69,0,0
newplayertutorial-icon-mouse-turn,10363,575,228,203,1,229,697,900,12262,78,69,0,0
shadowlands-landingbutton-NightFae-down,10396,1609,65,65,1,66,1,66,15793,0,0,0,0
shadowlands-landingbutton-NightFae-glow,10397,1609,65,65,1,66,68,133,15794,0,0,0,0
shadowlands-landingbutton-NightFae-highlight,10398,1609,65,65,1,66,135,200,15795,0,0,0,0
shadowlands-landingbutton-NightFae-up,10399,1609,65,65,68,133,1,66,15796,0,0,0,0
shadowlands-landingbutton-kyrian-down,10400,1609,65,65,68,133,68,133,12300,0,0,0,0
shadowlands-landingbutton-kyrian-glow,10401,1609,65,65,68,133,135,200,12301,0,0,0,0
shadowlands-landingbutton-kyrian-highlight,10402,1609,65,65,135,200,1,66,12302,0,0,0,0
shadowlands-landingbutton-kyrian-up,10403,1609,65,65,135,200,68,133,12303,0,0,0,0
shadowlands-landingbutton-necrolord-down,10404,1609,65,65,135,200,135,200,12304,0,0,0,0
shadowlands-landingbutton-necrolord-glow,10405,1609,65,65,202,267,1,66,12305,0,0,0,0
shadowlands-landingbutton-necrolord-highlight,10406,1609,65,65,202,267,68,133,12306,0,0,0,0
shadowlands-landingbutton-necrolord-up,10407,1609,65,65,202,267,135,200,12307,0,0,0,0
shadowlands-landingbutton-venthyr-down,10408,1609,65,65,269,334,1,66,12308,0,0,0,0
shadowlands-landingbutton-venthyr-glow,10409,1609,65,65,336,401,1,66,12309,0,0,0,0
shadowlands-landingbutton-venthyr-up,10411,1609,65,65,403,468,1,66,12311,0,0,0,0
covenantchoice-offering-ability-frame-kyrian,10438,1592,63,127,277,340,871,998,12338,0,0,0,0
covenantchoice-offering-ability-ring-kyrian,10439,1592,80,82,415,495,438,520,12339,0,0,0,0
covenantchoice-offering-parchment-kyrian,10440,1592,557,435,1,558,1,436,12340,0,0,0,0
covenantchoice-offering-preview-frame-kyrian,10441,1592,414,432,560,974,1,433,12341,0,0,0,0
covenantchoice-offering-sigil-kyrian,10442,1592,55,91,342,397,871,962,12342,0,0,0,0
covenantchoice-offering-ability-frame-venthyr,10443,1593,63,127,277,340,871,998,12343,0,0,0,0
covenantchoice-offering-ability-ring-venthyr,10444,1593,80,82,415,495,438,520,12344,0,0,0,0
covenantchoice-offering-parchment-venthyr,10445,1593,557,435,1,558,1,436,12345,0,0,0,0
covenantchoice-offering-preview-frame-venthyr,10446,1593,414,432,560,974,1,433,12346,0,0,0,0
covenantchoice-offering-sigil-venthyr,10447,1593,63,86,342,405,871,957,12347,0,0,0,0
covenantchoice-panel-sigil-kyrian,10452,1589,73,96,306,379,215,311,12352,0,0,0,0
covenantchoice-panel-sigil-necrolords,10453,1589,73,96,381,454,117,213,12353,0,0,0,0
covenantchoice-panel-sigil-nightfae,10454,1589,73,96,381,454,215,311,12354,0,0,0,0
covenantchoice-panel-sigil-venthyr,10455,1589,73,96,306,379,117,213,12355,0,0,0,0
ui-frame-oribos-cardshadowlarge,10459,1589,303,553,1,304,1,554,12359,0,0,0,0
ui-frame-oribos-cardshadowsmall,10460,1589,253,467,1,254,556,1023,12360,0,0,0,0
ui-frame-oribos-extrabutton,10461,1589,40,40,456,496,117,157,12361,0,0,0,0
covenantsanctum-background-kyrian,10474,1608,644,585,1,645,1,586,12374,0,0,0,0
covenantsanctum-divider-kyrian,10476,1608,24,585,1251,1275,63,648,12376,0,0,0,0
covenantsanctum-icon-border-kyrian,10477,1608,128,128,347,475,882,1010,12377,0,0,0,0
covenantsanctum-upgrade-border-kyrian,10484,1608,257,56,1553,1810,1,57,12384,0,0,0,0
covenantsanctum-icon-hover,10485,1606,94,94,702,796,1,95,12385,0,0,0,0
covenantsanctum-icon-rankborder,10486,1606,22,18,309,331,373,391,12386,0,0,0,0
covenantsanctum-icon-select,10487,1606,97,97,603,700,1,98,12387,0,0,0,0
covenantsanctum-reservoir-hover,10489,1606,254,253,347,601,1,254,12389,0,0,0,0
covenantsanctum-reservoir-select,10490,1606,254,253,347,601,256,509,12390,0,0,0,0
covenantsanctum-upgrade-background,10491,1606,257,56,1,258,339,395,12391,0,0,0,0
covenantsanctum-upgrade-border-available,10492,1606,257,56,1,258,397,453,12392,0,0,0,0
covenantsanctum-upgrade-hover,10493,1606,257,56,1,258,455,511,12393,0,0,0,0
covenantsanctum-upgrade-icon-available,10494,1606,28,32,309,337,339,371,12394,0,0,0,0
UI-Frame-Kyrian-ExitButtonBorder,10499,1610,33,32,1,34,824,856,12399,0,0,0,0
UI-Frame-Kyrian-TitleLeft,10500,1610,202,85,561,763,270,355,12400,0,0,0,0
UI-Frame-Kyrian-TitleRight,10501,1610,202,85,765,967,270,355,12401,0,0,0,0
_UI-Frame-Kyrian-TitleMiddle,10504,1610,128,85,0,128,33,118,12404,0,0,4,0
!UI-Frame-Kyrian-TileLeft,10506,1612,30,256,1,31,0,256,12695,0,0,2,0
!UI-Frame-Kyrian-TileRight,10507,1612,30,256,33,63,0,256,12696,0,0,2,0
ui-frame-newplayertutorial-cornertopleft,10508,575,128,128,1074,1202,341,469,12702,64,64,0,0
ui-frame-newplayertutorial-cornerbottomleft,10509,575,128,128,915,1043,747,875,12700,64,64,0,0
ui-frame-newplayertutorial-cornerbottomright,10510,575,128,128,915,1043,877,1005,12701,64,64,0,0
ui-frame-newplayertutorial-cornertopright,10511,575,128,128,1074,1202,471,599,12703,64,64,0,0
ui-frame-newplayertutorial-center,10516,575,1,1,2043,2044,1,2,12699,0,0,0,0
charactercreate-startingzone-draenei,10517,1613,1022,664,1025,2047,1333,1997,12417,0,0,0,0
charactercreate-startingzone-darkirondwarf,10518,1613,1022,664,1025,2047,1,665,12418,0,0,0,0
charactercreate-startingzone-demonhunter,10519,1613,1022,664,1,1023,1333,1997,12419,0,0,0,0
charactercreate-startingzone-deathknight,10520,1613,1022,664,1,1023,667,1331,12420,0,0,0,0
charactercreate-startingzone-deathknight-alliedraces,10521,1613,1022,664,1025,2047,667,1331,12421,0,0,0,0
charactercreate-startingzone-bloodelf,10522,1613,1022,664,1,1023,1,665,12422,0,0,0,0
charactercreate-startingzone-dwarf,10523,1614,1022,664,1,1023,1,665,12423,0,0,0,0
charactercreate-startingzone-gnome,10524,1614,1022,664,1025,2047,1,665,12424,0,0,0,0
charactercreate-startingzone-goblin,10525,1614,1022,664,1,1023,667,1331,12425,0,0,0,0
charactercreate-startingzone-highmountaintauren,10526,1614,1022,664,1025,2047,667,1331,12426,0,0,0,0
charactercreate-startingzone-human,10527,1614,1022,664,1,1023,1333,1997,12427,0,0,0,0
charactercreate-startingzone-kultiran,10528,1614,1022,664,1025,2047,1333,1997,12428,0,0,0,0
charactercreate-startingzone-lightforgeddraenei,10529,1615,1022,664,1,1023,1,665,12429,0,0,0,0
charactercreate-startingzone-magharorc,10530,1615,1022,664,1025,2047,1,665,12430,0,0,0,0
charactercreate-startingzone-mechagnome,10531,1615,1022,664,1,1023,667,1331,12431,0,0,0,0
charactercreate-startingzone-nightborne,10532,1615,1022,664,1025,2047,667,1331,12432,0,0,0,0
charactercreate-startingzone-nightelf,10533,1615,1022,664,1,1023,1333,1997,12433,0,0,0,0
charactercreate-startingzone-orc,10534,1615,1022,664,1025,2047,1333,1997,12434,0,0,0,0
charactercreate-startingzone-pandaren,10535,1616,1022,664,1,1023,1,665,12435,0,0,0,0
charactercreate-startingzone-tauren,10536,1616,1022,664,1025,2047,1,665,12436,0,0,0,0
charactercreate-startingzone-troll,10537,1616,1022,664,1,1023,667,1331,12437,0,0,0,0
charactercreate-startingzone-undead,10538,1616,1022,664,1025,2047,667,1331,12438,0,0,0,0
charactercreate-startingzone-voidelf,10539,1616,1022,664,1,1023,1333,1997,12439,0,0,0,0
charactercreate-startingzone-vulpera,10540,1616,1022,664,1025,2047,1333,1997,12440,0,0,0,0
adventure-healthbar,10541,1557,89,36,609,698,1120,1156,12441,0,0,0,0
adventures-dps,10542,1557,28,30,537,565,1165,1195,12442,0,0,0,0
adventures-enemy-frame,10543,1557,67,67,221,288,1865,1932,12443,0,0,0,0
adventures-healer,10544,1557,28,30,567,595,1165,1195,12444,0,0,0,0
adventures-tank,10545,1557,28,30,567,595,1197,1227,12445,0,0,0,0
adventure_ability_frame,10547,1557,36,37,855,891,1120,1157,12447,0,0,0,0
adventurers-followers-frame-base,10548,1557,70,62,151,221,1934,1996,12448,0,0,0,0
charactercreate-startingzone-worgen,10549,1617,1022,664,1,1023,1,665,12449,0,0,0,0
charactercreate-startingzone-zandalaritroll,10550,1617,1022,664,1,1023,667,1331,12450,0,0,0,0
charactercreate-startingzone-exilesreach,10551,1618,1022,664,1,1023,1,665,12451,0,0,0,0
AlphaMask2,10554,1620,128,128,0,128,0,128,12453,0,0,16,0
newplayertutorial-keyboard,10556,575,960,338,1,961,1,339,12454,480,169,0,0
newplayertutorial-icon-mouse-leftbutton,10557,575,152,202,231,383,697,899,12455,52,69,0,0
newplayertutorial-icon-mouse-middlebutton,10558,575,152,202,385,537,697,899,12456,52,69,0,0
!ui-frame-newplayertutorial-edgeleft,10559,575,128,128,915,1043,487,615,12697,64,64,0,0
!ui-frame-newplayertutorial-edgeright,10560,575,128,128,915,1043,617,745,12698,64,64,0,0
_ui-frame-newplayertutorial-edgebottom,10561,575,1044,128,963,2007,1,129,12704,522,64,0,0
_ui-frame-newplayertutorial-edgetop,10562,575,1044,128,963,2007,131,259,12705,522,64,0,0
newplayertutorial-greenglow-redbutton-left,10563,575,50,98,1,51,902,1000,12505,25,49,0,0
newplayertutorial-greenglow-redbutton-middle,10564,575,2,98,2015,2017,131,229,12506,2,49,0,0
newplayertutorial-greenglow-redbutton-right,10565,575,50,98,53,103,902,1000,12507,25,49,0,0
adventure-healthbar-enemy,10566,1557,72,28,700,772,1120,1148,12524,0,0,0,0
adventurers-frame-soulbind-fae,10567,1557,94,96,106,200,1567,1663,12525,0,0,0,0
adventurers-frame-soulbind-kyrian,10568,1557,94,96,1,95,1672,1768,12526,0,0,0,0
adventurers-frame-soulbind-necrolord,10569,1557,94,96,97,191,1672,1768,12527,0,0,0,0
adventurers-frame-soulbind-revendrath,10570,1557,94,96,193,287,1672,1768,12528,0,0,0,0
adventures-ffw,10571,1557,12,12,1005,1017,410,422,12529,0,0,0,0
adventures-rewatch,10572,1557,14,14,1005,1019,394,408,12530,0,0,0,0
adventure_ability_frame_enemy,10573,1557,29,28,597,626,1165,1193,12531,0,0,0,0
adventure_ability_frame_filled,10574,1557,36,37,893,929,1120,1157,12532,0,0,0,0
adventure_ability_frame_filled_enemy,10575,1557,29,28,597,626,1195,1223,12533,0,0,0,0
newplayertutorial-drag-cursor,10576,575,157,144,915,1072,341,485,12534,82,75,0,0
newplayertutorial-drag-slotblue,10577,575,152,152,693,845,697,849,12535,76,76,0,0
newplayertutorial-drag-slotgreen,10578,575,152,152,693,845,851,1003,12536,76,76,0,0
UI-Frame-Oribos-CardShadowMask,10579,1622,1024,1024,0,1024,0,1024,12452,0,0,16,0
animachannel-bar-background,10588,1625,272,38,1,273,303,341,12560,0,0,0,0
animachannel-bar-kyrian-gem,10589,1625,24,24,387,411,303,327,12561,0,0,0,0
animachannel-bar-necrolord-gem,10590,1625,24,24,361,385,303,327,12562,0,0,0,0
animachannel-bar-nightfae-gem,10591,1625,24,24,309,333,303,327,12563,0,0,0,0
animachannel-bar-venthyr-gem,10592,1625,24,24,335,359,303,327,12564,0,0,0,0
animachannel-currencyborder,10593,1625,189,37,315,504,261,298,12565,0,0,0,0
animachannel-icon-device-kyrian-border,10594,1625,52,53,1,53,398,451,12566,0,0,0,0
animachannel-icon-device-necrolord-border,10595,1625,52,53,55,107,398,451,12567,0,0,0,0
animachannel-icon-device-nightfae-border,10596,1625,52,53,1,53,453,506,12568,0,0,0,0
animachannel-icon-device-venthyr-border,10597,1625,52,53,55,107,343,396,12569,0,0,0,0
animachannel-icon-device,10598,1625,52,53,1,53,343,396,12570,0,0,0,0
animachannel-icon-kyrian-normal,10599,1625,37,45,259,296,343,388,12571,0,0,0,0
animachannel-icon-kyrian-ready,10600,1625,37,45,220,257,390,435,12572,0,0,0,0
animachannel-icon-kyrian-reinforce,10601,1625,37,45,220,257,343,388,12573,0,0,0,0
animachannel-icon-kyrian-select,10602,1625,37,45,220,257,437,482,12574,0,0,0,0
animachannel-icon-necrolord-normal,10603,1625,35,49,146,181,445,494,12575,0,0,0,0
animachannel-icon-necrolord-ready,10604,1625,35,49,183,218,343,392,12576,0,0,0,0
animachannel-icon-necrolord-reinforce,10605,1625,35,49,146,181,394,443,12577,0,0,0,0
animachannel-icon-necrolord-select,10606,1625,35,49,146,181,343,392,12578,0,0,0,0
animachannel-icon-nightfae-normal,10607,1625,35,51,109,144,449,500,12579,0,0,0,0
animachannel-icon-nightfae-ready,10608,1625,35,51,55,90,453,504,12580,0,0,0,0
animachannel-icon-nightfae-reinforce,10609,1625,35,51,109,144,343,394,12581,0,0,0,0
animachannel-icon-nightfae-select,10610,1625,35,51,109,144,396,447,12582,0,0,0,0
animachannel-icon-venthyr-normal,10611,1625,33,49,183,216,394,443,12583,0,0,0,0
animachannel-icon-venthyr-ready,10612,1625,33,49,259,292,441,490,12584,0,0,0,0
animachannel-icon-venthyr-reinforce,10613,1625,33,49,183,216,445,494,12585,0,0,0,0
animachannel-icon-venthyr-select,10614,1625,33,49,259,292,390,439,12586,0,0,0,0
animachannel-reinforce-textshadow,10615,1625,312,40,1,313,261,301,12587,0,0,0,0
animachannel-menu-corner,10624,1625,32,32,275,307,303,335,12727,0,0,0,0
_animachannel-menu-edgebottom,10625,1625,32,9,0,32,239,248,12717,0,0,4,0
_animachannel-menu-edgetop,10626,1625,32,9,0,32,250,259,12718,0,0,4,0
!animachannel-menu-edgeleft,10627,1628,9,32,1,10,0,32,12715,0,0,2,0
!animachannel-menu-edgeright,10628,1628,9,32,12,21,0,32,12719,0,0,2,0
_GarrMissionLocation-Ardenweald-Mid,10630,1630,1024,285,0,1024,1,286,12601,0,0,4,0
_GarrMissionLocation-Bastion-Mid,10631,1631,1024,285,0,1024,1,286,12602,0,0,4,0
_GarrMissionLocation-Maldraxxus-Mid,10632,1632,1024,285,0,1024,1,286,12603,0,0,4,0
_GarrMissionLocation-Revendreth-Mid,10633,1633,1024,285,0,1024,1,286,12604,0,0,4,0
Callings-Available,10634,1634,26,33,65,91,1,34,12605,0,0,0,0
Callings-Turnin,10635,1634,26,33,93,119,1,34,12606,0,0,0,0
UI-Frame-CharacterCreateDropdown-CornerBottomLeft,10636,1635,124,144,1,125,1,145,12709,62,72,0,0
UI-Frame-CharacterCreateDropdown-CornerBottomRight,10637,1635,124,144,1,125,253,397,12710,62,72,0,0
UI-Frame-CharacterCreateDropdown-CornerTopLeft,10638,1635,124,104,1,125,147,251,12711,62,52,0,0
UI-Frame-CharacterCreateDropdown-CornerTopRight,10639,1635,124,104,813,937,1,105,12712,62,52,0,0
_UI-Frame-CharacterCreateDropdown-EdgeBottom,10640,1635,432,144,379,811,1,145,12713,216,72,0,0
_UI-Frame-CharacterCreateDropdown-EdgeTop,10641,1635,432,104,379,811,147,251,12714,216,52,0,0
!UI-Frame-CharacterCreateDropdown-EdgeLeft,10642,1635,124,408,253,377,1,409,12706,62,204,0,0
!UI-Frame-CharacterCreateDropdown-EdgeRight,10643,1635,124,408,127,251,1,409,12707,62,204,0,0
UI-Frame-CharacterCreateDropdown-Center,10644,1635,1,1,1,2,399,400,12708,0,0,0,0
charactercreate-customize-dropdownbox,10645,708,300,76,439,739,497,573,12616,150,38,0,0
charactercreate-customize-palette,10646,708,84,20,1923,2007,213,233,12617,42,10,0,0
charactercreate-customize-dropdown-linemouseover-middle,10647,708,1,40,2043,2044,1,41,12618,1,20,0,0
charactercreate-customize-dropdown-linemouseover-side,10648,708,12,40,2029,2041,1,41,12619,6,20,0,0
adventures-endcombat-fae,10650,1557,500,232,1,501,338,570,16498,0,0,0,0
adventures-endcombat-fail,10651,1557,181,153,503,684,806,959,12622,0,0,0,0
adventures-endcombat-kyrian,10652,1557,500,232,503,1003,338,570,12623,0,0,0,0
adventures-endcombat-necrolord,10653,1557,500,232,1,501,572,804,12624,0,0,0,0
adventures-endcombat-venthyr,10654,1557,500,232,503,1003,572,804,12625,0,0,0,0
_animachannel-channel-line-horizontal,10657,1625,32,32,0,32,103,135,12626,0,0,4,0
_animachannel-reinforce-line-horizontal,10658,1625,32,32,0,32,205,237,12627,0,0,4,0
Callings-Glow,10659,1634,62,62,1,63,1,63,12628,0,0,0,0
charactercreate-customize-dropdownbox-hover,10660,708,300,76,741,1041,497,573,12629,150,38,0,0
charactercreate-customize-dropdownbox-open,10661,708,300,76,1043,1343,497,573,12630,150,38,0,0
shadowlands-landingpage-callingsdecor-kyrian,10662,1636,169,42,848,1017,129,171,12722,0,0,0,0
shadowlands-landingpage-callingsdecor-necrolord,10663,1636,169,42,1019,1188,129,171,12723,0,0,0,0
shadowlands-landingpage-callingsdecor-nightfae,10664,1636,169,42,364,533,129,171,12724,0,0,0,0
shadowlands-landingpage-callingsdecor-venthyr,10665,1636,169,42,535,704,129,171,12725,0,0,0,0
shadowlands-landingpage-divider,10666,1636,361,173,1,362,1,174,12726,0,0,0,0
Bar-End,10667,1637,15,18,200,215,545,563,12728,0,0,0,0
Cast-Bar-End,10668,1637,15,25,183,198,545,570,12729,0,0,0,0
Health-Bar-End,10669,1637,15,35,227,242,573,608,12730,0,0,0,0
Health_End,10670,1637,6,18,242,248,204,222,12731,0,0,0,0
Metal-Bar,10672,1637,239,80,1,240,184,264,12733,0,0,0,0
Portrait-Frame-Nameplate,10673,1637,50,50,199,249,705,755,12734,0,0,0,0
Portrait-Frame,10674,1637,119,119,131,250,266,385,12735,0,0,0,0
Trinket-Frame,10675,1637,65,65,183,248,478,543,12736,0,0,0,0
_Bar-mid,10676,1637,15,18,0,15,134,152,12737,0,0,4,0
_Cast-Bar-mid,10677,1637,15,25,0,15,87,112,12738,0,0,4,0
_Health-Bar-mid,10678,1637,15,35,0,15,50,85,12739,0,0,4,0
worldstate-capturebar-arrow-bastionarmor,10679,901,7,7,217,224,1,8,12740,0,0,0,0
worldstate-capturebar-frame-separater-bastionarmor,10681,901,3,13,226,229,1,14,12742,0,0,0,0
worldstate-capturebar-neutralfill-bastionarmor,10682,901,54,13,0,54,1,14,12743,0,0,4,0
worldstate-capturebar-neutralglow-bastionarmor,10683,901,162,37,1,163,460,497,12744,0,0,0,0
worldstate-capturebar-spark-bastionarmor,10684,901,19,39,30,49,832,871,12745,0,0,0,0
worldstate-capturebar-spark-neutral-bastionarmor,10685,901,19,39,30,49,873,912,12746,0,0,0,0
mixingpool-lefticon-amount,10688,1638,21,15,40,61,54,69,12749,0,0,0,0
mixingpool-lefticon-frame,10689,1638,37,37,1,38,54,91,12750,0,0,0,0
mixingpool-midicon-amount,10690,1638,21,15,40,61,71,86,12751,0,0,0,0
mixingpool-midicon-frame,10691,1638,37,37,67,104,36,73,12752,0,0,0,0
mixingpool-righticon-amount,10692,1638,21,15,38,59,93,108,12753,0,0,0,0
mixingpool-righticon-frame,10693,1638,37,37,67,104,75,112,12754,0,0,0,0
mixingpool-shadow-text,10694,1638,44,16,143,187,36,52,12755,0,0,0,0
covenantsanctum-divider-venthyr,10696,1639,24,585,1251,1275,63,648,12764,0,0,0,0
covenantsanctum-upgrade-border-venthyr,10697,1639,257,56,1277,1534,63,119,12765,0,0,0,0
covenantsanctum-icon-border-venthyr,10698,1639,128,128,477,605,882,1010,12766,0,0,0,0
covenantsanctum-background-venthyr,10699,1639,644,585,1,645,1,586,12767,0,0,0,0
covenantsanctum-upgrade-border-nightfae,10703,1640,257,56,1553,1810,259,315,12771,0,0,0,0
covenantsanctum-icon-border-nightfae,10704,1640,128,128,347,475,882,1010,12772,0,0,0,0
covenantsanctum-background-nightfae,10705,1640,644,585,1,645,1,586,12773,0,0,0,0
covenantsanctum-divider-nightfae,10706,1640,24,585,1251,1275,321,906,12774,0,0,0,0
Cast-Bar-Fill-End,10708,1637,6,8,242,248,224,232,12824,0,0,0,0
Portrait-frame-color,10710,1637,79,79,175,254,396,475,12826,0,0,0,0
_Cast-Bar-Fill-mid,10711,1637,6,8,0,6,174,182,12827,0,0,4,0
CircleMaskScalable,10712,1641,64,64,0,64,0,64,12828,0,0,16,0
charactercreate-customize-palette-selected,10713,708,102,40,1819,1921,213,253,12829,51,20,0,0
Armor-Fill-End,10714,1637,7,18,242,249,184,202,12830,0,0,0,0
Flag-1,10715,1637,64,64,155,219,627,691,12831,0,0,0,0
Flag-2,10716,1637,64,64,1,65,705,769,12832,0,0,0,0
Icon-Healer,10717,1637,64,64,133,197,705,769,12833,0,0,0,0
Icon-Tank,10718,1637,64,64,1,65,771,835,12834,0,0,0,0
_Armor-Fill-mid,10719,1637,8,18,0,8,114,132,12835,0,0,4,0
_Health_mid,10720,1637,5,18,0,5,154,172,12836,0,0,4,0
CommentatorSpellBorder,10721,1637,50,50,175,225,573,623,12837,0,0,0,0
ui-dailyquestpoicampaign-questbang,10726,1555,32,32,1,33,67,99,15677,0,0,0,0
ui-dailyquestpoicampaign-questbangturnin,10727,1555,32,32,67,99,1,33,15678,0,0,0,0
quest-dailycampaign-available,10728,647,32,32,887,919,477,509,15679,0,0,0,0
quest-dailycampaign-turnin,10729,647,32,32,921,953,477,509,15680,0,0,0,0
campaignactivedailyquesticon,10730,1642,24,24,1,25,1,25,15681,16,16,0,0
campaignactivequesticon,10731,1642,24,24,1,25,27,51,15682,16,16,0,0
campaignavailabledailyquesticon,10732,1642,24,24,27,51,1,25,15683,16,16,0,0
campaignavailablequesticon,10733,1642,24,24,27,51,27,51,15684,16,16,0,0
campaignincompletequesticon,10734,1642,24,24,53,77,1,25,15685,16,16,0,0
Frame-Timer,10735,1637,118,52,1,119,573,625,15686,0,0,0,0
Healing-BG,10736,1637,75,76,1,76,627,703,15687,0,0,0,0
Score-Team,10739,1637,52,52,121,173,573,625,15689,0,0,0,0
_Score-Team-mid,10740,1637,28,47,0,28,1,48,15690,0,0,4,0
Portrait-Frame-Nameplate-scaledup,10741,1637,92,93,1,93,478,571,15691,0,0,0,0
Flag-outline,10742,1637,64,64,67,131,705,769,15692,0,0,0,0
Navigation-Tombstone-Icon,10746,1546,26,33,1,27,1,34,15696,0,0,0,0
DK-Rune-Ready,10747,893,32,32,35,67,35,67,15703,0,0,0,0
ClassOverlay-ComboPoint-Kyrian,10749,728,20,21,29,49,21,42,15699,0,0,0,0
ClassOverlay-ComboPoint-Off-Kyrian,10750,728,20,21,51,71,21,42,15700,0,0,0,0
ComboPoints-ComboPoint-Kyrian,10751,728,20,21,73,93,21,42,15701,0,0,0,0
ComboPoints-PointBg-Kyrian,10752,728,20,21,95,115,21,42,15702,0,0,0,0
auctionhouse-icon-clock,10753,1495,24,24,982,1006,347,371,11503,0,0,0,0
DK-Base-Rune-CDFill,10754,894,32,32,37,69,40,72,15704,0,0,0,0
Icon-Death,10756,1637,128,128,1,129,266,394,15706,0,0,0,0
tradeskills-icon-add,10757,734,39,39,62,101,386,425,15707,0,0,0,0
shadowlands-landingpage-soulbindsbutton-down,10758,1636,482,126,1,483,176,302,15708,241,63,0,0
shadowlands-landingpage-soulbindsbutton-draven,10759,1636,482,126,1,483,304,430,15709,241,63,0,0
shadowlands-landingpage-soulbindsbutton-dreamweaver,10760,1636,482,126,1332,1814,1,127,15710,241,63,0,0
shadowlands-landingpage-soulbindsbutton-emeni,10761,1636,482,126,485,967,432,558,15711,241,63,0,0
shadowlands-landingpage-soulbindsbutton-heirmir,10762,1636,482,126,1,483,560,686,15712,241,63,0,0
shadowlands-landingpage-soulbindsbutton-highlight,10763,1636,482,126,1,483,688,814,15713,241,63,0,0
shadowlands-landingpage-soulbindsbutton-kleia,10764,1636,482,126,969,1451,304,430,15714,241,63,0,0
shadowlands-landingpage-soulbindsbutton-korayn,10765,1636,482,126,1,483,816,942,15715,241,63,0,0
shadowlands-landingpage-soulbindsbutton-marileth,10766,1636,482,126,848,1330,1,127,15716,241,63,0,0
shadowlands-landingpage-soulbindsbutton-mikanikos,10767,1636,482,126,364,846,1,127,15717,241,63,0,0
shadowlands-landingpage-soulbindsbutton-nadjia,10768,1636,482,126,485,967,176,302,15718,241,63,0,0
shadowlands-landingpage-soulbindsbutton-niya,10769,1636,482,126,1453,1935,304,430,15719,241,63,0,0
shadowlands-landingpage-soulbindsbutton-pelagos,10770,1636,482,126,1453,1935,432,558,15720,241,63,0,0
shadowlands-landingpage-soulbindsbutton-theotar,10772,1636,482,126,485,967,560,686,15722,241,63,0,0
Soulbind_Shot_Venthyr_Nadjia,10773,1570,629,558,1,630,1,559,15723,419,372,0,0
Soulbind_Shot_Venthyr_Theotar,10774,1570,608,558,632,1240,1,559,15724,405,372,0,0
Soulbind_Shot_Kyrian_Kleia,10775,1643,603,558,1,604,1,559,15725,402,372,0,0
Soulbind_Shot_Kyrian_Mikanikos,10776,1643,578,558,606,1184,1,559,15726,385,372,0,0
Soulbind_Shot_Kyrian_Pelagos,10777,1643,578,558,1186,1764,1,559,15727,385,372,0,0
Icon-WoW,10778,1637,75,72,78,153,627,699,15728,0,0,0,0
charactercreate-druidform-aquatic,10779,897,64,64,1,65,911,975,15729,0,0,0,0
charactercreate-druidform-bear,10780,897,64,64,131,195,911,975,15730,0,0,0,0
charactercreate-druidform-cat,10781,897,64,64,261,325,911,975,15731,0,0,0,0
charactercreate-druidform-flight,10782,897,64,64,391,455,911,975,15732,0,0,0,0
charactercreate-druidform-moonkin,10783,897,64,64,521,585,911,975,15733,0,0,0,0
charactercreate-druidform-travel,10784,897,64,64,651,715,911,975,15734,0,0,0,0
weeklyrewards-background-mythic,10821,1646,326,131,1,327,48,179,15771,0,0,0,0
weeklyrewards-background-raid,10822,1646,326,131,1,327,314,445,15772,0,0,0,0
weeklyrewards-background-pvp,10823,1646,326,131,1,327,181,312,15773,0,0,0,0
oribos-weeklyrewards-frame-button,10824,1646,237,26,443,680,10,36,21388,0,0,0,0
oribos-weeklyrewards-orb-unlocked,10825,1646,212,119,1534,1746,103,222,21391,0,0,0,0
weeklyrewards-frame-item-epic,10826,1646,155,49,1,156,447,496,15776,0,0,0,0
weeklyrewards-icon-unlocked,10827,1646,24,24,708,732,10,34,15777,0,0,0,0
weeklyrewards-background-reward-locked,10828,1646,212,119,329,541,103,222,15778,0,0,0,0
weeklyrewards-icon-incomplete,10829,1646,24,24,682,706,10,34,15779,0,0,0,0
weeklyrewards-orb-locked,10830,1646,212,119,329,541,345,464,15780,0,0,0,0
weeklyrewards-frame-reward-selected,10831,1646,224,131,543,767,258,389,15781,0,0,0,0
weeklyrewards-shadow-reward-unselected,10832,1646,224,131,1748,1972,103,234,15782,0,0,0,0
weeklyrewards-frame-reward-locked,10833,1646,219,126,801,1020,103,229,15783,0,0,0,0
weeklyrewards-glow-redeem-epic,10834,1646,149,89,1383,1532,103,192,15784,0,0,0,0
oribos-weeklyrewards-divider,10835,1646,1057,7,443,1500,1,8,21386,0,0,0,0
oribos-weeklyrewards-frame-mode,10836,1646,359,137,1022,1381,103,240,21389,0,0,0,0
weeklyrewards-frame-reward-unlocked,10837,1646,219,126,801,1020,231,357,15787,0,0,0,0
weeklyrewards-background-reward-unlocked,10838,1646,212,119,329,541,224,343,15788,0,0,0,0
Soulbinds_Background_Necrolord,10839,1577,888,607,1,889,1,608,12295,0,0,0,0
jailerstower-animapowerlist-highlight,10840,1550,45,45,54,99,440,485,15789,0,0,0,0
jailerstower-animapowerlist-powerborder,10841,1550,51,51,1,52,440,491,15790,0,0,0,0
Metal-Bar-Small,10842,1637,172,80,1,173,396,476,15791,0,0,0,0
Portrait-Frame-Small,10843,1637,86,86,95,181,478,564,15792,0,0,0,0
tradeskills-iconborder-glow,10844,734,59,59,1,60,386,445,15797,0,0,0,0
newplayerchat-chaticon-guide,10845,924,30,26,1,31,99,125,15798,15,13,0,0
newplayerchat-chaticon-newcomer,10846,924,30,30,1,31,35,65,15799,15,15,0,0
chromietime-portrait-small-burningcrusade,10853,1565,312,173,1,313,1049,1222,15806,208,115,0,0
chromietime-portrait-small-cataclysm,10854,1565,312,173,1,313,1224,1397,15807,208,115,0,0
chromietime-portrait-small-legion,10855,1565,312,173,1,313,1399,1572,15808,208,115,0,0
chromietime-portrait-small-mistsofpandaria,10856,1565,312,173,1,313,1574,1747,15809,208,115,0,0
chromietime-portrait-small-warlordsofdraenor,10857,1565,312,173,404,716,769,942,15810,208,115,0,0
chromietime-portrait-small-wrathofthelichking,10858,1565,312,173,718,1030,769,942,15811,208,115,0,0
chromietime-portrait-large-burningcrusade,10859,1565,489,254,1387,1876,1,255,15812,326,169,0,0
chromietime-portrait-large-cataclysm,10860,1565,489,254,404,893,257,511,15813,326,169,0,0
chromietime-portrait-large-legion,10861,1565,489,254,895,1384,257,511,15814,326,169,0,0
chromietime-portrait-large-mistsofpandaria,10862,1565,489,254,1386,1875,257,511,15815,326,169,0,0
chromietime-portrait-large-warlordsofdraenor,10863,1565,489,254,895,1384,513,767,15816,326,169,0,0
chromietime-portrait-large-wrathofthelichking,10864,1565,489,254,1386,1875,513,767,15817,326,169,0,0
NightFae-NineSlice-CornerBottomLeft,10865,1647,166,166,774,940,152,318,15818,0,0,0,0
NightFae-NineSlice-CornerBottomRight,10866,1647,166,166,1,167,761,927,15819,0,0,0,0
NightFae-NineSlice-CornerTopLeft,10867,1647,166,166,1,167,593,759,15820,0,0,0,0
NightFae-NineSlice-CornerTopRight,10868,1647,166,166,649,815,592,758,15821,0,0,0,0
UI-Frame-NightFae-ExitButtonBorder,10869,1647,33,32,169,202,593,625,15822,0,0,0,0
UI-Frame-NightFae-TitleLeft,10870,1647,202,85,817,1019,592,677,15823,0,0,0,0
UI-Frame-NightFae-TitleRight,10871,1647,202,85,817,1019,679,764,15824,0,0,0,0
_NightFae-NineSlice-EdgeBottom,10872,1647,256,30,0,256,33,63,15825,0,0,4,0
_NightFae-NineSlice-EdgeTop,10873,1647,256,30,0,256,1,31,15826,0,0,4,0
_UI-Frame-NightFae-TitleMiddle,10874,1647,128,85,0,128,65,150,15827,0,0,4,0
!NightFae-NineSlice-EdgeLeft,10875,1648,30,256,1,31,0,256,15828,0,0,2,0
!NightFae-NineSlice-EdgeRight,10876,1648,30,256,33,63,0,256,15829,0,0,2,0
NightFae-NineSlice-Center,10877,1649,256,256,0,256,0,256,15880,0,0,6,0
UI-Frame-Venthyr-TitleLeft,10878,1650,202,85,240,442,152,237,15831,0,0,0,0
UI-Frame-Venthyr-TitleRight,10879,1650,202,85,1,203,152,237,15832,0,0,0,0
Venthyr-NineSlice-CornerBottomLeft,10880,1650,166,166,1,167,350,516,15833,0,0,0,0
Venthyr-NineSlice-CornerBottomRight,10881,1650,166,166,1,167,686,852,15834,0,0,0,0
Venthyr-NineSlice-CornerTopLeft,10882,1650,166,166,1,167,518,684,15835,0,0,0,0
Venthyr-NineSlice-CornerTopRight,10883,1650,166,166,1,167,854,1020,15836,0,0,0,0
_UI-Frame-Venthyr-TitleMiddle,10884,1650,128,85,0,128,65,150,15837,0,0,4,0
_Venthyr-NineSlice-EdgeBottom,10885,1650,256,30,0,256,33,63,15838,0,0,4,0
_Venthyr-NineSlice-EdgeTop,10886,1650,256,30,0,256,1,31,15839,0,0,4,0
!Venthyr-NineSlice-EdgeLeft,10887,1651,30,256,1,31,0,256,15840,0,0,2,0
!Venthyr-NineSlice-EdgeRight,10888,1651,30,256,33,63,0,256,15841,0,0,2,0
Venthyr-NineSlice-Center,10889,1652,256,256,0,256,0,256,15879,0,0,6,0
UI-Frame-Venthyr-ExitButtonBorder,10890,1650,33,32,205,238,152,184,15843,0,0,0,0
Kyrian-NineSlice-CornerBottomLeft,10891,1610,166,166,1,167,320,486,12689,0,0,0,0
Kyrian-NineSlice-CornerBottomRight,10892,1610,166,166,1,167,488,654,12690,0,0,0,0
Kyrian-NineSlice-CornerTopLeft,10893,1610,166,166,1,167,152,318,12691,0,0,0,0
Kyrian-NineSlice-CornerTopRight,10894,1610,166,166,1,167,656,822,12692,0,0,0,0
_Kyrian-NineSlice-EdgeBottom,10895,1610,256,30,0,256,1,31,12693,0,0,4,0
_Kyrian-NineSlice-EdgeTop,10896,1610,256,30,0,256,120,150,12694,0,0,4,0
Kyrian-NineSlice-Center,10897,1611,256,256,0,256,0,256,12405,0,0,6,0
necrolord-nineslice-cornerbottomleft,10898,1653,166,166,649,815,592,758,15845,0,0,0,0
necrolord-nineslice-cornerbottomright,10899,1653,166,166,1,167,761,927,15846,0,0,0,0
necrolord-nineslice-cornertopleft,10900,1653,166,166,1,167,593,759,15847,0,0,0,0
necrolord-nineslice-cornertopright,10901,1653,166,166,774,940,152,318,15848,0,0,0,0
ui-frame-necrolord-exitbuttonborder,10902,1653,33,32,169,202,593,625,15849,0,0,0,0
ui-frame-necrolord-titleleft,10903,1653,202,85,774,976,431,516,15850,0,0,0,0
ui-frame-necrolord-titleright,10904,1653,202,85,817,1019,703,788,15851,0,0,0,0
_necrolord-nineslice-edgebottom,10905,1653,256,30,0,256,120,150,15852,0,0,4,0
_necrolord-nineslice-edgetop,10906,1653,256,30,0,256,88,118,15853,0,0,4,0
_ui-frame-necrolord-titlemiddle,10907,1653,128,85,0,128,1,86,15854,0,0,4,0
!Necrolord-NineSlice-EdgeLeft,10908,1654,30,256,1,31,0,256,15855,0,0,2,0
!Necrolord-NineSlice-EdgeRight,10909,1654,30,256,33,63,0,256,15856,0,0,2,0
Necrolord-NineSlice-Center,10910,1655,256,256,0,256,0,256,15881,0,0,6,0
runecarving-background-smoke,10911,1656,588,676,1,589,1,677,15858,0,0,0,0
runecarving-frame-glow,10912,1656,448,454,1,449,1135,1589,15859,0,0,0,0
runecarving-frame-runes,10913,1656,448,454,1,449,1591,2045,15860,0,0,0,0
runecarving-frame,10914,1656,448,454,1,449,679,1133,15861,0,0,0,0
runecarving-icon-arrow-open,10915,1656,35,24,927,962,322,346,15862,0,0,0,0
runecarving-icon-bag-item-glow,10916,1656,63,62,901,964,753,815,15863,0,0,0,0
runecarving-icon-center-empty,10917,1656,88,88,591,679,371,459,15864,0,0,0,0
runecarving-icon-center-pressed,10918,1656,88,88,591,679,461,549,15865,0,0,0,0
runecarving-icon-center-selected,10919,1656,88,88,591,679,551,639,15866,0,0,0,0
runecarving-icon-power-empty,10920,1656,78,78,771,849,461,539,15867,0,0,0,0
runecarving-icon-power-pressed,10921,1656,78,78,771,849,541,619,15868,0,0,0,0
runecarving-icon-power-selected,10922,1656,78,78,851,929,461,539,15869,0,0,0,0
runecarving-icon-reagent-empty,10923,1656,49,50,972,1021,1,51,15870,0,0,0,0
runecarving-icon-reagent-pressed,10924,1656,49,50,972,1021,53,103,15871,0,0,0,0
runecarving-icon-reagent-selected,10925,1656,48,49,972,1020,208,257,15872,0,0,0,0
runecarving-menu-power-background,10926,1656,300,368,591,891,1,369,15873,0,0,0,0
runecarving-menu-power-border,10927,1656,72,72,927,999,541,613,15874,0,0,0,0
runecarving-menu-power-selected,10928,1656,72,72,901,973,679,751,15875,0,0,0,0
runecarving-menu-reagent-background,10929,1656,77,243,893,970,1,244,15876,0,0,0,0
maw-tooltip-topper,10931,1658,95,27,1,96,29,56,15877,0,0,0,0
unitframeicon-chromietime,10932,1659,58,62,1,59,1,63,15878,29,31,0,0
weeklyrewards-background-currency-unlocked,10933,1646,440,45,1,441,1,46,15882,0,0,0,0
oribos-weeklyrewards-divider-currency,10934,1646,195,7,1502,1697,1,8,21387,0,0,0,0
weeklyrewards-frame-currency-selected,10935,1646,450,53,329,779,48,101,15884,0,0,0,0
weeklyrewards-frame-currency-unlocked,10936,1646,440,45,781,1221,48,93,15885,0,0,0,0
weeklyrewards-shadow-currency-unselected,10937,1646,450,53,1223,1673,48,101,15886,0,0,0,0
newplayerchat-signup-background,10938,1660,329,582,1,330,1,583,15887,0,0,0,0
covenantsanctum-background-necrolord,10939,1661,644,585,260,904,63,648,15888,0,0,0,0
covenantsanctum-divider-necrolord,10940,1661,24,585,906,930,63,648,15889,0,0,0,0
covenantsanctum-icon-border-necrolord,10941,1661,128,128,50,178,885,1013,15890,0,0,0,0
covenantsanctum-upgrade-border-necrolord,10944,1661,257,56,562,819,1,57,15893,0,0,0,0
covenantchoice-offering-ability-frame-nightfae,10945,1662,63,127,277,340,871,998,15894,0,0,0,0
covenantchoice-offering-ability-ring-nightfae,10946,1662,80,82,415,495,438,520,15895,0,0,0,0
covenantchoice-offering-parchment-nightfae,10947,1662,557,435,1,558,1,436,15896,0,0,0,0
covenantchoice-offering-preview-frame-nightfae,10948,1662,414,432,560,974,1,433,15897,0,0,0,0
covenantchoice-offering-sigil-nightfae,10949,1662,69,70,342,411,871,941,15898,0,0,0,0
covenantchoice-offering-ability-frame-necrolord,10950,1663,63,127,277,340,871,998,15899,0,0,0,0
covenantchoice-offering-ability-ring-necrolord,10951,1663,80,82,415,495,438,520,15900,0,0,0,0
covenantchoice-offering-parchment-necrolord,10952,1663,557,435,1,558,1,436,15901,0,0,0,0
covenantchoice-offering-preview-frame-necrolord,10953,1663,414,432,560,974,1,433,15902,0,0,0,0
covenantchoice-offering-sigil-necrolord,10954,1663,70,85,342,412,871,956,15903,0,0,0,0
covenantsanctum-level-border-kyrian,10956,1608,243,76,1,244,926,1002,15904,0,0,0,0
covenantsanctum-level-border-necrolord,10959,1661,243,76,606,849,908,984,15905,0,0,0,0
covenantsanctum-level-border-nightfae,10960,1640,243,76,1,244,926,1002,15906,0,0,0,0
covenantsanctum-level-border-venthyr,10961,1639,243,76,1,244,926,1002,15907,0,0,0,0
bonusloot-chest,10962,332,78,78,856,934,1,79,15908,0,0,0,0
embercourt-guest-alexandrosmograine,10963,647,36,36,203,239,952,988,15909,0,0,0,0
embercourt-guest-baronessvashj,10964,647,36,36,261,297,263,299,15910,0,0,0,0
embercourt-guest-choofa,10965,647,36,36,261,297,301,337,15911,0,0,0,0
embercourt-guest-countess,10966,647,36,36,261,297,339,375,15912,0,0,0,0
embercourt-guest-cryptkeeperkassir,10967,647,36,36,261,297,377,413,15913,0,0,0,0
embercourt-guest-dromanaliothe,10968,647,36,36,261,297,453,489,15914,0,0,0,0
embercourt-guest-grandmastervole,10969,647,36,36,261,297,491,527,15915,0,0,0,0
embercourt-guest-huntcaptainkorayn,10970,647,36,36,261,297,529,565,15916,0,0,0,0
embercourt-guest-kleia,10971,647,36,36,261,297,567,603,15917,0,0,0,0
embercourt-guest-ladymoonberry,10972,647,36,36,261,297,605,641,15918,0,0,0,0
embercourt-guest-mikanikos,10973,647,36,36,261,297,643,679,15919,0,0,0,0
embercourt-guest-plaguedevisermarileth,10974,647,36,36,261,297,719,755,15920,0,0,0,0
embercourt-guest-polemarchadrestes,10975,647,36,36,261,297,757,793,15921,0,0,0,0
embercourt-guest-princerenathal,10976,647,36,36,261,297,795,831,15922,0,0,0,0
embercourt-guest-rendle,10977,647,36,36,261,297,833,869,15923,0,0,0,0
embercourt-guest-sika,10978,647,36,36,261,297,871,907,15924,0,0,0,0
embercourt-guest-stonehead,10979,647,36,36,261,297,909,945,15925,0,0,0,0
adventure-buff-indicator,10980,1557,31,19,982,1013,1015,1034,15926,0,0,0,0
adventure-heal-indicator,10981,1557,24,24,659,683,961,985,15927,0,0,0,0
adventures-target-indicator-desat,10982,1557,53,56,482,535,1165,1221,15928,0,0,0,0
adventures-target-indicator,10983,1557,53,56,427,480,1165,1221,15929,0,0,0,0
runecarving-icon-reagent-border,10986,1656,48,49,972,1020,157,206,15936,0,0,0,0
runecarving-icon-reagent-selectedother,10987,1656,48,49,972,1020,259,308,15937,0,0,0,0
runecarving-menu-reagent-selected,10988,1656,48,49,972,1020,310,359,15938,0,0,0,0
worldstate-capturebar-leftfill-white,10989,901,4,9,0,4,300,309,15939,0,0,4,0
worldstate-capturebar-neutralfill-white,10990,901,4,9,0,4,355,364,15940,0,0,4,0
worldstate-capturebar-rightfill-white,10991,901,4,9,0,4,410,419,15941,0,0,4,0
worldstate-capturebar-spark-white,10992,901,5,18,249,254,499,517,15942,0,0,0,0
UI-Frame-Venthyr-CardParchment,10993,1650,254,439,686,940,559,998,12362,0,0,0,0
UI-Frame-Venthyr-CardParchmentWider,10994,1650,515,438,169,684,559,997,15944,0,0,0,0
UI-Frame-Venthyr-DisableSubtitle,10995,1650,207,30,444,651,152,182,15945,0,0,0,0
UI-Frame-Venthyr-Portrait,10996,1650,205,109,1,206,239,348,15946,0,0,0,0
UI-Frame-Venthyr-PortraitDisable,10997,1650,205,109,208,413,239,348,15947,0,0,0,0
UI-Frame-Venthyr-PortraitWider,10998,1650,390,207,561,951,350,557,15948,0,0,0,0
UI-Frame-Venthyr-PortraitWiderDisable,10999,1650,390,207,169,559,350,557,15949,0,0,0,0
UI-Frame-Venthyr-Ribbon,11000,1650,281,84,653,934,152,236,15950,0,0,0,0
UI-Frame-Venthyr-Subtitle,11001,1650,207,30,444,651,184,214,15951,0,0,0,0
covenantchoice-offering-preview-frame-background-kyrian,11002,1592,412,431,1,413,438,869,15952,0,0,0,0
covenantchoice-offering-preview-frame-background-necrolord,11004,1663,412,431,1,413,438,869,15954,0,0,0,0
covenantchoice-offering-preview-frame-background-nightfae,11005,1662,412,431,1,413,438,869,15955,0,0,0,0
covenantchoice-offering-preview-frame-background-venthyr,11006,1593,412,431,1,413,438,869,15956,0,0,0,0
UI-Frame-Kyrian-CardParchment,11007,1610,254,439,169,423,361,800,12356,0,0,0,0
UI-Frame-Kyrian-CardParchmentWider,11008,1610,515,438,425,940,361,799,15957,0,0,0,0
UI-Frame-Kyrian-DisableSubtitle,11009,1610,207,30,561,768,152,182,15958,0,0,0,0
UI-Frame-Kyrian-Portrait,11010,1610,205,109,169,374,802,911,15959,0,0,0,0
UI-Frame-Kyrian-PortraitDisable,11011,1610,205,109,169,374,913,1022,15960,0,0,0,0
UI-Frame-Kyrian-PortraitWider,11012,1610,390,207,169,559,152,359,15961,0,0,0,0
UI-Frame-Kyrian-PortraitWiderDisable,11013,1610,390,207,425,815,801,1008,15962,0,0,0,0
UI-Frame-Kyrian-Ribbon,11014,1610,281,84,561,842,184,268,15963,0,0,0,0
UI-Frame-Kyrian-Subtitle,11015,1610,207,30,770,977,152,182,15964,0,0,0,0
ui-frame-necrolord-cardparchment,11016,1653,254,439,1,255,152,591,15965,0,0,0,0
ui-frame-necrolord-cardparchmentwider,11017,1653,515,438,257,772,152,590,15966,0,0,0,0
ui-frame-necrolord-disablesubtitle,11018,1653,207,30,1,208,929,959,15967,0,0,0,0
ui-frame-necrolord-portraitdisable,11019,1653,205,109,774,979,320,429,15968,0,0,0,0
ui-frame-necrolord-portraitwider,11020,1653,390,207,257,647,592,799,15969,0,0,0,0
ui-frame-necrolord-portraitwiderdisable,11021,1653,390,207,540,930,801,1008,15970,0,0,0,0
ui-frame-necrolord-ribbon,11022,1653,281,84,257,538,801,885,15971,0,0,0,0
ui-frame-necrolord-subtitle,11023,1653,207,30,1,208,961,991,15972,0,0,0,0
ui-frame-necrolords-portrait,11024,1653,205,109,817,1022,592,701,15973,0,0,0,0
UI-Frame-NightFae-CardParchment,11025,1647,254,439,1,255,152,591,12358,0,0,0,0
UI-Frame-NightFae-CardParchmentWider,11026,1647,515,438,257,772,152,590,15974,0,0,0,0
UI-Frame-NightFae-DisableSubtitle,11027,1647,207,30,1,208,929,959,15975,0,0,0,0
UI-Frame-NightFae-Portrait,11028,1647,205,109,774,979,431,540,15976,0,0,0,0
UI-Frame-NightFae-PortraitDisable,11029,1647,205,109,774,979,320,429,15977,0,0,0,0
UI-Frame-NightFae-PortraitWider,11030,1647,390,207,257,647,592,799,15978,0,0,0,0
UI-Frame-NightFae-PortraitWiderDisable,11031,1647,390,207,257,647,801,1008,15979,0,0,0,0
UI-Frame-NightFae-Ribbon,11032,1647,281,84,649,930,801,885,15980,0,0,0,0
UI-Frame-NightFae-Subtitle,11033,1647,207,30,1,208,961,991,15981,0,0,0,0
worldstate-capturebar-arrow-embercourt,11034,901,9,15,210,219,499,514,15982,0,0,0,0
worldstate-capturebar-frame-casualformal-embercourt,11035,901,196,26,1,197,499,525,15983,0,0,0,0
worldstate-capturebar-frame-humbledecadent-embercourt,11036,901,196,26,1,197,527,553,15984,0,0,0,0
worldstate-capturebar-frame-messyclean-embercourt,11037,901,196,26,1,197,555,581,15985,0,0,0,0
worldstate-capturebar-frame-relaxingexciting-embercourt,11038,901,196,26,1,197,583,609,15986,0,0,0,0
worldstate-capturebar-frame-safedangerous-embercourt,11039,901,196,26,1,197,611,637,15987,0,0,0,0
worldstate-capturebar-leftfill-casualformal-embercourt,11041,901,4,10,0,4,16,26,15989,0,0,4,0
worldstate-capturebar-leftfill-humbledecadent-embercourt,11042,901,4,10,0,4,28,38,15990,0,0,4,0
worldstate-capturebar-leftfill-messyclean-embercourt,11043,901,4,10,0,4,40,50,15991,0,0,4,0
worldstate-capturebar-leftfill-relaxingexciting-embercourt,11044,901,4,10,0,4,52,62,15992,0,0,4,0
worldstate-capturebar-leftfill-safedangerous-embercourt,11045,901,4,10,0,4,64,74,15993,0,0,4,0
worldstate-capturebar-leftfill-shadow-casualformal-embercourt,11046,901,4,10,0,4,76,86,15994,0,0,4,0
worldstate-capturebar-leftfill-shadow-humbledecadent-embercourt,11047,901,4,10,0,4,88,98,15995,0,0,4,0
worldstate-capturebar-leftfill-shadow-messyclean-embercourt,11048,901,4,10,0,4,100,110,15996,0,0,4,0
worldstate-capturebar-leftfill-shadow-relaxingexciting-embercourt,11049,901,4,10,0,4,112,122,15997,0,0,4,0
worldstate-capturebar-leftfill-shadow-safedangerous-embercourt,11050,901,4,10,0,4,124,134,15998,0,0,4,0
worldstate-capturebar-leftglow-casualformal-embercourt,11051,901,27,28,165,192,421,449,15999,0,0,0,0
worldstate-capturebar-leftglow-humbledecadent-embercourt,11052,901,27,28,223,250,421,449,16000,0,0,0,0
worldstate-capturebar-leftglow-messyclean-embercourt,11053,901,27,28,194,221,460,488,16001,0,0,0,0
worldstate-capturebar-leftglow-relaxingexciting-embercourt,11054,901,27,28,223,250,460,488,16002,0,0,0,0
worldstate-capturebar-leftglow-safedangerous-embercourt,11055,901,27,28,1,28,802,830,16003,0,0,0,0
worldstate-capturebar-rightfill-casualformal-embercourt,11056,901,4,10,0,4,136,146,16004,0,0,4,0
worldstate-capturebar-rightfill-humbledecadent-embercourt,11057,901,4,10,0,4,148,158,16005,0,0,4,0
worldstate-capturebar-rightfill-messyclean-embercourt,11058,901,4,10,0,4,160,170,16006,0,0,4,0
worldstate-capturebar-rightfill-relaxingexciting-embercourt,11059,901,4,10,0,4,172,182,16007,0,0,4,0
worldstate-capturebar-rightfill-safedangerous-embercourt,11060,901,4,10,0,4,184,194,16008,0,0,4,0
worldstate-capturebar-rightfill-shadow-casualformal-embercourt,11061,901,4,10,0,4,196,206,16009,0,0,4,0
worldstate-capturebar-rightfill-shadow-humbledecadent-embercourt,11062,901,4,10,0,4,208,218,16010,0,0,4,0
worldstate-capturebar-rightfill-shadow-messyclean-embercourt,11063,901,4,10,0,4,220,230,16011,0,0,4,0
worldstate-capturebar-rightfill-shadow-relaxingexciting-embercourt,11064,901,4,10,0,4,232,242,16012,0,0,4,0
worldstate-capturebar-rightfill-shadow-safedangerous-embercourt,11065,901,4,10,0,4,244,254,16013,0,0,4,0
worldstate-capturebar-rightglow-casualformal-embercourt,11066,901,27,28,1,28,832,860,16014,0,0,0,0
worldstate-capturebar-rightglow-humbledecadent-embercourt,11067,901,27,28,1,28,892,920,16015,0,0,0,0
worldstate-capturebar-rightglow-messyclean-embercourt,11068,901,27,28,1,28,952,980,16016,0,0,0,0
worldstate-capturebar-rightglow-relaxingexciting-embercourt,11069,901,27,28,1,28,982,1010,16017,0,0,0,0
worldstate-capturebar-rightglow-safedangerous-embercourt,11070,901,27,28,30,57,802,830,16018,0,0,0,0
eyeofthejailer-state0-background,11139,1664,120,120,123,243,1,121,16087,0,0,0,0
eyeofthejailer-state0-backgroundglow,11140,1664,214,178,461,675,245,423,16088,0,0,0,0
eyeofthejailer-state0-border,11141,1664,120,120,339,459,245,365,16089,0,0,0,0
eyeofthejailer-state0-transitionglow,11142,1664,120,120,589,709,123,243,16090,0,0,0,0
eyeofthejailer-state1-background,11143,1664,120,120,1,121,809,929,16091,0,0,0,0
eyeofthejailer-state1-backgroundglow,11144,1664,214,178,367,581,425,603,16092,0,0,0,0
eyeofthejailer-state1-border,11145,1664,120,120,123,243,669,789,16093,0,0,0,0
eyeofthejailer-state1-transitionglow,11147,1664,120,120,245,365,425,545,16095,0,0,0,0
eyeofthejailer-state2-background,11148,1664,120,120,245,365,123,243,16096,0,0,0,0
eyeofthejailer-state2-backgroundglow,11149,1664,214,178,790,1004,245,423,16097,0,0,0,0
eyeofthejailer-state2-border,11150,1664,120,120,123,243,425,545,16098,0,0,0,0
eyeofthejailer-state2-transitionglow,11153,1664,120,120,123,243,547,667,16101,0,0,0,0
eyeofthejailer-state3-background,11154,1664,120,120,245,365,547,667,16102,0,0,0,0
eyeofthejailer-state3-backgroundglow,11155,1664,214,178,799,1013,425,603,16103,0,0,0,0
eyeofthejailer-state3-border,11156,1664,120,120,245,365,791,911,16104,0,0,0,0
eyeofthejailer-state3-transitionglow,11158,1664,120,120,489,609,605,725,16106,0,0,0,0
eyeofthejailer-state4-background,11159,1664,120,120,1,121,245,365,16107,0,0,0,0
eyeofthejailer-state4-backgroundglow,11160,1664,214,178,583,797,425,603,16108,0,0,0,0
eyeofthejailer-state4-border,11161,1664,120,120,367,487,849,969,16109,0,0,0,0
eyeofthejailer-state4-transitionglow,11167,1664,120,120,855,975,1,121,16115,0,0,0,0
eyeofthejailer-state5-background,11168,1664,120,120,733,853,605,725,16116,0,0,0,0
eyeofthejailer-state5-backgroundglow,11169,1664,214,178,123,337,245,423,16117,0,0,0,0
eyeofthejailer-state5-border,11170,1664,120,120,711,831,123,243,16118,0,0,0,0
eyeofthejailer-state5-transitionglow,11175,1664,120,120,855,975,727,847,16123,0,0,0,0
eyeofthejailer-state4-borderglow1,11176,1664,120,120,1,121,1,121,16124,0,0,0,0
eyeofthejailer-state5-borderglow2,11177,1664,120,120,611,731,727,847,16125,0,0,0,0
worldstate-capturebar-spark-casualformal-embercourt,11179,901,11,30,30,41,914,944,16127,0,0,0,0
worldstate-capturebar-spark-humbledecadent-embercourt,11180,901,11,30,43,54,914,944,16128,0,0,0,0
worldstate-capturebar-spark-messyclean-embercourt,11181,901,11,30,30,41,946,976,16129,0,0,0,0
worldstate-capturebar-spark-relaxingexciting-embercourt,11182,901,11,30,43,54,946,976,16130,0,0,0,0
worldstate-capturebar-spark-safedangerous-embercourt,11183,901,11,30,30,41,978,1008,16131,0,0,0,0
worldstate-capturebar-divider-casualformal-embercourt,11184,901,4,10,231,235,1,11,16132,0,0,0,0
worldstate-capturebar-divider-humbledecadent-embercourt,11185,901,4,10,237,241,1,11,16133,0,0,0,0
worldstate-capturebar-divider-messyclean-embercourt,11186,901,4,10,243,247,1,11,16134,0,0,0,0
worldstate-capturebar-divider-relaxingexciting-embercourt,11187,901,4,10,249,253,1,11,16135,0,0,0,0
worldstate-capturebar-divider-safedangerous-embercourt,11188,901,4,10,199,203,527,537,16136,0,0,0,0
eyeofthejailer-state5-borderglow3,11190,1664,111,118,611,722,849,967,16138,0,0,0,0
eyeofthejailer-state5-borderglow4,11191,1664,98,99,245,343,913,1012,16139,0,0,0,0
eyeofthejailer-state1-centereffect1,11192,1664,120,120,467,587,123,243,16140,0,0,0,0
eyeofthejailer-state2-centereffect1,11193,1664,120,120,733,853,1,121,16141,0,0,0,0
eyeofthejailer-state2-centereffect2,11194,1664,120,120,367,487,1,121,16142,0,0,0,0
eyeofthejailer-state3-centereffect1,11195,1664,120,120,245,365,669,789,16143,0,0,0,0
eyeofthejailer-state3-centereffect3,11196,1664,120,120,367,487,605,725,16144,0,0,0,0
eyeofthejailer-state3-centereffect5,11197,1664,120,120,367,487,727,847,16145,0,0,0,0
eyeofthejailer-state4-centereffect1,11198,1664,120,120,489,609,1,121,16146,0,0,0,0
eyeofthejailer-state4-centereffect2,11199,1664,120,120,611,731,1,121,16147,0,0,0,0
eyeofthejailer-state4-centereffect3,11200,1664,120,120,489,609,847,967,16148,0,0,0,0
eyeofthejailer-state4-centereffect4,11201,1664,120,120,611,731,605,725,16149,0,0,0,0
eyeofthejailer-state5-centereffect1,11202,1664,120,120,733,853,727,847,16150,0,0,0,0
eyeofthejailer-state5-centereffect2,11203,1664,120,120,123,243,123,243,16151,0,0,0,0
eyeofthejailer-state5-centereffect3,11204,1664,120,120,1,121,123,243,16152,0,0,0,0
eyeofthejailer-state5-centereffect4,11205,1664,120,120,245,365,1,121,16153,0,0,0,0
eyeofthejailer-state0-transitionglow2,11216,1664,111,118,677,788,245,363,16164,0,0,0,0
eyeofthejailer-state0-transitionglow3,11217,1664,98,99,833,931,123,222,16165,0,0,0,0
eyeofthejailer-state1-transitionglow2,11218,1664,111,118,123,234,791,909,16166,0,0,0,0
eyeofthejailer-state1-transitionglow3,11219,1664,98,99,367,465,123,222,16167,0,0,0,0
eyeofthejailer-state2-transitionglow2,11220,1664,111,118,1,112,468,586,16168,0,0,0,0
eyeofthejailer-state2-transitionglow3,11221,1664,98,99,1,99,708,807,16169,0,0,0,0
eyeofthejailer-state3-transitionglow2,11222,1664,111,118,489,600,727,845,16170,0,0,0,0
eyeofthejailer-state3-transitionglow3,11223,1664,98,99,1,99,367,466,16171,0,0,0,0
eyeofthejailer-state4-transitionglow2,11224,1664,111,118,855,966,605,723,16172,0,0,0,0
eyeofthejailer-state4-transitionglow3,11225,1664,98,99,123,221,911,1010,16173,0,0,0,0
eyeofthejailer-state5-transitionglow2,11226,1664,111,118,1,112,588,706,16174,0,0,0,0
eyeofthejailer-state5-transitionglow3,11227,1664,98,99,733,831,849,948,16175,0,0,0,0
worldstate-capturebar-framebar-bastionarmor,11229,901,162,37,1,163,421,458,12823,0,0,0,0
eyeofthejailer-step1-disable,11230,1664,29,27,977,1006,30,57,16176,0,0,0,0
eyeofthejailer-step1-enable,11231,1664,29,27,977,1006,1,28,16177,0,0,0,0
eyeofthejailer-step2-disable,11232,1664,34,25,1,35,931,956,16178,0,0,0,0
eyeofthejailer-step2-enable,11233,1664,34,25,977,1011,59,84,16179,0,0,0,0
eyeofthejailer-step3-disable,11234,1664,31,33,32,63,958,991,16180,0,0,0,0
eyeofthejailer-step3-enable,11235,1664,31,33,977,1008,86,119,16181,0,0,0,0
eyeofthejailer-step4-disable,11236,1664,29,27,1,30,987,1014,16182,0,0,0,0
eyeofthejailer-step4-enable,11237,1664,29,27,1,30,958,985,16183,0,0,0,0
eyeofthejailer-step5-disable,11238,1664,30,28,32,62,993,1021,16184,0,0,0,0
eyeofthejailer-step5-enable,11239,1664,30,28,933,963,123,151,16185,0,0,0,0
ui-frame-kyrianchoice-cardparchment,11264,1589,252,464,256,508,556,1020,16210,0,0,0,0
ui-frame-necrolordschoice-cardparchment,11265,1589,252,464,255,507,1491,1955,16211,0,0,0,0
ui-frame-nightfaechoice-cardparchment,11266,1589,252,464,1,253,1025,1489,16212,0,0,0,0
ui-frame-venthyrchoice-cardparchment,11267,1589,252,464,1,253,1491,1955,16213,0,0,0,0
adventure-debuff-indicator,11268,1557,29,19,202,231,1649,1668,16214,0,0,0,0
adventures_missioncoststartbuttonbg,11269,1557,376,51,291,667,1040,1091,16215,0,0,0,0
UI-Frame-KyrianChoice-ScrollingBG,11270,1594,1026,577,1,1027,1,578,16216,0,0,0,0
ui-frame-nightfaechoice-scrollingbg,11271,1597,1026,577,1,1027,1,578,16217,0,0,0,0
UI-Frame-VenthyrChoice-ScrollingBG,11272,1595,1026,577,1,1027,1,578,16218,0,0,0,0
soulbinds_tree_undo,11273,1578,36,34,1300,1336,1,35,16219,18,17,0,0
ui-frame-necrolordschoice-scrollingbg,11274,1596,1026,577,1,1027,580,1157,16220,0,0,0,0
soulbinds_tree_conduit_arrows,11275,1578,100,100,1560,1660,49,149,16221,50,50,0,0
_pvpqueue-conquestbar-fill-blue,11276,1234,256,17,517,773,1,18,16222,0,0,0,0
pvpqueue-chest-greatvault-collect,11277,1665,312,300,1,313,303,603,16223,156,150,0,0
pvpqueue-chest-greatvault-complete,11278,1665,312,300,1,313,605,905,16224,156,150,0,0
pvpqueue-chest-greatvault-incomplete,11279,1665,312,300,315,627,303,603,16225,156,150,0,0
_pvpqueue-conquestbar-fill-disabled,11280,1234,256,17,757,1013,426,443,16226,0,0,0,0
Adventures-Missions-Shadow,11281,1666,900,900,1,901,1,901,16227,0,0,0,0
adventures-divider,11282,1557,53,13,927,980,1015,1028,16228,0,0,0,0
adventures-infinite,11283,1557,15,9,1005,1020,424,433,16229,0,0,0,0
soulbinds_tree_conduit_arrows_socketed,11284,1578,66,66,1819,1885,238,304,16230,0,0,0,0
Soulbinds_Link_Spirits,11285,1667,256,1024,0,256,0,1024,16231,16,64,6,0
EmberCourtScenario-TrackerHeader,11286,1668,243,77,246,489,155,232,16233,0,0,0,0
runecarving-upgrade-icon-center-empty,11287,1656,88,88,681,769,371,459,16234,0,0,0,0
runecarving-upgrade-icon-center-pressed,11288,1656,88,88,681,769,461,549,16235,0,0,0,0
runecarving-upgrade-icon-slot-empty,11289,1656,74,74,893,967,246,320,16236,0,0,0,0
runecarving-upgrade-icon-slot-pressed,11290,1656,74,74,851,925,541,615,16237,0,0,0,0
runecarving-upgrade-slot-background,11291,1656,74,62,927,1001,615,677,16238,0,0,0,0
ui-frame-bar-bordertick,11292,1253,17,31,75,92,182,213,16239,0,0,0,0
jailerstower-wayfinder-background,11293,1669,807,569,1,808,1,570,16240,0,0,0,0
jailerstower-wayfinder-exitborder,11294,1669,32,30,958,990,214,244,16241,0,0,0,0
jailerstower-wayfinder-rewardbackground-disable,11295,1669,145,69,810,955,72,141,16242,0,0,0,0
jailerstower-wayfinder-rewardbackground-mouseover,11296,1669,146,32,810,956,214,246,16243,0,0,0,0
jailerstower-wayfinder-rewardbackground-selected,11297,1669,146,32,810,956,248,280,16244,0,0,0,0
jailerstower-wayfinder-rewardbackground,11298,1669,145,69,810,955,1,70,16245,0,0,0,0
jailerstower-wayfinder-rewardcheckmark,11299,1669,42,43,980,1022,143,186,16246,0,0,0,0
jailerstower-wayfinder-rewardcircle,11300,1669,40,40,810,850,282,322,16247,0,0,0,0
jailerstower-wayfinder-rewardglow,11301,1669,56,56,957,1013,1,57,16248,0,0,0,0
jailerstower-wayfinder-rewardpadlock,11302,1669,44,52,957,1001,72,124,16249,0,0,0,0
jailerstower-wayfinder-tierbackground-mouseover,11303,1669,83,69,810,893,143,212,16250,0,0,0,0
jailerstower-wayfinder-tierbackground-selected,11304,1669,83,69,895,978,143,212,16251,0,0,0,0
jailerstower-wayfinder-tierbackground-skoldushall,11305,1670,91,91,1,92,1,92,16252,0,0,0,0
soulbinds_tree_activatefx,11306,1578,700,1518,357,1057,376,1894,16253,350,759,0,0
mythicplus-greatvault-collect,11315,1244,390,344,1,391,352,696,16262,195,172,0,0
mythicplus-greatvault-complete,11316,1244,390,344,503,893,1,345,16263,195,172,0,0
mythicplus-greatvault-incomplete,11317,1244,390,344,503,893,347,691,16264,195,172,0,0
charactercreate-customize-palette-glow,11318,708,84,20,1923,2007,235,255,16265,42,10,0,0
jailerstower-skull-1,11319,1669,36,44,810,846,324,368,16266,0,0,0,0
jailerstower-skull-2,11320,1669,36,44,810,846,370,414,16267,0,0,0,0
jailerstower-skull-3,11321,1669,36,44,810,846,416,460,16268,0,0,0,0
poi-soulspiritghost,11322,647,32,34,137,169,989,1023,16269,16,17,0,0
poi-torghast,11323,647,58,62,929,987,197,259,16270,29,31,0,0
soulbinds_portrait_lock,11324,1578,63,76,1662,1725,49,125,16271,0,0,0,0
conduiticonframe-corners,11325,1671,64,64,67,131,1,65,16272,0,0,0,0
conduiticonframe,11326,1671,64,64,1,65,1,65,16273,0,0,0,0
jailerstower-scenario-skull1,11327,1550,23,23,185,208,440,463,16274,0,0,0,0
jailerstower-scenario-skull2,11328,1550,23,23,143,166,482,505,16275,0,0,0,0
jailerstower-scenario-skull3,11329,1550,23,25,101,124,482,507,16276,0,0,0,0
Adventure_MissionParchment,11330,1672,256,256,0,256,0,256,16277,0,0,6,0
jailerstower-wayfinder-tierbackground-coldheartinterstitia,11331,1670,91,91,1,92,94,185,16278,0,0,0,0
jailerstower-wayfinder-tierbackground-fracturechambers,11332,1670,91,91,94,185,1,92,16279,0,0,0,0
jailerstower-wayfinder-tierbackground-mortregar,11333,1670,91,91,94,185,94,185,16280,0,0,0,0
jailerstower-wayfinder-tierbackground-soulforges,11334,1670,91,91,187,278,1,92,16281,0,0,0,0
jailerstower-wayfinder-tierbackground-theupperreaches,11335,1670,91,91,187,278,94,185,16282,0,0,0,0
jailerstower-wayfinder-tierbackground-twistingcorridors,11336,1670,91,91,280,371,1,92,16283,0,0,0,0
soulbinds_tree_activatefx_runes1,11337,1578,146,476,85,231,1506,1982,16284,0,0,0,0
soulbinds_tree_activatefx_runes2,11338,1578,128,600,1059,1187,1236,1836,16285,0,0,0,0
soulbinds_tree_activatefx_lensflare,11339,1578,1367,187,23,1390,49,236,16286,0,0,0,0
EmberCourtScenario-TitleBG,11340,1668,467,141,1,468,12,153,16287,0,0,0,0
EmberCourtScenario-Tracker-frame,11341,1668,243,77,1,244,155,232,16288,0,0,0,0
EmberCourtScenario-Tracker-barfill,11342,1668,231,9,0,231,1,10,16289,0,0,4,0
covenantchoice-celebration-background,11343,1673,414,260,1,415,1,261,16290,0,0,0,0
covenantchoice-celebration-kyriancloudyline,11344,1673,362,67,417,779,70,137,16291,0,0,0,0
covenantchoice-celebration-kyriansigil,11345,1673,59,93,919,978,356,449,16292,0,0,0,0
covenantchoice-celebration-necrolordsigil,11347,1673,77,95,689,766,356,451,16294,0,0,0,0
covenantchoice-celebration-nightfaecloudyline,11348,1673,362,67,1,363,332,399,16295,0,0,0,0
covenantchoice-celebration-nightfaesigil,11349,1673,79,80,768,847,356,436,16296,0,0,0,0
covenantchoice-celebration-venthyrsigil,11351,1673,68,90,849,917,356,446,16298,0,0,0,0
ShadowlandsMissionsLandingPage-Background-Kyrian,11352,1674,201,232,1,202,1,233,16299,0,0,0,0
ShadowlandsMissionsLandingPage-Background-Venthyr,11353,1675,201,232,1,202,1,233,16300,0,0,0,0
ShadowlandsMissionsLandingPage-Background-NightFae,11354,1676,201,232,1,202,1,233,16301,0,0,0,0
runecarving-frame-item-legendary,11356,1656,155,49,861,1016,371,420,16303,0,0,0,0
charactercreate-customize-palette-half,11357,708,84,20,519,603,471,491,16304,42,10,0,0
covenantsanctum-bag-glow-kyrian,11358,1608,204,72,993,1197,775,847,16305,0,0,0,0
covenantsanctum-icon-glow-kyrian,11359,1608,128,128,477,605,882,1010,16306,0,0,0,0
covenantsanctum-bag-glow-necrolord,11361,1661,204,72,50,254,811,883,16308,0,0,0,0
covenantsanctum-icon-glow-necrolord,11362,1661,128,128,1190,1318,650,778,16309,0,0,0,0
covenantsanctum-bag-glow-nightfae,11364,1640,204,72,993,1197,775,847,16311,0,0,0,0
covenantsanctum-icon-glow-nightfae,11365,1640,128,128,477,605,882,1010,16312,0,0,0,0
covenantsanctum-bag-glow-venthyr,11367,1639,204,72,993,1197,517,589,16314,0,0,0,0
covenantsanctum-icon-glow-venthyr,11368,1639,128,128,347,475,882,1010,16315,0,0,0,0
groupfinder-background-torghast,11370,236,333,96,1001,1334,295,391,16317,0,0,0,0
groupfinder-button-torghast,11371,236,290,36,915,1205,393,429,16318,0,0,0,0
groupfinder-background-raids-shadowlands,11372,236,333,96,1001,1334,197,293,16319,0,0,0,0
groupfinder-button-raids-shadowlands,11373,236,290,36,1,291,969,1005,16320,0,0,0,0
shop-card-full-npe-gametime,11374,1678,568,463,1,569,1,464,16321,0,0,0,0
shop-card-full-npe-subscription,11375,1678,568,463,1,569,466,929,16322,0,0,0,0
interstitial-newplayerexperience-subscribe,11376,1679,1600,960,1,1601,1,961,16323,800,480,0,0
interstitial-newplayerexperience-upgrade,11377,1679,1600,960,1,1601,963,1923,16324,800,480,0,0
interstitial-newplayerexperience-upgrade-bullet,11378,1679,10,10,1603,1613,1,11,16325,5,5,0,0
ShadowlandsMissionsLandingPage-Background-Necrolord,11379,1677,201,232,1,202,1,233,16326,0,0,0,0
soulbinds_background,11380,1576,888,876,1,889,1,877,16327,0,0,0,0
soulbinds_collection_conduit_border,11381,1578,64,64,1727,1791,171,235,16328,32,32,0,0
soulbinds_collection_conduit_border_glass,11382,1578,64,64,1964,2028,49,113,16329,32,32,0,0
soulbinds_collection_conduit_shadow,11383,1578,56,56,1500,1556,165,221,16330,0,0,0,0
Soulbinds_Collection_Conduit_Mask,11384,1680,64,64,0,64,0,64,16331,32,32,16,0
soulbinds_collection_categoryheader,11385,1578,432,46,1,433,1,47,16332,216,23,0,0
soulbinds_collection_categoryheader_collapse,11386,1578,38,38,627,665,1,39,16333,19,19,0,0
soulbinds_collection_categoryheader_expand,11387,1578,38,38,535,573,1,39,16334,19,19,0,0
soulbinds_collection_scrollbar_background,11389,1578,20,1548,23,43,376,1924,16336,0,0,0,0
soulbinds_collection_scrollbar_thumb,11390,1578,4,1044,79,83,726,1770,16337,2,522,0,0
soulbinds_collection_scrollbar_backplate,11392,1578,32,876,45,77,376,1252,16339,0,0,0,0
adventures-buff-heal-burst,11393,1557,129,138,686,815,806,944,16340,0,0,0,0
adventures-buff-heal-ring,11394,1557,109,109,817,926,806,915,16341,0,0,0,0
runecarving-exitborder,11395,1656,32,30,893,925,322,352,16342,0,0,0,0
kyrian-scenario-TitleBG,11396,1681,467,141,1,468,1,142,16343,0,0,0,0
kyrian-scenario-TrackerHeader,11397,1681,243,77,1,244,144,221,16344,0,0,0,0
soulbinds_tree_conduit_ring_pendinganimation_glow,11398,1578,124,126,85,209,1378,1504,16345,62,63,0,0
soulbinds_tree_conduit_ring_pendinganimation_dot,11399,1578,24,24,575,599,1,25,16346,12,12,0,0
soulbinds_collection_conduit_pendinganimation_mask,11400,1682,64,64,0,64,0,64,16347,0,0,16,0
soulbinds_tree_conduit_ring_pendinganimation_stick,11401,1578,10,59,1,11,1095,1154,16348,0,0,0,0
charactercreate-vignette-sides-widescreen,11402,708,89,1,1,90,2041,2042,16349,0,0,0,0
soulbinds_collection_conduit_pending,11403,1578,40,20,667,707,19,39,16350,20,10,0,0
worldmap-highlight-cosmic-Shadowlands,11406,1310,460,400,451,911,1,401,16353,0,0,0,0
soulbinds_collection_scrollbar_arrow_down,11407,1578,40,34,1258,1298,1,35,16354,20,17,0,0
soulbinds_collection_scrollbar_arrow_up,11408,1578,40,34,435,475,1,35,16355,20,17,0,0
adventures-dps-ranged,11409,1557,28,30,537,565,1197,1227,16356,0,0,0,0
soulbinds_collection_shadow,11410,1578,242,16,667,909,1,17,16357,0,0,0,0
shadowlands-landingbutton-venthyr-highlight,11411,1609,65,65,269,334,68,133,16358,0,0,0,0
loottoast-oribos,11412,332,276,96,1,277,414,510,16359,0,0,0,0
covenantsanctum-currency-shadow,11413,1606,316,26,603,919,100,126,16360,0,0,0,0
runecarving-frame-center-lit,11414,1656,448,454,451,899,679,1133,16361,0,0,0,0
runecarving-frame-runes-lit,11415,1656,448,454,451,899,1135,1589,16362,0,0,0,0
runecarving-frame-upgrade-center-lit,11416,1656,448,454,451,899,1591,2045,16363,0,0,0,0
GenericMetal2-NineSlice-CornerBottomLeft,11417,1683,128,128,1,129,261,389,16364,64,64,0,0
GenericMetal2-NineSlice-CornerBottomRight,11418,1683,128,128,131,259,261,389,16365,64,64,0,0
GenericMetal2-NineSlice-CornerTopLeft,11419,1683,128,128,261,389,261,389,16366,64,64,0,0
GenericMetal2-NineSlice-CornerTopRight,11420,1683,128,128,391,519,261,389,16367,64,64,0,0
_GenericMetal2-NineSlice-EdgeBottom,11421,1683,1024,128,0,1024,1,129,16368,512,64,4,0
_GenericMetal2-NineSlice-EdgeTop,11422,1683,1024,128,0,1024,131,259,16369,512,64,4,0
!GenericMetal2-NineSlice-EdgeLeft,11423,1684,128,1024,1,129,0,1024,16370,64,512,2,0
!GenericMetal2-NineSlice-EdgeRight,11424,1684,128,1024,131,259,0,1024,16371,64,512,2,0
Glues-AnnouncementPopup-Line,11426,821,411,2,1,412,963,965,16373,0,0,0,0
Glues-AnnouncementPopup-Parchment-Bottom,11427,821,541,184,1,542,777,961,16374,0,0,0,0
Glues-AnnouncementPopup-Parchment-Middle,11428,821,540,126,803,1343,1,127,16375,0,0,0,0
Glues-AnnouncementPopup-Parchment-Top,11429,821,541,239,1,542,536,775,16376,0,0,0,0
quickkeybind_bagmicro_glow,11430,1685,360,153,224,584,826,979,16377,0,0,0,0
quickkeybind_bottombarextended_glow,11431,1685,1078,119,853,1931,259,378,16378,0,0,0,0
quickkeybind_bottombar_glow,11432,1685,825,119,224,1049,482,601,16379,0,0,0,0
quickkeybind_sidebar_glow,11433,1685,221,627,1,222,259,886,16380,0,0,0,0
quickkeybind_topleftbar_glow,11434,1685,627,221,224,851,259,480,16381,0,0,0,0
quickkeybind_toprightbar_glow,11435,1685,375,221,224,599,603,824,16382,0,0,0,0
_quickkeybind_bottom_shadow,11436,1685,16,256,0,16,1,257,16383,0,0,4,0
!quickkeybind_side_shadow,11437,1686,286,16,1,287,0,16,16384,0,0,2,0
accountupgradebanner-shadowlands,11438,558,200,134,203,403,137,271,16385,0,0,0,0
covenantchoice-celebration-kyrian-detailline,11439,1673,362,67,417,779,1,68,16386,0,0,0,0
covenantchoice-celebration-necrolord-detailline,11440,1673,362,67,1,363,263,330,16387,0,0,0,0
covenantchoice-celebration-nightfae-detailline,11441,1673,362,67,1,363,401,468,16388,0,0,0,0
covenantchoice-celebration-venthyr-detailline-zhcn,11442,1673,362,67,417,779,208,275,17287,0,0,0,0
covenantchoice-celebration-venthyr-detailline,11443,1673,362,67,417,779,139,206,16390,0,0,0,0
ui-ej-memoryframe,11444,207,407,76,1,408,1,77,16391,0,0,0,0
ui-ej-shadowlands,11445,1304,786,425,789,1575,428,853,16392,0,0,0,0
Glues-AnnouncementPopup-Background,11446,1687,512,512,0,512,0,512,16372,256,256,6,0
adventures-spell-border,11447,1557,68,67,151,219,1865,1932,16393,0,0,0,0
adventures-rewards-banner,11448,1557,304,45,669,973,1040,1085,16394,0,0,0,0
adventures_mission_materialframe,11449,1557,316,43,291,607,1120,1163,16395,0,0,0,0
adventurers-frame-shadow,11450,1557,103,103,1,104,1567,1670,16396,0,0,0,0
streamcinematic-shadowlands-down,11451,557,176,78,357,533,241,319,16397,0,0,0,0
streamcinematic-shadowlands-up,11452,557,176,78,535,711,161,239,16398,0,0,0,0
warmode-broker-32x32,11454,647,32,32,615,647,681,713,16400,24,24,0,0
adventures-mission-follower-tutorial-ring,11455,1557,108,108,111,219,1457,1565,16401,0,0,0,0
_creditsscreen-gradient-tile,11456,1689,16,178,0,16,1,179,16402,0,0,4,0
creditsscreen-background-1,11457,1690,512,512,0,512,0,512,16403,0,0,6,0
creditsscreen-background-6,11458,1691,512,512,0,512,0,512,16404,0,0,6,0
creditsscreen-background-8,11459,1692,512,512,0,512,0,512,16405,0,0,6,0
creditsscreen-keyart-1,11460,1693,1425,966,1,1426,1,967,16406,0,0,0,0
creditsscreen-keyart-6,11461,1694,1425,966,1,1426,1,967,16407,0,0,0,0
creditsscreen-keyart-8,11462,1695,1425,966,1,1426,1,967,16408,0,0,0,0
adventures-combatlog-bg,11463,1696,336,567,1,337,1,568,16409,0,0,0,0
adventures-combatlog-frame,11464,1696,336,567,339,675,1,568,16410,0,0,0,0
adventures-followers-bg,11465,1696,311,508,677,988,1,509,16411,0,0,0,0
adventures-followers-frame,11466,1696,311,508,677,988,511,1019,16412,0,0,0,0
animachannel-line-mask,11467,1697,64,64,0,64,0,64,16413,0,0,16,0
mixingpool-frame-fill-white,11468,1638,138,13,67,205,21,34,16414,0,0,0,0
animachannel-line-reinforce-mask,11469,1698,64,64,0,64,0,64,16415,0,0,16,0
tradeskills-icon-locked,11470,734,39,39,62,101,427,466,16416,0,0,0,0
covenantchoice-celebration-kyrianglowline,11471,1673,324,18,1,325,470,488,16417,0,0,0,0
covenantchoice-celebration-necrolordglowline,11472,1673,324,18,1,325,490,508,16418,0,0,0,0
covenantchoice-celebration-nightfaeglowline,11473,1673,324,18,694,1018,277,295,16419,0,0,0,0
covenantchoice-celebration-toastbg,11474,1673,275,77,417,692,277,354,16420,0,0,0,0
covenantchoice-celebration-venthyrglowline,11475,1673,322,18,694,1016,317,335,16421,0,0,0,0
covenantchoice-celebration-venthyrglowline-zhcn,11476,1673,322,18,694,1016,297,315,17288,0,0,0,0
covenantchoice-celebration-content-soulbind,11477,1673,140,138,417,557,356,494,16423,70,69,0,0
covenantchoice-celebration-content-ring,11478,1673,128,128,559,687,356,484,16424,64,64,0,0
creditsscreen-keyart-0,11479,1699,1425,966,1,1426,1,967,16425,0,0,0,0
creditsscreen-background-0,11480,1700,512,512,0,512,0,512,16426,0,0,6,0
creditsscreen-keyart-2,11481,1701,1425,966,1,1426,1,967,16427,0,0,0,0
creditsscreen-background-2,11482,1702,512,512,0,512,0,512,16428,0,0,6,0
creditsscreen-keyart-3,11483,1703,1425,966,1,1426,1,967,16429,0,0,0,0
creditsscreen-background-3,11484,1704,512,512,0,512,0,512,16430,0,0,6,0
creditsscreen-keyart-4,11485,1705,1425,966,1,1426,1,967,16431,0,0,0,0
creditsscreen-background-4,11486,1706,512,512,0,512,0,512,16432,0,0,6,0
creditsscreen-keyart-5,11487,1707,1425,966,1,1426,1,967,16433,0,0,0,0
creditsscreen-background-5,11488,1708,512,512,0,512,0,512,16434,0,0,6,0
creditsscreen-background-7,11489,1709,512,512,0,512,0,512,16435,0,0,6,0
creditsscreen-keyart-7,11490,1710,1425,966,1,1426,1,967,16436,0,0,0,0
chromietime-32x32,11491,647,32,32,377,409,409,441,16437,22,22,0,0
_adventures-frame-shadow,11493,1557,8,26,0,8,310,336,16438,0,0,4,0
ui-frame-necrolordschoice-cardparchment-zhcn,11494,1589,252,464,255,507,1025,1489,17289,0,0,0,0
ui-frame-necrolordschoice-scrollingbg-zhcn,11495,1596,1026,577,1,1027,1,578,17283,0,0,0,0
covenantsanctum-background-necrolord-zhcn,11496,1661,644,585,932,1576,63,648,17290,0,0,0,0
adventures-endcombat-venthyr-zhcn,11498,1557,500,232,1,501,806,1038,17291,0,0,0,0
teleportationnetwork-32x32,11499,647,32,32,547,579,545,577,16444,24,24,0,0
creditsscreen-highlight,11500,1689,480,63,1,481,1213,1276,16445,0,0,0,0
creditsscreen-selected,11501,1689,480,63,1,481,1278,1341,16446,0,0,0,0
questbg-parchment,11502,1711,299,407,1,300,1,408,16447,0,0,0,0
_animachannel-channel-line-horizontal-kyrian,11508,1625,32,32,0,32,137,169,16453,0,0,4,0
_animachannel-channel-line-horizontal-necrolord,11509,1625,32,32,0,32,1,33,16454,0,0,4,0
_animachannel-channel-line-horizontal-nightfae,11510,1625,32,32,0,32,35,67,16455,0,0,4,0
_animachannel-channel-line-horizontal-venthyr,11511,1625,32,32,0,32,171,203,16456,0,0,4,0
animachannel-link-anima-black,11512,1688,128,512,391,519,0,512,16457,16,64,2,0
animachannel-link-anima-kyrian,11513,1688,128,512,521,649,0,512,16458,16,64,2,0
animachannel-link-anima-necrolord,11514,1688,128,512,131,259,0,512,16459,16,64,2,0
animachannel-link-anima-nightfae,11515,1688,128,512,261,389,0,512,16460,16,64,2,0
animachannel-link-anima-venthyr,11516,1688,128,512,1,129,0,512,16461,16,64,2,0
animachannel-link-anima-venthyr-zhcn,11517,1688,128,512,651,779,0,512,17285,16,64,2,0
_animachannel-channel-line-horizontal-venthyr-zhcn,11518,1625,32,32,0,32,69,101,17286,0,0,4,0
callings-header-kyrian,11519,1712,608,62,1,609,1,63,16464,0,0,0,0
callings-header-necrolord,11520,1712,608,62,1,609,65,127,16465,0,0,0,0
callings-header-nightfae,11521,1712,608,62,611,1219,1,63,16466,0,0,0,0
callings-header-venthyr,11522,1712,608,62,611,1219,65,127,16467,0,0,0,0
callingsheader_selectedglow,11523,1712,608,62,1221,1829,1,63,16468,0,0,0,0
splash-901-botleft,11524,1713,137,371,374,511,589,960,16469,0,0,0,0
splash-901-right,11525,1713,510,586,1,511,1,587,16470,0,0,0,0
splash-901-topleft,11526,1713,371,434,1,372,589,1023,16471,0,0,0,0
splash-902-botleft,11527,1714,137,371,374,511,587,958,16472,0,0,0,0
splash-902-right,11528,1714,510,584,1,511,1,585,16473,0,0,0,0
splash-902-topleft,11529,1714,371,434,1,372,587,1021,16474,0,0,0,0
adventures_missionlist,11532,1717,843,93,1,844,1,94,16477,0,0,0,0
adventures_missionlist_highlight,11533,1717,843,93,1,844,96,189,16478,0,0,0,0
adventures_missionlist_inprogress,11534,1717,843,93,1,844,191,284,16479,0,0,0,0
questbg-bastion,11537,1720,299,407,1,300,1,408,11846,0,0,0,0
questbg-maldraxxus,11540,1721,299,407,1,300,1,408,12093,0,0,0,0
questbg-revendreth,11541,1722,299,407,1,300,1,408,11942,0,0,0,0
questbg-kyrian,11542,1723,299,407,1,300,1,408,12088,0,0,0,0
questbg-necrolord,11543,1724,299,407,1,300,1,408,12094,0,0,0,0
questbg-venthyr,11544,1725,299,407,1,300,1,408,12089,0,0,0,0
jailerstower-animapowerlist-powerborder-white,11545,1550,40,40,930,970,80,120,16482,0,0,0,0
queensconservatory-seedborder,11546,1726,79,79,347,426,1,80,16483,0,0,0,0
queensconservatory-seedborder-highlight,11547,1726,79,79,428,507,1,80,16484,0,0,0,0
adventurers-followers-frame-troops,11552,1557,94,96,927,1021,917,1013,16489,0,0,0,0
jailerstower-animapowerlist-powerborder-blue,11553,1550,40,40,101,141,440,480,16490,0,0,0,0
jailerstower-animapowerlist-powerborder-green,11554,1550,40,40,143,183,440,480,16491,0,0,0,0
jailerstower-animapowerlist-powerborder-purple,11555,1550,40,40,973,1013,1,41,16492,0,0,0,0
queensconservatory-bg,11556,1726,344,166,1,345,1,167,16493,0,0,0,0
campaign_oribos,11557,1552,608,138,611,1219,281,419,16494,0,0,0,2
callings-backhighlight,11558,1727,45,46,1,46,49,95,16495,0,0,0,0
callings-tophighlight,11559,1727,43,43,48,91,1,44,16496,0,0,0,0
questbg-shadowlands,11560,1554,299,407,1,300,1,408,12126,0,0,0,0
questbg-ardenweald,11561,1728,299,407,1,300,1,408,12086,0,0,0,0
questbg-fey,11562,1729,299,407,1,300,1,408,12087,0,0,0,0
questbg-oribos,11563,1730,299,407,1,300,1,408,16497,0,0,0,0
covenantsanctum-upgrade-icon-border-nightfae,11564,1640,47,47,246,293,926,973,16499,0,0,0,0
covenantsanctum-upgrade-icon-border-disabled,11565,1606,47,47,260,307,339,386,16500,0,0,0,0
covenantsanctum-upgrade-icon-border-kyrian,11566,1608,47,47,246,293,926,973,16501,0,0,0,0
covenantsanctum-upgrade-icon-border-necrolord,11567,1661,47,47,1,48,811,858,16502,0,0,0,0
covenantsanctum-upgrade-icon-border-venthyr,11568,1639,47,47,246,293,926,973,16503,0,0,0,0
covenantsanctum-reservoir-empty-kyrian,11569,1608,344,336,1,345,588,924,12379,0,0,0,0
covenantsanctum-reservoir-full-kyrian,11570,1608,344,336,647,991,1,337,12380,0,0,0,0
covenantsanctum-reservoir-glow-kyrian,11571,1608,344,336,647,991,339,675,16307,0,0,0,0
covenantsanctum-reservoir-spark-glow-kyrian,11572,1608,300,60,647,947,935,995,16504,0,0,0,0
covenantsanctum-reservoir-spark-kyrian,11573,1608,300,60,1251,1551,1,61,16505,0,0,0,0
covenantsanctum-reservoir-empty-necrolord,11574,1661,344,336,1578,1922,63,399,15891,0,0,0,0
covenantsanctum-reservoir-full-necrolord,11575,1661,344,336,1578,1922,401,737,15892,0,0,0,0
covenantsanctum-reservoir-glow-necrolord,11576,1661,344,336,260,604,650,986,16310,0,0,0,0
covenantsanctum-reservoir-spark-glow-necrolord,11577,1661,300,60,260,560,1,61,16506,0,0,0,0
covenantsanctum-reservoir-spark-necrolord,11578,1661,300,60,821,1121,1,61,16507,0,0,0,0
covenantsanctum-reservoir-empty-nightfae,11579,1640,344,336,1,345,588,924,12769,0,0,0,0
covenantsanctum-reservoir-full-nightfae,11580,1640,344,336,647,991,1,337,12770,0,0,0,0
covenantsanctum-reservoir-glow-nightfae,11581,1640,344,336,647,991,339,675,16313,0,0,0,0
covenantsanctum-reservoir-spark-glow-nightfae,11582,1640,300,60,647,947,935,995,16508,0,0,0,0
covenantsanctum-reservoir-spark-nightfae,11583,1640,300,60,1251,1551,259,319,16509,0,0,0,0
covenantsanctum-reservoir-empty-venthyr,11584,1639,344,336,1,345,588,924,12763,0,0,0,0
covenantsanctum-reservoir-full-venthyr-zhcn2,11585,1639,344,336,647,991,339,675,17281,0,0,0,0
covenantsanctum-reservoir-full-venthyr,11586,1639,344,336,647,991,677,1013,12768,0,0,0,0
covenantsanctum-reservoir-glow-venthyr,11587,1639,344,336,647,991,1,337,16316,0,0,0,0
covenantsanctum-reservoir-spark-glow-venthyr,11588,1639,300,60,1553,1853,1,61,16511,0,0,0,0
covenantsanctum-reservoir-spark-venthyr,11589,1639,300,60,1251,1551,1,61,16512,0,0,0,0
soulbinds_background_noconduits,11597,1576,318,876,1,319,879,1755,16513,0,0,0,0
powerswirlanimation-spinningglowys-soulbinds,11598,1486,70,70,415,485,73,143,16514,0,0,0,0
powerswirlanimation-starburst-soulbinds,11599,1486,133,133,280,413,1,134,16515,0,0,0,0
powerswirlanimation-yellowring-soulbinds,11600,1486,100,100,1,101,382,482,16516,0,0,0,0
powerswirlanimation-whirls-soulbinds,11601,1486,149,105,287,436,145,250,16517,0,0,0,0
barbershop-32x32,11602,647,32,32,887,919,375,407,16518,24,24,0,0
mixingpool-frame-bordercenter,11604,1638,64,31,1,65,21,52,16521,0,0,0,0
mixingpool-frame-borderleft,11605,1638,35,31,1,36,93,124,16522,0,0,0,0
mixingpool-frame-borderright,11606,1638,35,31,106,141,36,67,16523,0,0,0,0
mixingpool-bgcenter,11607,1638,64,18,0,64,1,19,16519,0,0,4,0
mixingpool-bgleft,11608,1638,29,18,106,135,69,87,16527,0,0,0,0
mixingpool-bgright,11609,1638,29,18,106,135,89,107,16528,0,0,0,0
torghastdoor-32x32,11610,647,32,32,751,783,545,577,16529,24,24,0,0
torghastdoor-arrowdown-32x32,11611,647,32,32,785,817,545,577,16530,24,24,0,0
torghastdoor-arrowleft-32x32,11612,647,32,32,819,851,545,577,16531,24,24,0,0
torghastdoor-arrowright-32x32,11613,647,32,32,853,885,545,577,16532,24,24,0,0
torghastdoor-arrowup-32x32,11614,647,32,32,887,919,545,577,16533,24,24,0,0
_garrmissionlocation-maw-mid,11615,1731,1024,285,0,1024,1,286,16534,0,0,4,0
covenantsanctum-text-border-kyrian,11616,1608,257,292,347,604,588,880,16535,0,0,0,0
covenantsanctum-text-border-necrolord,11617,1661,257,292,1,258,1,293,16536,0,0,0,0
covenantsanctum-text-border-nightfae,11618,1640,257,292,347,604,588,880,16537,0,0,0,0
128-goldredbutton-left-disabled,11619,1732,114,128,295,409,651,779,16538,0,0,0,0
128-goldredbutton-left-pressed,11620,1732,114,128,295,409,781,909,16539,0,0,0,0
128-goldredbutton-left,11621,1732,114,128,295,409,521,649,16540,0,0,0,0
128-goldredbutton-right-disabled,11622,1732,292,128,1,293,651,779,16541,0,0,0,0
128-goldredbutton-right-pressed,11623,1732,292,128,1,293,781,909,16542,0,0,0,0
128-goldredbutton-right,11624,1732,292,128,1,293,521,649,16543,0,0,0,0
128-store-main,11625,1732,64,64,444,508,391,455,16544,0,0,0,0
_128-goldredbutton-center-disabled,11626,1732,64,128,0,64,131,259,16545,0,0,4,0
_128-goldredbutton-center-pressed,11627,1732,64,128,0,64,261,389,16546,0,0,4,0
_128-goldredbutton-center,11628,1732,64,128,0,64,1,129,16547,0,0,4,0
128-redbutton-exit-pressed,11629,871,128,128,261,389,1171,1299,16548,0,0,0,0
128-redbutton-exit-disabled,11630,871,128,128,1,129,1171,1299,16549,0,0,0,0
128-redbutton-exit,11631,871,128,128,261,389,1041,1169,16550,0,0,0,0
128-goldredbutton-highlight,11632,1732,441,128,1,442,391,519,16551,0,0,0,0
16-store-main,11633,1732,16,16,444,460,457,473,16552,0,0,0,0
weeklyrewards-frame-burst,11634,1646,256,153,543,799,103,256,16553,0,0,0,0
weeklyrewards-frame-sheen,11635,1646,130,130,801,931,359,489,16554,0,0,0,0
soulbinds_collection_entry_highlight,11636,1578,484,80,509,993,238,318,16555,242,40,0,0
soulbinds_collection_entry_selected,11637,1578,484,80,995,1479,238,318,16556,242,40,0,0
soulbinds_collection_entry_glow,11638,1578,484,136,23,507,238,374,16557,242,68,0,0
embercourt-guest-cudgelface,11639,647,36,36,261,297,415,451,16558,0,0,0,0
embercourt-guest-pelagos,11640,647,36,36,261,297,681,717,16559,0,0,0,0
soulbinds_portrait_newlabel_shadow,11641,1578,100,34,1156,1256,1,35,16560,0,0,0,0
covenantsanctum-text-border-venthyr,11642,1639,257,292,347,604,588,880,16561,0,0,0,0
soulbinds_collection_specborder_primary,11643,1578,48,48,1392,1440,157,205,16562,24,24,0,0
soulbinds_collection_specborder_secondary,11644,1578,48,48,1610,1658,151,199,16563,24,24,0,0
soulbinds_collection_specborder_tertiary,11645,1578,48,48,1560,1608,151,199,16564,24,24,0,0
soulbinds_collection_scrollbar_thumb_wide,11646,1578,20,1044,1,21,49,1093,16565,10,522,0,0
ui_adv_atk,11647,1557,32,32,931,963,1120,1152,16566,0,0,0,0
ui_adv_health,11648,1557,32,32,965,997,1120,1152,16567,0,0,0,0
soulbinds_collection_charge_active,11649,1578,52,52,1392,1444,49,101,16568,26,26,0,0
soulbinds_collection_charge_inactive,11650,1578,52,52,1662,1714,127,179,16569,26,26,0,0
soulbinds_collection_charge_pending,11651,1578,52,52,1446,1498,165,217,16570,26,26,0,0
soulbinds_collection_charge_slot,11652,1578,52,52,1392,1444,103,155,16571,26,26,0,0
soulbinds_collection_charge_shadow,11653,1578,243,14,911,1154,1,15,16572,0,0,0,0
soulbinds_collection_charge_dialog,11654,1578,24,24,601,625,1,25,16573,12,12,0,0
ui-lfg-dungeontoast,11655,1733,338,72,1,339,1,73,16574,0,0,0,0
covenantchoice-offering-portrait-kyrian-kleia,11656,1592,90,114,1,91,871,985,16575,0,0,0,0
covenantchoice-offering-portrait-kyrian-mikanikos,11657,1592,90,114,93,183,871,985,16576,0,0,0,0
covenantchoice-offering-portrait-kyrian-pelagos,11658,1592,90,114,185,275,871,985,16577,0,0,0,0
covenantchoice-offering-portrait-necrolord-emeni,11659,1663,90,114,1,91,871,985,16578,0,0,0,0
covenantchoice-offering-portrait-necrolord-heirmir,11660,1663,90,114,93,183,871,985,16579,0,0,0,0
covenantchoice-offering-portrait-necrolord-marileth,11661,1663,90,114,185,275,871,985,16580,0,0,0,0
covenantchoice-offering-portrait-nightfae-korayn,11662,1662,90,114,1,91,871,985,16581,0,0,0,0
covenantchoice-offering-portrait-nightfae-niya,11664,1662,90,114,93,183,871,985,16583,0,0,0,0
covenantchoice-offering-portrait-venthyr-draven,11665,1593,90,114,1,91,871,985,16584,0,0,0,0
covenantchoice-offering-portrait-venthyr-nadjia,11666,1593,90,114,93,183,871,985,16585,0,0,0,0
covenantchoice-offering-portrait-venthyr-theotar,11667,1593,90,114,185,275,871,985,16586,0,0,0,0
covenantchoice-offering-soulbinds-background,11668,1589,90,114,398,488,1,115,16587,0,0,0,0
covenantchoice-offering-soulbinds-frame,11669,1589,90,114,306,396,1,115,16588,0,0,0,0
bonusobjectives-bar-frame-5,11670,663,240,51,1,241,315,366,16589,0,0,0,0
covenantchoice-offering-portrait-nightfae-dreamweaver,11671,1662,90,114,185,275,871,985,16590,0,0,0,0
animachannel-icon-kyrian-map,11679,647,32,32,479,511,375,407,16591,26,26,0,0
animachannel-icon-necrolord-map,11680,647,32,32,513,545,375,407,16592,26,26,0,0
animachannel-icon-nightfae-map,11681,647,32,32,547,579,375,407,16593,26,26,0,0
animachannel-icon-venthyr-map,11682,647,32,32,581,613,375,407,16594,26,26,0,0
flightmaster_bastion-taxi_frame_gray,11683,1734,38,38,1,39,1,39,16595,0,0,0,0
flightmaster_bastion-taxi_frame_green,11684,1734,38,38,41,79,1,39,16596,0,0,0,0
flightmaster_bastion-taxi_frame_yellow,11685,1734,38,38,81,119,1,39,16597,0,0,0,0
flightmaster_bastion-taxinode_neutral,11688,647,30,30,659,689,99,129,16600,18,18,0,0
chatbubble-nineslice-center,11689,1735,32,32,67,99,69,101,16601,0,0,0,0
chatbubble-nineslice-cornerbottomleft,11690,1735,32,32,1,33,135,167,16602,16,16,0,0
chatbubble-nineslice-cornerbottomright,11691,1735,32,32,1,33,169,201,16603,16,16,0,0
chatbubble-nineslice-cornertopleft,11692,1735,32,32,1,33,203,235,16604,16,16,0,0
chatbubble-nineslice-cornertopright,11693,1735,32,32,35,67,135,167,16605,16,16,0,0
_chatbubble-nineslice-edgebottom,11694,1735,32,32,0,32,1,33,16606,16,16,4,0
_chatbubble-nineslice-edgetop,11695,1735,32,32,0,32,35,67,16607,16,16,4,0
chatbubble-tail,11696,1735,64,64,1,65,69,133,16608,16,16,0,0
!chatbubble-nineslice-edgeleft,11697,1736,32,32,1,33,0,32,16609,16,16,2,0
!chatbubble-nineslice-edgeright,11698,1736,32,32,35,67,0,32,16610,16,16,2,0
cosmeticiconframe,11699,1737,64,64,1,65,1,65,16611,0,0,0,0
teleportationnetwork-ardenweald-32x32,11700,647,32,32,581,613,545,577,16612,24,24,0,0
teleportationnetwork-maldraxxus-32x32,11701,647,32,32,649,681,545,577,16613,24,24,0,0
teleportationnetwork-revendreth-32x32,11702,647,32,32,683,715,545,577,16614,24,24,0,0
sanctumupgrades-kyrian-32x32,11703,647,32,32,989,1021,511,543,16615,0,0,0,0
sanctumupgrades-necrolord-32x32,11704,647,32,32,513,545,545,577,16616,0,0,0,0
sanctumupgrades-nightfae-32x32,11705,647,32,32,513,545,579,611,16617,0,0,0,0
sanctumupgrades-venthyr-32x32,11706,647,32,32,513,545,613,645,16618,0,0,0,0
covenantsanctum-renown-arrow,11707,1738,48,67,775,823,68,135,16619,0,0,0,0
covenantsanctum-renown-background-shadow,11708,1738,715,296,1,716,1,297,16620,0,0,0,0
covenantsanctum-renown-checkmark,11709,1738,28,26,718,746,269,295,16621,0,0,0,0
covenantsanctum-renown-icon-border-disabled,11712,1738,55,55,946,1001,1,56,16623,0,0,0,0
covenantsanctum-renown-toast-hover,11713,1738,415,136,1,416,299,435,16338,0,0,0,0
covenantsanctum-renown-anima-venthyr-zhcn,11714,1739,706,155,871,1577,158,313,17282,0,0,0,0
covenantsanctum-renown-anima-venthyr,11715,1739,706,155,723,1429,1,156,16208,0,0,0,0
covenantsanctum-renown-background-venthyr,11716,1739,720,503,1,721,1,504,16205,0,0,0,0
covenantsanctum-renown-divider-venthyr,11717,1739,716,26,871,1587,327,353,16206,0,0,0,0
covenantsanctum-renown-finaltoast-venthyr,11718,1739,415,136,1431,1846,1,137,16488,0,0,0,0
covenantsanctum-renown-icon-border-venthyr,11720,1739,55,65,1905,1960,50,115,16625,0,0,0,0
covenantsanctum-renown-next-border-venthyr,11723,1739,55,65,723,778,158,223,16628,0,0,0,0
covenantsanctum-renown-special-border-venthyr,11724,1739,55,65,723,778,225,290,16629,0,0,0,0
covenantsanctum-renown-special-disabled-border-venthyr,11725,1739,55,65,723,778,292,357,16630,0,0,0,0
covenantsanctum-renown-title-divider-venthyr,11726,1739,625,10,871,1496,315,325,16631,0,0,0,0
covenantsanctum-renown-toast-venthyr,11727,1739,415,136,1579,1994,158,294,16209,0,0,0,0
covenantsanctum-renown-anima-nightfae,11728,1740,706,155,1,707,179,334,16199,0,0,0,0
covenantsanctum-renown-background-nightfae,11729,1740,720,503,1,721,474,977,16200,0,0,0,0
covenantsanctum-renown-divider-nightfae,11730,1740,716,26,1,717,1,27,16201,0,0,0,0
covenantsanctum-renown-finaltoast-nightfae,11731,1740,415,136,1,416,29,165,16487,0,0,0,0
covenantsanctum-renown-icon-border-nightfae,11733,1740,55,65,418,473,96,161,16633,0,0,0,0
covenantsanctum-renown-next-border-nightfae,11734,1740,55,65,475,530,96,161,16634,0,0,0,0
covenantsanctum-renown-special-border-nightfae,11735,1740,55,65,623,678,96,161,16635,0,0,0,0
covenantsanctum-renown-special-disabled-border-nightfae,11736,1740,55,65,623,678,29,94,16636,0,0,0,0
covenantsanctum-renown-title-divider-nightfae,11737,1740,625,10,1,626,167,177,16637,0,0,0,0
covenantsanctum-renown-toast-nightfae,11738,1740,415,136,1,416,336,472,16202,0,0,0,0
covenantsanctum-renownlevel-border-nightfae,11739,1740,360,110,418,778,336,446,16638,0,0,0,0
covenantsanctum-renown-icon-border-necrolord,11740,1741,55,65,1939,1994,1,66,16639,0,0,0,0
covenantsanctum-renown-toast-necrolord,11741,1741,415,136,1431,1846,1,137,16192,0,0,0,0
covenantsanctum-renown-finaltoast-necrolord,11742,1741,415,136,723,1138,158,294,16486,0,0,0,0
covenantsanctum-renown-special-border-necrolord,11743,1741,55,65,1939,1994,68,133,16640,0,0,0,0
covenantsanctum-renown-background-necrolord-zhcn,11744,1741,720,503,1,721,506,1009,17284,0,0,0,0
covenantsanctum-renown-anima-necrolord,11745,1741,706,155,723,1429,1,156,16193,0,0,0,0
covenantsanctum-renownlevel-border-necrolord,11746,1741,360,110,1140,1500,158,268,16641,0,0,0,0
covenantsanctum-renown-next-border-necrolord,11748,1741,55,65,1559,1614,158,223,16643,0,0,0,0
covenantsanctum-renown-divider-necrolord,11749,1741,716,26,723,1439,296,322,16194,0,0,0,0
covenantsanctum-renown-background-necrolord,11750,1741,720,503,1,721,1,504,16196,0,0,0,0
covenantsanctum-renown-title-divider-necrolord,11751,1741,625,10,1,626,1011,1021,16644,0,0,0,0
covenantsanctum-renown-special-disabled-border-necrolord,11752,1741,55,65,1502,1557,158,223,16645,0,0,0,0
covenantsanctum-renown-anima-kyrian,11753,1742,706,155,1,707,506,661,16186,0,0,0,0
covenantsanctum-renown-background-kyrian,11754,1742,720,503,1,721,1,504,16187,0,0,0,0
covenantsanctum-renown-divider-kyrian,11755,1742,716,26,1,717,663,689,16188,0,0,0,0
covenantsanctum-renown-finaltoast-kyrian,11756,1742,415,136,1,416,703,839,16485,0,0,0,0
covenantsanctum-renown-icon-border-kyrian,11758,1742,55,65,951,1006,1,66,16647,0,0,0,0
covenantsanctum-renown-next-border-kyrian,11759,1742,55,65,894,949,1,66,16648,0,0,0,0
covenantsanctum-renown-special-border-kyrian,11760,1742,55,65,780,835,1,66,16649,0,0,0,0
covenantsanctum-renown-special-disabled-border-kyrian,11761,1742,55,65,814,869,68,133,16650,0,0,0,0
covenantsanctum-renown-title-divider-kyrian,11762,1742,625,10,1,626,691,701,16651,0,0,0,0
covenantsanctum-renown-toast-kyrian,11763,1742,415,136,1,416,841,977,16191,0,0,0,0
covenantsanctum-renownlevel-border-kyrian,11764,1742,360,110,418,778,703,813,16652,0,0,0,0
covenantsanctum-renown-arrow-depressed,11765,1738,48,67,775,823,137,204,16653,0,0,0,0
covenantsanctum-renown-arrow-hover,11766,1738,48,67,825,873,68,135,16654,0,0,0,0
covenantsanctum-renown-hexagon-border-disabled,11767,1738,55,65,718,773,1,66,16655,0,0,0,0
covenantsanctum-renown-hexagon-border-venthyr,11768,1739,55,65,1848,1903,1,66,16656,0,0,0,0
covenantsanctum-renown-hexagon-next-border-venthyr,11769,1739,55,65,1848,1903,68,133,16657,0,0,0,0
covenantsanctum-renown-hexagon-border-nightfae,11770,1740,55,65,475,530,29,94,16658,0,0,0,0
covenantsanctum-renown-hexagon-next-border-nightfae,11771,1740,55,65,418,473,29,94,16659,0,0,0,0
covenantsanctum-renown-hexagon-next-border-necrolord,11772,1741,55,65,1616,1671,158,223,16660,0,0,0,0
covenantsanctum-renown-hexagon-border-necrolord,11773,1741,55,65,1502,1557,225,290,16661,0,0,0,0
covenantsanctum-renown-hexagon-border-kyrian,11774,1742,55,65,723,778,1,66,16662,0,0,0,0
covenantsanctum-renown-hexagon-next-border-kyrian,11775,1742,55,65,837,892,1,66,16663,0,0,0,0
covenantsanctum-renown-hexagon-mask,11776,1743,64,64,0,64,0,64,16664,0,0,16,0
eyeofthejailer-bar,11777,1664,128,128,833,961,849,977,16665,0,0,0,0
eyeofthejailer-runebg,11778,1664,40,40,65,105,958,998,16666,0,0,0,0
covenantsanctum-renown-special-next-border-kyrian,11779,1742,55,65,871,926,68,133,16667,0,0,0,0
covenantsanctum-renown-special-next-border-necrolord,11780,1741,55,65,1559,1614,225,290,16668,0,0,0,0
covenantsanctum-renown-special-next-border-nightfae,11781,1740,55,65,729,784,29,94,16669,0,0,0,0
covenantsanctum-renown-special-next-border-venthyr,11782,1739,55,65,1962,2017,50,115,16670,0,0,0,0
covenantsanctum-renown-scroll-mask,11783,1744,1024,128,0,1024,0,128,16671,0,0,16,0
covenantsanctum-renown-hexagon-hover,11784,1738,55,65,718,773,135,200,16672,0,0,0,0
covenantsanctum-renown-icon-hover,11785,1738,55,65,832,887,1,66,16673,0,0,0,0
covenantsanctum-renown-arrow-disabled,11786,1738,48,67,775,823,206,273,16674,0,0,0,0
covenantsanctum-renown-checkmark-large,11787,1738,46,41,975,1021,68,109,16675,0,0,0,0
poi-lighthouse-neutral,11788,647,10,16,1009,1019,59,75,16676,0,0,0,0
soulbinds_backgroundfx_mask,11789,1745,1024,1024,0,1024,0,1024,16677,0,0,16,0
soulbinds_backgroundfx_sheen,11790,1746,1735,876,1,1736,1,877,16678,0,0,0,0
teleportationnetwork-flightpathminimap,11792,647,32,32,615,647,545,577,16679,36,36,0,0
shadowlands-landingpage-topbackground,11793,1636,361,164,485,846,816,980,16680,0,0,0,0
shadowlands-landingpage-renownbutton-venthyr-down,11794,1636,482,126,969,1451,176,302,16681,0,0,0,0
shadowlands-landingpage-renownbutton-nightfae,11795,1636,482,126,1453,1935,176,302,16682,0,0,0,0
shadowlands-landingpage-renownbutton-kyrian,11796,1636,482,126,485,967,304,430,16683,0,0,0,0
shadowlands-landingpage-renownbutton-nightfae-down,11797,1636,482,126,1,483,432,558,16684,0,0,0,0
shadowlands-landingpage-renownbutton-kyrian-down,11798,1636,482,126,969,1451,432,558,16685,0,0,0,0
shadowlands-landingpage-renownbutton-venthyr,11799,1636,482,126,969,1451,560,686,16686,0,0,0,0
shadowlands-landingpage-renownbutton-necrolord,11800,1636,482,126,1453,1935,560,686,16687,0,0,0,0
shadowlands-landingpage-renownbutton-necrolord-down,11801,1636,482,126,485,967,688,814,16688,0,0,0,0
buildanabomination-32x32,11802,647,32,32,955,987,375,407,16689,24,24,0,0
embercourt-32x32-zhcn,11803,647,32,32,377,409,885,917,17292,24,24,0,0
embercourt-32x32,11804,647,32,32,377,409,851,883,16691,0,0,0,0
pathofascension-32x32,11805,647,32,32,819,851,443,475,16692,24,24,0,0
queensconservatory-32x32,11806,647,32,32,751,783,477,509,16693,24,24,0,0
soulbind-32x32,11807,647,32,32,513,545,749,781,16694,24,24,0,0
animadiversion-icon,11808,647,32,32,615,647,375,407,16695,0,0,0,0
soulbinds_backgroundfx_gridburst,11809,1746,1024,1024,1,1025,879,1903,16696,0,0,0,0
adventures-32x32,11810,647,32,32,203,235,990,1022,16697,24,24,0,0
soulbinds_backgroundfx_chargesheen,11811,1746,87,138,1738,1825,1,139,16698,0,0,0,0
covenantsanctum-renown-next-glow-kyrian,11812,1742,89,91,723,812,68,159,16699,0,0,0,0
covenantsanctum-renown-next-glow-necrolord,11813,1741,89,91,1848,1937,1,92,16700,0,0,0,0
covenantsanctum-renown-next-glow-nightfae,11814,1740,89,91,532,621,29,120,16701,0,0,0,0
covenantsanctum-renown-next-glow-venthyr,11815,1739,89,91,780,869,158,249,16702,0,0,0,0
covenantsanctum-renownlevel-border-venthyr-zhcn,11816,1739,360,110,1233,1593,355,465,16703,0,0,0,0
covenantsanctum-renownlevel-border-venthyr,11817,1739,360,110,871,1231,355,465,16704,0,0,0,0
covenantsanctum-reservoir-shadow,11828,1606,344,336,1,345,1,337,16705,0,0,0,0
soulbinds_tree_activatefx_diamond,11829,1578,389,380,1580,1969,376,756,16706,0,0,0,0
soulbinds_tree_activatefx_diamondarrows,11830,1578,389,380,1059,1448,376,756,16707,0,0,0,0
soulbinds_tree_activatefx_stars,11831,1578,512,512,1189,1701,1236,1748,16708,0,0,0,0
soulbinds_background_activate,11832,1576,888,876,891,1779,1,877,16709,0,0,0,0
soulbinds_tree_activatefx_ring,11833,1578,511,476,1059,1570,758,1234,16710,0,0,0,0
ui-frame-bar-fill-white,11834,1253,256,17,0,256,163,180,15698,0,0,4,0
runecarving-icon-center-empty-error,11836,1656,88,88,681,769,551,639,16712,0,0,0,0
runecarving-icon-center-selected-error,11837,1656,88,88,771,859,371,459,16713,0,0,0,0
runecarving-icon-power-empty-error,11838,1656,78,78,931,1009,461,539,16714,0,0,0,0
runecarving-icon-reagent-empty-error,11839,1656,49,50,972,1021,105,155,16715,0,0,0,0
covenantsanctum-reservoir-idle-kyrian-glass,11842,1608,256,256,647,903,677,933,16716,0,0,0,0
covenantsanctum-reservoir-idle-kyrian-glow,11843,1608,256,256,993,1249,1,257,16717,0,0,0,0
covenantsanctum-reservoir-idle-kyrian-speck,11844,1608,256,256,993,1249,259,515,16718,0,0,0,0
covenantsanctum-reservoir-idle-kyrian-speck2,11845,1608,256,256,993,1249,517,773,16719,0,0,0,0
garrlanding-followerframe,11860,268,300,384,1,301,1,385,16722,0,0,0,0
covenantsanctum-reservoir-idle-venthyr-glass,11865,1639,256,256,993,1249,1,257,16727,0,0,0,0
covenantsanctum-reservoir-idle-venthyr-glow,11866,1639,256,256,993,1249,259,515,16728,0,0,0,0
covenantsanctum-renown-icon-available-kyrian,11891,1742,47,47,928,975,68,115,16734,0,0,0,0
covenantsanctum-renown-icon-available-necrolord,11892,1741,47,47,1848,1895,94,141,16735,0,0,0,0
covenantsanctum-renown-icon-available-venthyr,11893,1739,47,47,1905,1952,1,48,16736,0,0,0,0
shop-card-celebrationcollection-epic1,11903,1753,566,225,1,567,1,226,16745,0,0,0,0
shop-card-celebrationcollection-epic2,11904,1753,566,225,1,567,228,453,16746,0,0,0,0
shop-card-celebrationcollection-essentials,11905,1753,277,224,569,846,1,225,16747,0,0,0,0
shop-card-celebrationcollection-heroic,11906,1753,277,224,569,846,228,452,16748,0,0,0,0
_covenantsanctum-reservoir-idle-venthyr-strands2,11925,1750,512,512,0,512,1,513,16760,0,0,4,0
!covenantsanctum-reservoir-idle-kyrian-strands,11926,1748,512,512,1,513,0,512,16761,0,0,2,0
!covenantsanctum-reservoir-idle-venthyr-strands,11928,1748,512,512,515,1027,0,512,16763,0,0,2,0
autoquest-badge-campaign,11940,860,128,128,1,129,1,129,16764,60,60,0,0
covenantsanctum-reservoir-idle-nightfae-glass,11942,1640,256,256,647,903,677,933,16754,0,0,0,0
covenantsanctum-reservoir-idle-nightfae-glow,11943,1640,256,256,993,1249,1,257,16755,0,0,0,0
covenantsanctum-reservoir-idle-nightfae-speck,11944,1640,256,256,993,1249,259,515,16766,0,0,0,0
covenantsanctum-reservoir-idle-nightfae-speck2,11945,1640,256,256,993,1249,517,773,16767,0,0,0,0
covenantsanctum-reservoir-idle-nightfae-spiral1,11979,1640,256,256,1251,1507,1,257,16771,0,0,0,0
covenantsanctum-reservoir-idle-nightfae-spiral2,11980,1640,256,256,1509,1765,1,257,16772,0,0,0,0
covenantsanctum-reservoir-idle-nightfae-spiral3,11981,1640,256,256,1767,2023,1,257,16773,0,0,0,0
covenantsanctum-reservoir-idle-necrolord-glass,11982,1661,256,256,1,257,553,809,16752,0,0,0,0
covenantsanctum-reservoir-idle-necrolord-pulse,11983,1661,256,256,606,862,650,906,16774,0,0,0,0
covenantsanctum-reservoir-idle-necrolord-speck,11984,1661,256,256,932,1188,650,906,16775,0,0,0,0
greatvault-32x32,11995,647,48,48,203,251,425,473,16778,30,30,0,0
oribos-weeklyrewards-orb-dialog,11996,1646,140,120,543,683,391,511,21390,0,0,0,0
garrmissionlocation-maw-buttonbg,11999,1757,843,93,1,844,1,94,16782,0,0,0,0
garrmissionlocation-maw-buttonhighlight,12000,1757,843,93,1,844,96,189,16783,0,0,0,0
timewalkingvendor-32x32,12001,647,32,32,717,749,545,577,16784,24,24,0,0
covenantsanctum-reservoir-idle-necrolord-speck2,12003,1661,256,256,1320,1576,650,906,16776,0,0,0,0
covenantsanctum-reservoir-idle-necrolord-veins,12004,1661,256,256,1,257,295,551,16786,0,0,0,0
levelup-bar-gold,12005,1760,418,7,513,931,106,113,16787,0,0,0,0
levelup-bar-green,12006,1760,418,7,513,931,115,122,16788,0,0,0,0
levelup-bar-white,12007,1760,418,7,513,931,124,131,16789,0,0,0,0
levelup-dot-gold,12008,1760,21,22,259,280,339,361,16790,0,0,0,0
levelup-dot-green,12009,1760,21,22,259,280,376,398,16791,0,0,0,0
levelup-glow-gold,12010,1760,224,115,1,225,299,414,16792,0,0,0,0
levelup-glow-green,12011,1760,224,115,287,511,106,221,16793,0,0,0,0
levelup-icon-arrow,12012,1760,30,34,227,257,376,410,16794,0,0,0,0
levelup-icon-bag,12013,1760,29,34,1,30,416,450,16795,0,0,0,0
levelup-icon-book,12014,1760,40,38,227,267,299,337,16796,0,0,0,0
levelup-icon-lock,12015,1760,30,35,227,257,339,374,16797,0,0,0,0
levelup-shadow-lower,12016,1760,284,296,1,285,1,297,16798,0,0,0,0
levelup-shadow-upper,12017,1760,326,103,287,613,1,104,16799,0,0,0,0
upgradeitem-32x32,12018,647,32,32,955,987,545,577,16800,24,24,0,0
garrmissionlocation-maw-bg-01,12037,1762,556,290,1,557,1,291,16819,0,0,0,0
garrmissionlocation-maw-bg-02,12038,1762,556,290,1,557,293,583,16820,0,0,0,0
garrmissionlocation-maw-enemy-socket-01,12039,1762,76,76,779,855,1,77,16821,0,0,0,0
garrmissionlocation-maw-enemy-socket-02,12040,1762,76,76,857,933,1,77,16822,0,0,0,0
garrmissionlocation-maw-enemy-socket-03,12041,1762,76,76,935,1011,1,77,16823,0,0,0,0
garrmissionlocation-maw-enemy-socket-04,12042,1762,76,76,779,855,79,155,16824,0,0,0,0
garrmissionlocation-maw-follower-socket-01,12043,1762,108,108,559,667,1,109,16825,0,0,0,0
garrmissionlocation-maw-follower-socket-02,12044,1762,108,108,559,667,111,219,16826,0,0,0,0
garrmissionlocation-maw-follower-socket-03,12045,1762,108,108,669,777,1,109,16827,0,0,0,0
garrmissionlocation-maw-follower-socket-04,12046,1762,108,108,669,777,111,219,16828,0,0,0,0
!ui-scrollbar-center,12047,1763,25,32,1,26,0,32,16829,0,0,2,0
ui-scrollbar-button-overlay,12110,1769,27,25,35,62,1,26,16833,0,0,0,0
ui-scrollbar-endcap-bottom,12111,1769,25,31,1,26,62,93,16834,0,0,0,0
ui-scrollbar-endcap-top,12112,1769,25,32,1,26,28,60,16835,0,0,0,0
ui-scrollbar-knob-endcap-bottom-disabled,12113,1769,18,21,35,53,80,101,16883,0,0,0,0
ui-scrollbar-knob-endcap-bottom,12114,1769,18,21,35,53,57,78,16836,0,0,0,0
ui-scrollbar-knob-endcap-top-disabled,12115,1769,18,21,64,82,84,105,16884,0,0,0,0
ui-scrollbar-knob-endcap-top,12116,1769,18,21,64,82,61,82,16837,0,0,0,0
ui-scrollbar-knob-mouseover-endcap-bottom,12117,1769,18,21,87,105,1,22,16838,0,0,0,0
ui-scrollbar-knob-mouseover-endcap-top,12118,1769,18,21,87,105,24,45,16839,0,0,0,0
ui-scrollbar-scrolldownbutton-disabled,12119,1769,18,16,87,105,47,63,16843,0,0,0,0
ui-scrollbar-scrolldownbutton-down,12120,1769,18,16,87,105,65,81,16844,0,0,0,0
ui-scrollbar-scrolldownbutton-highlight,12121,1769,18,16,87,105,83,99,16845,0,0,0,0
ui-scrollbar-scrolldownbutton-up,12122,1769,18,16,87,105,101,117,16846,0,0,0,0
ui-scrollbar-scrollupbutton-disabled,12123,1769,18,16,148,166,1,17,16847,0,0,0,0
ui-scrollbar-scrollupbutton-down,12124,1769,18,16,168,186,1,17,16848,0,0,0,0
ui-scrollbar-scrollupbutton-highlight,12125,1769,18,16,188,206,1,17,16849,0,0,0,0
ui-scrollbar-scrollupbutton-up,12126,1769,18,16,208,226,1,17,16850,0,0,0,0
ui-scrollbar-button-overlay-horizontal,12128,1769,25,27,35,60,28,55,16886,0,0,0,0
ui-scrollbar-endcap-left,12129,1769,31,25,1,32,95,120,16887,0,0,0,0
ui-scrollbar-endcap-right,12130,1769,32,25,1,33,1,26,16888,0,0,0,0
ui-scrollbar-knob-endcap-left-disabled,12131,1769,21,18,64,85,1,19,16889,0,0,0,0
ui-scrollbar-knob-endcap-left,12132,1769,21,18,35,56,103,121,16890,0,0,0,0
ui-scrollbar-knob-endcap-right-disabled,12133,1769,21,18,64,85,41,59,16891,0,0,0,0
ui-scrollbar-knob-endcap-right,12134,1769,21,18,64,85,21,39,16892,0,0,0,0
ui-scrollbar-knob-mouseover-endcap-left,12135,1769,21,18,64,85,107,125,16893,0,0,0,0
ui-scrollbar-knob-mouseover-endcap-right,12136,1769,21,18,107,128,1,19,16894,0,0,0,0
ui-scrollbar-scrollleftbutton-disabled,12137,1769,16,18,107,123,21,39,16895,0,0,0,0
ui-scrollbar-scrollleftbutton-down,12138,1769,16,18,107,123,41,59,16896,0,0,0,0
ui-scrollbar-scrollleftbutton-highlight,12139,1769,16,18,107,123,61,79,16897,0,0,0,0
ui-scrollbar-scrollleftbutton-up,12140,1769,16,18,107,123,81,99,16898,0,0,0,0
ui-scrollbar-scrollrightbutton-disabled,12141,1769,16,18,107,123,101,119,16899,0,0,0,0
ui-scrollbar-scrollrightbutton-down,12142,1769,16,18,130,146,1,19,16900,0,0,0,0
ui-scrollbar-scrollrightbutton-highlight,12143,1769,16,18,130,146,21,39,16901,0,0,0,0
ui-scrollbar-scrollrightbutton-up,12144,1769,16,18,130,146,41,59,16902,0,0,0,0
_ui-scrollbar-center,12145,1770,32,25,0,32,1,26,16903,0,0,4,0
ui-scrollbar-knob-center-disabled,12149,1763,18,1022,28,46,1,1023,16907,0,0,0,0
ui-scrollbar-knob-center,12150,1763,18,1022,48,66,1,1023,16908,0,0,0,0
ui-scrollbar-knob-mouseover-center,12151,1763,18,1022,68,86,1,1023,16909,0,0,0,0
ui-scrollbar-knob-center-disabled-horizontal,12152,1770,1022,18,1,1023,28,46,16910,0,0,0,0
ui-scrollbar-knob-center-horizontal,12153,1770,1022,18,1,1023,48,66,16911,0,0,0,0
ui-scrollbar-knob-mouseover-center-horizontal,12154,1770,1022,18,1,1023,68,86,16912,0,0,0,0
ui-achievement-alert-background-mini,12155,1771,256,84,1,257,378,462,16913,0,0,0,0
ui-achievement-alert-background,12156,1771,310,101,640,950,174,275,16914,0,0,0,0
ui-achievement-alert-glow-glow,12157,1771,400,171,1,401,1,172,16915,0,0,0,0
ui-achievement-alert-glow-shine,12158,1771,67,85,1,68,866,951,16916,0,0,0,0
ui-achievement-guild-background,12159,1771,321,104,317,638,174,278,16917,0,0,0,0
ui-achievement-guild-glow,12160,1771,382,154,403,785,1,155,16918,0,0,0,0
ui-achievement-guild-shine,12161,1771,84,90,1,85,573,663,16919,0,0,0,0
ui-achievement-bling,12162,1771,107,107,1,108,464,571,16920,0,0,0,0
ui-achievement-border-1,12163,1771,513,22,259,772,403,425,16921,0,0,0,0
ui-achievement-border-2,12164,1771,512,23,259,771,378,401,16922,0,0,0,0
ui-achievement-border-3,12165,1771,512,19,110,622,464,483,16923,0,0,0,0
ui-achievement-border-4,12166,1771,512,22,259,771,427,449,16924,0,0,0,0
ui-achievement-border-5,12167,1771,512,15,110,622,485,500,16925,0,0,0,0
ui-achievement-border-6,12168,1771,512,14,110,622,502,516,16926,0,0,0,0
ui-achievement-border-7,12169,1771,427,55,452,879,312,367,16927,0,0,0,0
ui-achievement-border-8,12170,1771,449,64,1,450,312,376,16928,0,0,0,0
ui-achievement-guild-badge,12171,1771,23,20,787,810,131,151,16929,0,0,0,0
ui-achievement-guild-filigree-left,12172,1771,53,53,110,163,767,820,16930,0,0,0,0
ui-achievement-guild-filigree-right,12173,1771,53,53,110,163,822,875,16931,0,0,0,0
ui-achievement-guild-flag-outline,12174,1771,58,122,1,59,665,787,16932,0,0,0,0
ui-achievement-guild-flag-short-outline,12175,1771,65,62,881,946,312,374,16933,0,0,0,0
ui-achievement-guild-flag-short,12176,1771,65,68,1,66,953,1021,16934,0,0,0,0
ui-achievement-guild-flag,12177,1771,74,131,917,991,1,132,16935,0,0,0,0
ui-achievement-guild-iconframe-small,12178,1771,44,42,61,105,665,707,16936,0,0,0,0
ui-achievement-guild-iconframe,12179,1771,78,75,1,79,789,864,16937,0,0,0,0
ui-achievement-iconframe,12180,1771,74,74,110,184,518,592,16938,0,0,0,0
ui-achievement-shield-1,12181,1771,63,56,948,1011,312,368,16939,0,0,0,0
ui-achievement-shield-2-desaturated,12182,1771,63,56,110,173,594,650,16940,0,0,0,0
ui-achievement-shield-2,12183,1771,62,55,110,172,710,765,16941,0,0,0,0
ui-achievement-shield-desaturated,12184,1771,128,128,787,915,1,129,16942,0,0,0,0
common-icon-zoomin-disable,12200,1563,256,256,775,1031,1,257,16958,25,25,0,0
common-icon-zoomout-disable,12201,1563,256,256,775,1031,517,773,16959,25,25,0,0
charactercreate-customize-backbutton-disabled,12203,708,76,76,1801,1877,419,495,16961,38,38,0,0
charactercreate-customize-backbutton,12204,708,76,76,1723,1799,419,495,16962,38,38,0,0
charactercreate-customize-nextbutton-disabled,12205,708,76,76,281,357,1881,1957,16963,38,38,0,0
charactercreate-customize-nextbutton,12206,708,76,76,1959,2035,419,495,16964,38,38,0,0
charactercreate-gendericon-female-selected,12207,708,256,256,539,795,1,257,16965,0,0,0,0
charactercreate-gendericon-male-selected,12208,708,256,256,1055,1311,1,257,16966,0,0,0,0
soulbinds_tree_conduit_ring_enhanced,12209,1578,112,114,233,345,1506,1620,16967,56,57,0,0
soulbinds_collection_conduit_enhanced_mask,12210,1774,128,128,0,128,0,128,16968,64,64,16,0
charactercreate-customize-backbutton-down,12216,708,76,76,1881,1957,419,495,16986,38,38,0,0
charactercreate-customize-nextbutton-down,12217,708,76,76,359,435,1881,1957,16987,38,38,0,0
creditsscreen-assets-buttons-fastforward,12218,1689,256,256,1,257,181,437,16988,22,22,0,0
creditsscreen-assets-buttons-pause,12219,1689,256,256,1,257,439,695,16989,22,22,0,0
creditsscreen-assets-buttons-play,12220,1689,256,256,1,257,697,953,16990,22,22,0,0
creditsscreen-assets-buttons-rewind,12221,1689,256,256,1,257,955,1211,16991,22,22,0,0
chatframe-button-icon-tts,12222,924,29,29,163,192,1,30,17001,0,0,0,0
voicechat-channellist-icon-stt-off,12224,938,42,42,219,261,201,243,17003,0,0,0,0
voicechat-channellist-icon-stt-on,12225,938,42,42,285,327,135,177,17004,0,0,0,0
voicechat-icon-stt-mute,12226,938,32,32,419,451,103,135,17005,0,0,0,0
voicechat-icon-stt-mutesilenced,12227,938,32,32,453,485,103,135,17006,0,0,0,0
voicechat-icon-stt-off,12228,938,64,64,219,283,135,199,17007,0,0,0,0
voicechat-icon-stt-on,12229,938,64,64,285,349,69,133,17008,0,0,0,0
voicechat-icon-stt-silenced,12230,938,32,32,385,417,137,169,17009,0,0,0,0
voicechat-icon-stt,12231,938,32,32,385,417,103,135,17010,0,0,0,0
common-gray-button-entrybox-center,12232,1598,48,143,0,48,1,144,17011,16,48,4,0
common-gray-button-entrybox-left,12233,1598,39,143,938,977,146,289,17012,13,48,0,0
common-gray-button-entrybox-right,12234,1598,935,143,1,936,146,289,17013,314,48,0,0
ui-achievement-alert-background-mini-glow-shine,12248,1771,67,85,952,1019,174,259,17014,0,0,0,0
ui-achievement-alert-background-mini-glow,12249,1771,314,136,1,315,174,310,17015,0,0,0,0
ui-achievement-shield-1-desaturated,12250,1771,62,56,110,172,652,708,17016,0,0,0,0
kyrianassaults-64x64,12251,647,64,64,71,135,263,327,17017,50,50,0,0
kyrianassaultsquest-32x32,12252,647,32,32,411,443,511,543,17018,12,12,0,0
necrolordassaults-64x64,12253,647,64,64,269,333,131,195,17019,50,50,0,0
necrolordassaultsquest-32x32,12254,647,32,32,649,681,443,475,17020,12,12,0,0
nightfaeassaults-64x64,12255,647,64,64,335,399,131,195,17021,50,50,0,0
nightfaeassaultsquest-32x32,12256,647,32,32,683,715,443,475,17022,0,0,0,0
venthyrassaults-64x64,12257,647,64,64,137,201,593,657,17023,50,50,0,0
venthyrassaultsquest-32x32,12258,647,32,32,887,919,579,611,17024,12,12,0,0
animcreate_icon_3d,12365,1796,32,32,1,33,1,33,17074,0,0,0,0
animcreate_icon_folder,12366,1796,32,32,35,67,1,33,17075,0,0,0,0
animcreate_icon_mask,12367,1796,32,32,69,101,1,33,17076,0,0,0,0
animcreate_icon_template,12368,1796,32,32,1,33,35,67,17077,0,0,0,0
animcreate_icon_text,12369,1796,32,32,1,33,69,101,17078,0,0,0,0
animcreate_icon_texture,12370,1796,32,32,35,67,35,67,17079,0,0,0,0
adventure-buff-indicator-small,12371,1557,11,11,1005,1016,435,446,17080,0,0,0,0
adventure-heal-indicator-small,12372,1557,11,11,1005,1016,461,472,17081,0,0,0,0
ui-ej-memory-darkring,12402,207,70,70,410,480,1,71,17107,0,0,0,0
ui-ej-memory-disabledring,12403,207,70,70,1,71,79,149,17108,0,0,0,0
runecarving-venthyr-32x32-mask,12404,1804,32,32,0,32,0,32,17109,0,0,16,0
runecarving-kyrian-32x32-mask,12405,1805,32,32,0,32,0,32,17110,0,0,16,0
runecarving-necrolord-32x32-mask,12406,1806,32,32,0,32,0,32,17111,0,0,16,0
runecarving-nightfae-32x32-mask,12407,1807,32,32,0,32,0,32,17112,0,0,16,0
adventure-debuff-indicator-small,12408,1557,11,11,1005,1016,448,459,17113,0,0,0,0
adventures-mission-frame-elite,12409,1557,80,80,686,766,946,1026,17114,0,0,0,0
adventures-mission-frame-medium,12410,1557,80,80,202,282,1567,1647,17115,0,0,0,0
adventures-mission-frame-normal,12411,1557,80,80,199,279,1770,1850,17116,0,0,0,0
jailerstower-score-background,12420,1809,467,253,1,468,35,288,17117,0,0,0,0
jailerstower-score-footer,12421,1809,467,71,1,468,554,625,17118,0,0,0,0
jailerstower-score-topper,12425,1809,467,71,1,468,627,698,17122,0,0,0,0
questbg-parchment-accessibility,12426,1711,299,407,1,300,410,817,17123,0,0,0,0
questdetailsbackgrounds-accessibility,12427,103,287,464,290,577,467,931,17124,0,0,0,0
jailerstower-score-gem-mask,12429,1810,32,64,0,32,0,64,17126,0,0,16,0
ui-frame-jailerstower-rerollbutton,12444,1549,227,149,431,658,614,763,17148,0,0,0,0
ui-frame-jailerstower-rerollbuttonhighlight,12445,1549,227,149,431,658,765,914,17149,0,0,0,0
jailerstower-score-disabled-gem-icon,12446,1809,32,64,470,502,35,99,17147,0,0,0,0
jailerstower-score-gem-glow,12447,1809,32,28,470,502,167,195,17150,0,0,0,0
jailerstower-score-gem-icon,12448,1809,32,64,470,502,101,165,17142,0,0,0,0
jailerstower-score-gem-anim-flash,12449,1809,60,80,280,340,290,370,17197,0,0,0,0
animcreate_icon_add,12496,1796,32,32,69,101,35,67,17198,0,0,0,0
jailerstower-scorebar-filling-cap-pause,12578,1822,97,50,268,365,242,292,17273,0,0,0,0
jailerstower-scorebar-filling-cap,12579,1822,97,50,122,219,420,470,17272,0,0,0,0
jailerstower-scorebar-filling-pause,12580,1822,512,17,0,512,156,173,17274,0,0,4,0
jailerstower-scorebar-filling,12581,1822,512,17,0,512,175,192,17271,0,0,4,0
jailerstower-scorebar-backgroundglowz,12582,1822,265,80,1,266,242,322,17545,265,60,0,0
jailerstower-scorebar-full-fill-filling,12583,1822,512,17,0,512,137,154,17424,0,0,4,0
jailerstower-scenario-nodeaths-frame,12585,1550,243,77,458,701,1,78,17278,0,0,0,0
jailerstower-score-gem-tooltipicon,12586,1809,14,18,470,484,197,215,17293,0,0,0,0
coin-copper-20x20,12587,898,20,20,175,195,1,21,17562,0,0,0,0
coin-gold-20x20,12588,898,20,20,197,217,1,21,17563,0,0,0,0
coin-silver-20x20,12589,898,20,20,219,239,1,21,17564,0,0,0,0
talenttree-torghast-background,12590,1823,320,455,1,321,1,456,17297,0,0,0,0
talenttree-torghast-logo,12591,1823,61,61,323,384,1,62,17298,0,0,0,0
socket-domination-background,12593,1462,51,51,124,175,166,217,17300,0,0,0,0
socket-domination-closed,12594,1462,51,51,178,229,1,52,17301,0,0,0,0
socket-domination-open,12595,1462,51,51,178,229,54,105,17302,0,0,0,0
jailerstower-scorebar-bordercenter,12596,1822,1,23,0,1,217,240,17270,0,0,4,0
jailerstower-scorebar-borderleft,12597,1822,119,71,1,120,420,491,17303,0,0,0,0
jailerstower-scorebar-borderright,12598,1822,144,71,1,145,324,395,17304,0,0,0,0
jailerstower-scorebar-bgcenter,12599,1822,1,21,0,1,1,22,17322,0,0,4,0
jailerstower-scorebar-bgleft,12600,1822,103,21,147,250,324,345,17323,0,0,0,0
jailerstower-scorebar-bgright,12601,1822,127,21,1,128,397,418,17324,0,0,0,0
jailerstower-scorebar-full-bordercenter,12602,1822,1,23,0,1,24,47,17275,0,0,4,0
jailerstower-scorebar-full-borderleft,12603,1822,119,71,634,753,242,313,17308,0,0,0,0
jailerstower-scorebar-full-borderright,12604,1822,144,71,869,1013,242,313,17309,0,0,0,0
jailerstower-scorebar-full-glow-bordercenter,12605,1822,1,61,0,1,74,135,17310,0,0,4,0
jailerstower-scorebar-full-glow-borderleft,12606,1822,112,61,755,867,242,303,17311,0,0,0,0
jailerstower-scorebar-full-glow-borderright,12607,1822,138,61,367,505,343,404,17312,0,0,0,0
jailerstower-scorebar-pause-bordercenter,12609,1822,1,23,0,1,49,72,17280,0,0,4,0
jailerstower-scorebar-pause-borderleft,12610,1822,119,71,507,626,416,487,17314,0,0,0,0
jailerstower-scorebar-pause-borderright,12611,1822,144,71,507,651,343,414,17315,0,0,0,0
jailerstower-scorebar-full-tick,12614,1822,25,38,268,293,294,332,17426,0,0,0,0
jailerstower-scorebar-pause-tick,12615,1822,25,38,221,246,420,458,17427,0,0,0,0
jailerstower-scorebar-tick,12616,1822,25,38,295,320,294,332,17325,0,0,0,0
jailerstower-scorebar-full-backgroundglow,12618,1822,265,80,367,632,242,322,17425,265,60,0,0
jailerstower-scorebar-pause-bgcenter,12619,1822,1,21,0,1,194,215,17332,0,0,4,0
jailerstower-scorebar-pause-bgleft,12620,1822,103,21,147,250,347,368,17333,0,0,0,0
jailerstower-scorebar-pause-bgright,12621,1822,127,21,130,257,397,418,17334,0,0,0,0
covenantsanctum-renown-icon-available-nightfae,12710,1740,47,47,680,727,29,76,17423,0,0,0,0
jailerstower-score-hide-button,12711,1809,277,130,1,278,290,420,17428,0,0,0,0
jailerstower-score-hide-buttonhighlight,12712,1809,277,130,1,278,422,552,17429,0,0,0,0
jailerstower-highlight-row-left,12713,1809,47,32,280,327,372,404,17430,0,0,0,0
jailerstower-highlight-row-right,12714,1809,47,32,342,389,290,322,17431,0,0,0,0
_jailerstower-highlight-row-center,12715,1809,256,32,0,256,1,33,17432,0,0,4,0
tooltip-nineslice-cornerbottomleft,12716,1825,7,7,1,8,19,26,17433,0,0,0,0
tooltip-nineslice-cornerbottomright,12717,1825,7,7,1,8,28,35,17434,0,0,0,0
tooltip-nineslice-cornertopleft,12718,1825,7,7,1,8,37,44,17435,0,0,0,0
tooltip-nineslice-cornertopright,12719,1825,7,7,1,8,46,53,17436,0,0,0,0
_tooltip-nineslice-edgebottom,12720,1825,16,7,0,16,1,8,17437,0,0,4,0
_tooltip-nineslice-edgetop,12721,1825,16,7,0,16,10,17,17438,0,0,4,0
!tooltip-nineslice-edgeleft,12723,1827,7,16,1,8,0,16,17440,0,0,2,0
!tooltip-nineslice-edgeright,12724,1827,7,16,10,17,0,16,17441,0,0,2,0
tooltip-glues-nineslice-cornerbottomleft,12725,1828,16,16,1,17,37,53,17442,0,0,0,0
tooltip-glues-nineslice-cornerbottomright,12726,1828,16,16,1,17,55,71,17443,0,0,0,0
tooltip-glues-nineslice-cornertopleft,12727,1828,16,16,1,17,73,89,17444,0,0,0,0
tooltip-glues-nineslice-cornertopright,12728,1828,16,16,1,17,91,107,17445,0,0,0,0
_tooltip-glues-nineslice-edgebottom,12729,1828,16,16,0,16,1,17,17446,0,0,4,0
_tooltip-glues-nineslice-edgetop,12730,1828,16,16,0,16,19,35,17447,0,0,4,0
!tooltip-glues-nineslice-edgeleft,12731,1829,16,16,1,17,0,16,17448,0,0,2,0
!tooltip-glues-nineslice-edgeright,12732,1829,16,16,19,35,0,16,17449,0,0,2,0
tooltip-glues-nineslice-center,12733,1830,64,64,0,64,0,64,17610,0,0,6,0
textpanel-nineslice-cornerbottomleft,12734,1831,34,32,1,35,29,61,17451,0,0,0,0
textpanel-nineslice-cornerbottomright,12735,1831,31,32,1,32,97,129,17452,0,0,0,0
textpanel-nineslice-cornertopleft,12736,1831,34,32,1,35,63,95,17453,0,0,0,0
textpanel-nineslice-cornertopright,12737,1831,31,32,1,32,131,163,17454,0,0,0,0
_textpanel-nineslice-edgebottom,12738,1831,32,12,0,32,1,13,17455,0,0,4,0
_textpanel-nineslice-edgetop,12739,1831,32,12,0,32,15,27,17456,0,0,4,0
!textpanel-nineslice-edgeleft,12742,1833,13,32,1,14,0,32,17457,0,0,2,0
!textpanel-nineslice-edgeright,12743,1833,13,32,16,29,0,32,17458,0,0,2,0
splash-910-botleft,12745,1835,137,371,374,511,587,958,17460,0,0,0,0
splash-910-right,12746,1835,510,584,1,511,1,585,17461,0,0,0,0
splash-910-topleft,12747,1835,371,434,1,372,587,1021,17462,0,0,0,0
party-nineslice-cornerbottomleft,12756,1836,32,32,1,33,69,101,17471,0,0,0,0
party-nineslice-cornerbottomright,12757,1836,32,32,1,33,103,135,17472,0,0,0,0
party-nineslice-cornertopleft,12758,1836,32,32,1,33,137,169,17473,0,0,0,0
party-nineslice-cornertopright,12759,1836,32,32,1,33,171,203,17474,0,0,0,0
_party-nineslice-edgebottom,12760,1836,32,32,0,32,1,33,17475,0,0,4,0
_party-nineslice-edgetop,12761,1836,32,32,0,32,35,67,17476,0,0,4,0
ui-frame-party-backgroundtile,12762,1837,32,32,0,32,0,32,17477,0,0,6,0
!party-nineslice-edgeleft,12763,1838,32,32,1,33,0,32,17478,0,0,2,0
!party-nineslice-edgeright,12764,1838,32,32,35,67,0,32,17479,0,0,2,0
sliderbar-nineslice-cornerbottomleft,12774,1839,8,8,1,9,42,50,17480,0,0,0,0
sliderbar-nineslice-cornerbottomright,12775,1839,8,8,1,9,52,60,17481,0,0,0,0
sliderbar-nineslice-cornertopleft,12776,1839,8,8,1,9,62,70,17482,0,0,0,0
sliderbar-nineslice-cornertopright,12777,1839,8,8,1,9,72,80,17483,0,0,0,0
_sliderbar-nineslice-edgebottom,12778,1839,8,8,0,8,1,9,17484,0,0,4,0
_sliderbar-nineslice-edgetop,12779,1839,8,8,0,8,11,19,17485,0,0,4,0
!sliderbar-nineslice-edgeleft,12780,1840,8,8,1,9,0,8,17486,0,0,2,0
!sliderbar-nineslice-edgeright,12781,1840,8,8,11,19,0,8,17487,0,0,2,0
ui-frame-sliderbar-backgroundtile,12782,1841,8,8,1,9,1,9,17488,0,0,0,0
toast-nineslice-cornerbottomleft,12783,1842,16,16,1,17,37,53,17489,0,0,0,0
toast-nineslice-cornerbottomright,12784,1842,16,16,1,17,55,71,17490,0,0,0,0
toast-nineslice-cornertopleft,12785,1842,16,16,1,17,73,89,17491,0,0,0,0
toast-nineslice-cornertopright,12786,1842,16,16,1,17,91,107,17492,0,0,0,0
_toast-nineslice-edgebottom,12787,1842,16,16,0,16,1,17,17493,0,0,4,0
_toast-nineslice-edgetop,12788,1842,16,16,0,16,19,35,17494,0,0,4,0
!toast-nineslice-edgeleft,12789,1843,16,16,1,17,0,16,17495,0,0,2,0
!toast-nineslice-edgeright,12790,1843,16,16,19,35,0,16,17496,0,0,2,0
ui-frame-toast-backgroundtile,12791,1844,32,32,1,33,1,33,17497,0,0,0,0
calloutglow-nineslice-cornerbottomleft,12792,1845,16,16,1,17,37,53,17498,0,0,0,0
calloutglow-nineslice-cornerbottomright,12793,1845,16,16,1,17,55,71,17499,0,0,0,0
calloutglow-nineslice-cornertopleft,12794,1845,16,16,1,17,73,89,17500,0,0,0,0
calloutglow-nineslice-cornertopright,12795,1845,16,16,1,17,91,107,17501,0,0,0,0
_calloutglow-nineslice-edgebottom,12796,1845,16,16,0,16,1,17,17502,0,0,4,0
_calloutglow-nineslice-edgetop,12797,1845,16,16,0,16,19,35,17503,0,0,4,0
!calloutglow-nineslice-edgeleft,12798,1846,16,16,1,17,0,16,17504,0,0,2,0
!calloutglow-nineslice-edgeright,12799,1846,16,16,19,35,0,16,17505,0,0,2,0
dialogbox-nineslice-cornerbottomleft,12800,1847,32,32,1,33,70,102,17506,0,0,0,0
dialogbox-nineslice-cornerbottomright,12801,1847,32,32,1,33,104,136,17507,0,0,0,0
dialogbox-nineslice-cornertopleft,12802,1847,32,32,1,33,138,170,17508,0,0,0,0
dialogbox-nineslice-cornertopright,12803,1847,32,32,1,33,172,204,17509,0,0,0,0
_dialogbox-nineslice-edgebottom,12804,1847,32,33,0,32,1,34,17510,0,0,4,0
_dialogbox-nineslice-edgetop,12805,1847,32,32,0,32,36,68,17511,0,0,4,0
!dialogbox-nineslice-edgeleft,12806,1848,32,32,1,33,0,32,17512,0,0,2,0
!dialogbox-nineslice-edgeright,12807,1848,32,32,35,67,0,32,17513,0,0,2,0
ui-frame-dialogbox-backgroundtile,12808,1849,64,64,0,64,0,64,17514,0,0,6,0
achievement-wood-nineslice-cornerbottomleft,12811,1851,64,64,1,65,133,197,17515,0,0,0,0
achievement-wood-nineslice-cornerbottomright,12812,1851,64,64,1,65,199,263,17516,0,0,0,0
achievement-wood-nineslice-cornertopleft,12813,1851,64,64,1,65,265,329,17517,0,0,0,0
achievement-wood-nineslice-cornertopright,12814,1851,64,64,1,65,331,395,17518,0,0,0,0
_achievement-wood-nineslice-edgebottom,12815,1851,64,64,0,64,1,65,17519,0,0,4,0
_achievement-wood-nineslice-edgetop,12816,1851,64,64,0,64,67,131,17520,0,0,4,0
!achievement-wood-nineslice-edgeleft,12817,1852,64,64,1,65,0,64,17521,0,0,2,0
!achievement-wood-nineslice-edgeright,12818,1852,64,64,67,131,0,64,17522,0,0,2,0
arena-nineslice-cornerbottomleft,12819,1853,32,32,1,33,69,101,17523,0,0,0,0
arena-nineslice-cornerbottomright,12820,1853,32,32,1,33,103,135,17524,0,0,0,0
arena-nineslice-cornertopleft,12821,1853,32,32,1,33,137,169,17525,0,0,0,0
arena-nineslice-cornertopright,12822,1853,32,32,1,33,171,203,17526,0,0,0,0
_arena-nineslice-edgebottom,12823,1853,32,32,0,32,1,33,17527,0,0,4,0
_arena-nineslice-edgetop,12824,1853,32,32,0,32,35,67,17528,0,0,4,0
!arena-nineslice-edgeleft,12825,1854,32,32,1,33,0,32,17529,0,0,2,0
!arena-nineslice-edgeright,12826,1854,32,32,35,67,0,32,17530,0,0,2,0
splash-9102-botleft,12827,1855,137,371,374,511,587,958,17531,0,0,0,0
splash-9102-right,12828,1855,510,584,1,511,1,585,17532,0,0,0,0
splash-9102-topleft,12829,1855,371,434,1,372,587,1021,17533,0,0,0,0
torghast-empowered,12830,1856,256,128,1,257,1,129,17534,0,0,0,0
jailerstower-scorebar-onfire-backgroundglow,12831,1822,265,80,653,918,343,423,17535,0,0,0,0
jailerstower-scorebar-onfire-bgcenter,12832,1822,1,21,252,253,324,345,17536,0,0,0,0
jailerstower-scorebar-onfire-bgleft,12833,1822,103,21,147,250,370,391,17537,0,0,0,0
jailerstower-scorebar-onfire-bgright,12834,1822,127,21,122,249,472,493,17538,0,0,0,0
jailerstower-scorebar-onfire-bordercenter,12835,1822,1,23,248,249,420,443,17539,0,0,0,0
jailerstower-scorebar-onfire-borderleft,12836,1822,119,71,367,486,406,477,17540,0,0,0,0
jailerstower-scorebar-onfire-borderright,12837,1822,144,71,653,797,425,496,17541,0,0,0,0
jailerstower-scorebar-onfire-spark,12838,1822,97,50,268,365,334,384,17546,0,0,0,0
jailerstower-scorebar-onfire-fill-filling,12839,1822,512,17,367,879,324,341,17543,0,0,0,0
jailerstower-scorebar-onfire-bordertick,12840,1822,25,38,322,347,294,332,17544,0,0,0,0
tormentors-boss,12841,647,43,43,955,998,83,126,17547,35,35,0,0
tormentors-event,12842,647,43,43,203,246,575,618,17548,35,35,0,0
spellbook-skilllinetab,12852,1858,40,58,1,41,1,59,17558,0,0,0,0
128-redbutton-exit-highlight,12856,871,128,128,131,259,1171,1299,17565,0,0,0,0
tooltip-nineslice-center,12873,1826,64,64,0,64,0,64,17582,0,0,6,0
tooltip-azerite-nineslice-cornerbottomleft,12874,1262,32,32,1,33,58,90,17583,24,24,0,0
tooltip-azerite-nineslice-cornerbottomright,12875,1262,32,32,1,33,92,124,17584,24,24,0,0
tooltip-azerite-nineslice-cornertopleft,12876,1262,32,32,35,67,58,90,17585,24,24,0,0
tooltip-azerite-nineslice-cornertopright,12877,1262,32,32,35,67,92,124,17586,24,24,0,0
_tooltip-azerite-nineslice-edgebottom,12878,1262,32,12,0,32,1,13,17587,24,9,4,0
_tooltip-azerite-nineslice-edgetop,12879,1262,32,12,0,32,15,27,17588,24,9,4,0
!tooltip-azerite-nineslice-edgeleft,12880,1863,12,32,1,13,0,32,17589,9,24,2,0
!tooltip-azerite-nineslice-edgeright,12881,1863,12,32,15,27,0,32,17590,9,24,2,0
tooltip-azerite-nineslice-center,12882,1864,64,64,0,64,0,64,17591,0,0,6,0
tooltip-corrupted-nineslice-cornerbottomleft,12883,1527,32,32,1,33,58,90,17592,24,24,0,0
tooltip-corrupted-nineslice-cornerbottomright,12884,1527,32,32,1,33,92,124,17593,24,24,0,0
tooltip-corrupted-nineslice-cornertopleft,12885,1527,32,32,35,67,58,90,17594,24,24,0,0
tooltip-corrupted-nineslice-cornertopright,12886,1527,32,32,35,67,92,124,17595,24,24,0,0
_tooltip-corrupted-nineslice-edgebottom,12887,1527,32,12,0,32,1,13,17596,24,9,4,0
_tooltip-corrupted-nineslice-edgetop,12888,1527,32,12,0,32,15,27,17597,24,9,4,0
!tooltip-corrupted-nineslice-edgeleft,12889,1865,12,32,1,13,0,32,17598,9,24,2,0
!tooltip-corrupted-nineslice-edgeright,12890,1865,12,32,15,27,0,32,17599,9,24,2,0
tooltip-corrupted-nineslice-center,12891,1866,64,64,0,64,0,64,17600,0,0,6,0
tooltip-maw-nineslice-cornerbottomleft,12892,1658,32,32,1,33,58,90,17601,0,0,0,0
tooltip-maw-nineslice-cornerbottomright,12893,1658,32,32,1,33,92,124,17602,0,0,0,0
tooltip-maw-nineslice-cornertopleft,12894,1658,32,32,35,67,58,90,17603,0,0,0,0
tooltip-maw-nineslice-cornertopright,12895,1658,32,32,35,67,92,124,17604,0,0,0,0
_tooltip-maw-nineslice-edgebottom,12896,1658,32,12,0,32,1,13,17605,0,0,4,0
_tooltip-maw-nineslice-edgetop,12897,1658,32,12,0,32,15,27,17606,0,0,4,0
!tooltip-maw-nineslice-edgeleft,12898,1867,12,32,1,13,0,32,17607,0,0,2,0
!tooltip-maw-nineslice-edgeright,12899,1867,12,32,15,27,0,32,17608,0,0,2,0
tooltip-maw-nineslice-center,12900,1868,64,64,0,64,0,64,17609,0,0,6,0
friendship-parts-background,12909,1869,28,28,65,93,29,57,17611,0,0,0,0
friendship-parts-bar,12910,1869,263,26,65,328,1,27,17612,0,0,0,0
friendship-parts-circle,12911,1869,54,40,9,63,1,41,17613,0,0,0,0
friendship-parts-divider,12912,1869,6,19,1,7,1,20,17614,0,0,0,0
campaign_secretsofthefirstones,12985,1552,608,138,1,609,421,559,17677,0,0,0,2
questbg-secretsofthefirstones,12986,1871,299,407,1,300,1,408,17678,0,0,0,0
proglan-11,12987,1870,40,32,176,216,1,33,17679,0,0,0,0
proglan-30,12988,1870,36,32,41,77,69,101,17680,0,0,0,0
proglan-34,12989,1870,41,32,90,131,1,33,17681,0,0,0,0
proglan-2,12990,1870,35,32,41,76,137,169,17682,0,0,0,0
proglan-19,12991,1870,43,32,1,44,1,33,17683,0,0,0,0
proglan-36,12992,1870,39,32,43,82,35,67,17684,0,0,0,0
proglan-5,12993,1870,38,32,207,245,35,67,17685,0,0,0,0
proglan-6,12994,1870,36,32,41,77,103,135,17686,0,0,0,0
proglan-10,12995,1870,39,32,84,123,35,67,17687,0,0,0,0
proglan-29,12996,1870,23,32,113,136,205,237,17688,0,0,0,0
proglan-33,12997,1870,32,32,151,183,69,101,17689,0,0,0,0
proglan-23,12998,1870,40,32,1,41,35,67,17690,0,0,0,0
proglan-18,12999,1870,34,32,41,75,205,237,17691,0,0,0,0
proglan-15,13000,1870,37,32,218,255,1,33,17692,0,0,0,0
proglan-32,13001,1870,37,32,1,38,137,169,17693,0,0,0,0
proglan-24,13002,1870,37,32,1,38,171,203,17694,0,0,0,0
proglan-25,13003,1870,42,32,46,88,1,33,17695,0,0,0,0
proglan-20,13004,1870,28,32,79,107,205,237,17696,0,0,0,0
proglan-26,13005,1870,28,32,113,141,103,135,17697,0,0,0,0
proglan-28,13006,1870,34,32,79,113,69,101,17698,0,0,0,0
proglan-14,13007,1870,34,32,115,149,69,101,17699,0,0,0,0
proglan-12,13008,1870,32,32,185,217,69,101,17700,0,0,0,0
proglan-13,13009,1870,38,32,1,39,69,101,17701,0,0,0,0
proglan-7,13010,1870,39,32,125,164,35,67,17702,0,0,0,0
proglan-17,13011,1870,41,32,133,174,1,33,17703,0,0,0,0
proglan-27,13012,1870,31,32,79,110,137,169,17704,0,0,0,0
proglan-31,13013,1870,32,32,219,251,69,101,17705,0,0,0,0
proglan-1,13014,1870,19,32,143,162,103,135,17706,0,0,0,0
proglan-21,13015,1870,29,32,79,108,171,203,17707,0,0,0,0
proglan-8,13016,1870,37,32,1,38,205,237,17708,0,0,0,0
proglan-22,13017,1870,24,32,113,137,171,203,17709,0,0,0,0
proglan-35,13018,1870,32,32,79,111,103,135,17710,0,0,0,0
proglan-3,13019,1870,35,32,41,76,171,203,17711,0,0,0,0
proglan-16,13020,1870,26,32,113,139,137,169,17712,0,0,0,0
proglan-9,13021,1870,39,32,166,205,35,67,17713,0,0,0,0
proglan-4,13022,1870,38,32,1,39,103,135,17714,0,0,0,0
proglan-w-1,13023,1872,19,32,143,162,103,135,17715,0,0,0,0
proglan-w-10,13024,1872,39,32,43,82,35,67,17716,0,0,0,0
proglan-w-11,13025,1872,40,32,176,216,1,33,17717,0,0,0,0
proglan-w-12,13026,1872,32,32,151,183,69,101,17718,0,0,0,0
proglan-w-13,13027,1872,38,32,207,245,35,67,17719,0,0,0,0
proglan-w-14,13028,1872,34,32,41,75,205,237,17720,0,0,0,0
proglan-w-15,13029,1872,37,32,218,255,1,33,17721,0,0,0,0
proglan-w-16,13030,1872,26,32,113,139,137,169,17722,0,0,0,0
proglan-w-17,13031,1872,41,32,90,131,1,33,17723,0,0,0,0
proglan-w-18,13032,1872,34,32,79,113,69,101,17724,0,0,0,0
proglan-w-19,13033,1872,43,32,1,44,1,33,17725,0,0,0,0
proglan-w-2,13034,1872,35,32,41,76,137,169,17726,0,0,0,0
proglan-w-20,13035,1872,28,32,79,107,205,237,17727,0,0,0,0
proglan-w-21,13036,1872,29,32,79,108,171,203,17728,0,0,0,0
proglan-w-22,13037,1872,24,32,113,137,171,203,17729,0,0,0,0
proglan-w-23,13038,1872,40,32,1,41,35,67,17730,0,0,0,0
proglan-w-24,13039,1872,37,32,1,38,137,169,17731,0,0,0,0
proglan-w-25,13040,1872,42,32,46,88,1,33,17732,0,0,0,0
proglan-w-26,13041,1872,28,32,113,141,103,135,17733,0,0,0,0
proglan-w-27,13042,1872,31,32,79,110,137,169,17734,0,0,0,0
proglan-w-28,13043,1872,34,32,115,149,69,101,17735,0,0,0,0
proglan-w-29,13044,1872,23,32,113,136,205,237,17736,0,0,0,0
proglan-w-3,13045,1872,35,32,41,76,171,203,17737,0,0,0,0
proglan-w-30,13046,1872,36,32,41,77,69,101,17738,0,0,0,0
proglan-w-31,13047,1872,32,32,185,217,69,101,17739,0,0,0,0
proglan-w-32,13048,1872,37,32,1,38,171,203,17740,0,0,0,0
proglan-w-33,13049,1872,32,32,219,251,69,101,17741,0,0,0,0
proglan-w-34,13050,1872,41,32,133,174,1,33,17742,0,0,0,0
proglan-w-35,13051,1872,32,32,79,111,103,135,17743,0,0,0,0
proglan-w-36,13052,1872,39,32,84,123,35,67,17744,0,0,0,0
proglan-w-4,13053,1872,38,32,1,39,69,101,17745,0,0,0,0
proglan-w-5,13054,1872,38,32,1,39,103,135,17746,0,0,0,0
proglan-w-6,13055,1872,36,32,41,77,103,135,17747,0,0,0,0
proglan-w-7,13056,1872,39,32,125,164,35,67,17748,0,0,0,0
proglan-w-8,13057,1872,37,32,1,38,205,237,17749,0,0,0,0
proglan-w-9,13058,1872,39,32,166,205,35,67,17750,0,0,0,0
proglan-b-1,13059,1873,19,32,143,162,103,135,17751,0,0,0,0
proglan-b-10,13060,1873,39,32,43,82,35,67,17752,0,0,0,0
proglan-b-11,13061,1873,40,32,176,216,1,33,17753,0,0,0,0
proglan-b-12,13062,1873,32,32,151,183,69,101,17754,0,0,0,0
proglan-b-13,13063,1873,38,32,207,245,35,67,17755,0,0,0,0
proglan-b-14,13064,1873,34,32,41,75,205,237,17756,0,0,0,0
proglan-b-15,13065,1873,37,32,218,255,1,33,17757,0,0,0,0
proglan-b-16,13066,1873,26,32,113,139,137,169,17758,0,0,0,0
proglan-b-17,13067,1873,41,32,90,131,1,33,17759,0,0,0,0
proglan-b-18,13068,1873,34,32,79,113,69,101,17760,0,0,0,0
proglan-b-19,13069,1873,43,32,1,44,1,33,17761,0,0,0,0
proglan-b-2,13070,1873,35,32,41,76,137,169,17762,0,0,0,0
proglan-b-20,13071,1873,28,32,79,107,205,237,17763,0,0,0,0
proglan-b-21,13072,1873,29,32,79,108,171,203,17764,0,0,0,0
proglan-b-22,13073,1873,24,32,113,137,171,203,17765,0,0,0,0
proglan-b-23,13074,1873,40,32,1,41,35,67,17766,0,0,0,0
proglan-b-24,13075,1873,37,32,1,38,137,169,17767,0,0,0,0
proglan-b-25,13076,1873,42,32,46,88,1,33,17768,0,0,0,0
proglan-b-26,13077,1873,28,32,113,141,103,135,17769,0,0,0,0
proglan-b-27,13078,1873,31,32,79,110,137,169,17770,0,0,0,0
proglan-b-28,13079,1873,34,32,115,149,69,101,17771,0,0,0,0
proglan-b-29,13080,1873,23,32,113,136,205,237,17772,0,0,0,0
proglan-b-3,13081,1873,35,32,41,76,171,203,17773,0,0,0,0
proglan-b-30,13082,1873,36,32,41,77,69,101,17774,0,0,0,0
proglan-b-31,13083,1873,32,32,185,217,69,101,17775,0,0,0,0
proglan-b-32,13084,1873,37,32,1,38,171,203,17776,0,0,0,0
proglan-b-33,13085,1873,32,32,219,251,69,101,17777,0,0,0,0
proglan-b-34,13086,1873,41,32,133,174,1,33,17778,0,0,0,0
proglan-b-35,13087,1873,32,32,79,111,103,135,17779,0,0,0,0
proglan-b-36,13088,1873,39,32,84,123,35,67,17780,0,0,0,0
proglan-b-4,13089,1873,38,32,1,39,69,101,17781,0,0,0,0
proglan-b-5,13090,1873,38,32,1,39,103,135,17782,0,0,0,0
proglan-b-6,13091,1873,36,32,41,77,103,135,17783,0,0,0,0
proglan-b-7,13092,1873,39,32,125,164,35,67,17784,0,0,0,0
proglan-b-8,13093,1873,37,32,1,38,205,237,17785,0,0,0,0
proglan-b-9,13094,1873,39,32,166,205,35,67,17786,0,0,0,0
proglan-y-1,13095,1874,19,32,143,162,103,135,17787,0,0,0,0
proglan-y-10,13096,1874,39,32,43,82,35,67,17788,0,0,0,0
proglan-y-11,13097,1874,40,32,176,216,1,33,17789,0,0,0,0
proglan-y-12,13098,1874,32,32,151,183,69,101,17790,0,0,0,0
proglan-y-13,13099,1874,38,32,207,245,35,67,17791,0,0,0,0
proglan-y-14,13100,1874,34,32,41,75,205,237,17792,0,0,0,0
proglan-y-15,13101,1874,37,32,218,255,1,33,17793,0,0,0,0
proglan-y-16,13102,1874,26,32,113,139,137,169,17794,0,0,0,0
proglan-y-17,13103,1874,41,32,90,131,1,33,17795,0,0,0,0
proglan-y-18,13104,1874,34,32,79,113,69,101,17796,0,0,0,0
proglan-y-19,13105,1874,43,32,1,44,1,33,17797,0,0,0,0
proglan-y-2,13106,1874,35,32,41,76,137,169,17798,0,0,0,0
proglan-y-20,13107,1874,28,32,79,107,205,237,17799,0,0,0,0
proglan-y-21,13108,1874,29,32,79,108,171,203,17800,0,0,0,0
proglan-y-22,13109,1874,24,32,113,137,171,203,17801,0,0,0,0
proglan-y-23,13110,1874,40,32,1,41,35,67,17802,0,0,0,0
proglan-y-24,13111,1874,37,32,1,38,137,169,17803,0,0,0,0
proglan-y-25,13112,1874,42,32,46,88,1,33,17804,0,0,0,0
proglan-y-26,13113,1874,28,32,113,141,103,135,17805,0,0,0,0
proglan-y-27,13114,1874,31,32,79,110,137,169,17806,0,0,0,0
proglan-y-28,13115,1874,34,32,115,149,69,101,17807,0,0,0,0
proglan-y-29,13116,1874,23,32,113,136,205,237,17808,0,0,0,0
proglan-y-3,13117,1874,35,32,41,76,171,203,17809,0,0,0,0
proglan-y-30,13118,1874,36,32,41,77,69,101,17810,0,0,0,0
proglan-y-31,13119,1874,32,32,185,217,69,101,17811,0,0,0,0
proglan-y-32,13120,1874,37,32,1,38,171,203,17812,0,0,0,0
proglan-y-33,13121,1874,32,32,219,251,69,101,17813,0,0,0,0
proglan-y-34,13122,1874,41,32,133,174,1,33,17814,0,0,0,0
proglan-y-35,13123,1874,32,32,79,111,103,135,17815,0,0,0,0
proglan-y-36,13124,1874,39,32,84,123,35,67,17816,0,0,0,0
proglan-y-4,13125,1874,38,32,1,39,69,101,17817,0,0,0,0
proglan-y-5,13126,1874,38,32,1,39,103,135,17818,0,0,0,0
proglan-y-6,13127,1874,36,32,41,77,103,135,17819,0,0,0,0
proglan-y-7,13128,1874,39,32,125,164,35,67,17820,0,0,0,0
proglan-y-8,13129,1874,37,32,1,38,205,237,17821,0,0,0,0
proglan-y-9,13130,1874,39,32,166,205,35,67,17822,0,0,0,0
proglan-d-1,13131,1875,19,32,112,131,205,237,17823,0,0,0,0
proglan-d-10,13132,1875,39,32,43,82,35,67,17824,0,0,0,0
proglan-d-11,13133,1875,40,32,176,216,1,33,17825,0,0,0,0
proglan-d-12,13134,1875,32,32,115,147,69,101,17826,0,0,0,0
proglan-d-13,13135,1875,38,32,166,204,35,67,17827,0,0,0,0
proglan-d-14,13136,1875,34,32,41,75,171,203,17828,0,0,0,0
proglan-d-15,13137,1875,37,32,218,255,1,33,17829,0,0,0,0
proglan-d-16,13138,1875,26,32,112,138,103,135,17830,0,0,0,0
proglan-d-17,13139,1875,41,32,90,131,1,33,17831,0,0,0,0
proglan-d-18,13140,1875,34,32,41,75,205,237,17832,0,0,0,0
proglan-d-19,13141,1875,43,32,1,44,1,33,17833,0,0,0,0
proglan-d-2,13142,1875,35,32,41,76,103,135,17834,0,0,0,0
proglan-d-20,13143,1875,28,32,79,107,171,203,17835,0,0,0,0
proglan-d-21,13144,1875,29,32,79,108,137,169,17836,0,0,0,0
proglan-d-22,13145,1875,24,32,112,136,137,169,17837,0,0,0,0
proglan-d-23,13146,1875,40,32,1,41,35,67,17838,0,0,0,0
proglan-d-24,13147,1875,37,32,1,38,103,135,17839,0,0,0,0
proglan-d-25,13148,1875,42,32,46,88,1,33,17840,0,0,0,0
proglan-d-26,13149,1875,28,32,79,107,205,237,17841,0,0,0,0
proglan-d-27,13150,1875,31,32,79,110,103,135,17842,0,0,0,0
proglan-d-28,13151,1875,34,32,79,113,69,101,17843,0,0,0,0
proglan-d-29,13152,1875,23,32,112,135,171,203,17844,0,0,0,0
proglan-d-3,13153,1875,35,32,41,76,137,169,17845,0,0,0,0
proglan-d-30,13154,1875,36,32,1,37,205,237,17846,0,0,0,0
proglan-d-31,13155,1875,32,32,149,181,69,101,17847,0,0,0,0
proglan-d-32,13156,1875,37,32,1,38,137,169,17848,0,0,0,0
proglan-d-33,13157,1875,32,32,183,215,69,101,17849,0,0,0,0
proglan-d-34,13158,1875,41,32,133,174,1,33,17850,0,0,0,0
proglan-d-35,13159,1875,32,32,217,249,69,101,17851,0,0,0,0
proglan-d-4,13160,1875,38,32,206,244,35,67,17852,0,0,0,0
proglan-d-5,13161,1875,38,32,1,39,69,101,17853,0,0,0,0
proglan-d-6,13162,1875,36,32,41,77,69,101,17854,0,0,0,0
proglan-d-7,13163,1875,39,32,84,123,35,67,17855,0,0,0,0
proglan-d-8,13164,1875,37,32,1,38,171,203,17856,0,0,0,0
proglan-d-9,13165,1875,39,32,125,164,35,67,17857,0,0,0,0
hud-backpack,13166,940,64,64,654,718,167,231,17858,0,0,0,0
charactercreate-customize-dropdown-newtagglow,13167,708,40,40,1149,1189,455,495,17859,0,0,0,0
groupfinder-icon-lock,13168,236,63,76,331,394,553,629,17860,28,34,0,0
gmchat-nineslice-cornerbottomleft,13169,1876,7,7,23,30,29,36,17861,0,0,0,0
gmchat-nineslice-cornerbottomright,13170,1876,7,7,23,30,38,45,17862,0,0,0,0
gmchat-nineslice-cornertopleft,13171,1876,7,7,23,30,51,58,17863,0,0,0,0
gmchat-nineslice-cornertopright,13172,1876,7,7,23,30,60,67,17864,0,0,0,0
_gmchat-nineslice-edgebottom,13173,1876,8,5,0,8,1,6,17865,0,0,4,0
_gmchat-nineslice-edgetop,13174,1876,8,5,0,8,8,13,17866,0,0,4,0
!gmchat-nineslice-edgeleft,13175,1877,5,16,1,6,0,16,17867,0,0,2,0
!gmchat-nineslice-edgeright,13176,1877,5,16,8,13,0,16,17868,0,0,2,0
cosmetictoast-background,13180,1879,304,105,1,305,1,106,17872,0,0,0,0
gmchat-icon-alert,13181,1876,20,20,1,21,29,49,17873,0,0,0,0
gmchat-icon-blizz,13182,1876,20,20,1,21,51,71,17874,0,0,0,0
gmchat-icon-wow,13183,1876,20,20,1,21,73,93,17875,0,0,0,0
gmglow-nineslice-cornerbottomleft,13184,1876,7,7,23,30,73,80,17876,0,0,0,0
gmglow-nineslice-cornerbottomright,13185,1876,7,7,23,30,82,89,17877,0,0,0,0
gmglow-nineslice-cornertopleft,13186,1876,7,7,1,8,95,102,17878,0,0,0,0
gmglow-nineslice-cornertopright,13187,1876,7,7,10,17,95,102,17879,0,0,0,0
_gmglow-nineslice-edgebottom,13188,1876,8,5,0,8,15,20,17880,0,0,4,0
_gmglow-nineslice-edgetop,13189,1876,8,5,0,8,22,27,17881,0,0,4,0
!gmglow-nineslice-edgeleft,13190,1877,5,16,15,20,0,16,17882,0,0,2,0
!gmglow-nineslice-edgeright,13191,1877,5,16,22,27,0,16,17883,0,0,2,0
dressingroom-button-appearancelist-down,13192,1878,27,25,484,511,1,26,17870,0,0,0,0
dressingroom-button-appearancelist-up,13193,1878,27,25,484,511,43,68,17871,0,0,0,0
dressingroom-itemborder-account,13194,1878,40,40,316,356,1,41,17884,20,20,0,0
dressingroom-itemborder-artifact,13195,1878,40,40,358,398,1,41,17885,20,20,0,0
dressingroom-itemborder-blue,13196,1878,40,40,400,440,1,41,17886,20,20,0,0
dressingroom-itemborder-error,13197,1878,40,40,442,482,1,41,17887,20,20,0,0
dressingroom-itemborder-gray,13198,1878,40,40,316,356,43,83,17888,20,20,0,0
dressingroom-itemborder-green,13199,1878,40,40,358,398,43,83,17889,20,20,0,0
dressingroom-itemborder-orange,13200,1878,40,40,400,440,43,83,17890,20,20,0,0
dressingroom-itemborder-purple,13201,1878,40,40,442,482,43,83,17891,20,20,0,0
dressingroom-itemborder-small-account,13202,1878,28,28,1,29,476,504,17892,14,14,0,0
dressingroom-itemborder-small-artifact,13203,1878,28,28,31,59,476,504,17893,14,14,0,0
dressingroom-itemborder-small-blue,13204,1878,28,28,61,89,476,504,17894,14,14,0,0
dressingroom-itemborder-small-error,13205,1878,28,28,91,119,476,504,17895,14,14,0,0
dressingroom-itemborder-small-gray,13206,1878,28,28,121,149,476,504,17896,14,14,0,0
dressingroom-itemborder-small-green,13207,1878,28,28,151,179,476,504,17897,14,14,0,0
dressingroom-itemborder-small-orange,13208,1878,28,28,181,209,476,504,17898,14,14,0,0
dressingroom-itemborder-small-purple,13209,1878,28,28,211,239,476,504,17899,14,14,0,0
dressingroom-itemborder-small-white,13210,1878,28,28,271,299,476,504,17900,14,14,0,0
dressingroom-itemborder-white,13211,1878,40,40,358,398,85,125,17901,20,20,0,0
dressingroom-sideframe,13212,1878,313,473,1,314,1,474,17869,0,0,0,0
dressingroom-itemborder-small-uncollected,13213,1878,28,28,241,269,476,504,17902,14,14,0,0
dressingroom-itemborder-uncollected,13214,1878,40,40,316,356,85,125,17903,20,20,0,0
shop-card-full-915dragonbundle,13216,1880,568,463,1,569,1,464,17905,0,0,0,0
itemupgrade_bottompanel-shadow,13219,1881,532,359,1275,1807,43,402,17908,0,0,0,0
itemupgrade_bottompanel,13220,1881,532,359,741,1273,43,402,17909,0,0,0,0
itemupgrade_slotborder,13221,1881,70,72,121,191,771,843,17910,0,0,0,0
itemupgrade_toppanel,13222,1881,532,154,193,725,771,925,17911,0,0,0,0
store-card-transmog,13224,1460,286,433,579,865,1,434,17913,0,0,0,0
itemupgrade_fx_framedecor_micafleckssheen,13227,1881,738,726,1,739,43,769,17916,0,0,0,0
itemupgrade_fx_tooltip_goldflake,13229,1881,403,415,1593,1996,404,819,17918,0,0,0,0
itemupgrade_fx_tooltip_overlay,13230,1881,374,346,741,1115,404,750,17919,0,0,0,0
itemupgrade_fx_framedecor_linemask,13231,1882,1024,1024,0,1024,0,1024,17920,0,0,16,0
itemupgrade_fx_framedecor_micaflecksmask,13234,1883,512,512,0,512,0,512,17921,0,0,16,0
legendaryscrapper-background,13251,1886,323,194,1,324,1,195,17930,0,0,0,0
legendaryscrapper-glow,13252,1886,97,97,326,423,1,98,17931,0,0,0,0
itemupgrade_totalcostbar,13255,1881,220,20,181,401,1,21,17934,0,0,0,0
itemupgrade_fx_slotinnerglow,13256,1881,57,56,1,58,771,827,17935,0,0,0,0
itemupgrade_greenplusicon,13258,1881,59,58,60,119,771,829,17936,0,0,0,0
itemupgrade_greenplusicon_pressed,13259,1881,59,58,60,119,831,889,17937,0,0,0,0
!itemupgrade_fx_framedecor_idleglow,13260,1888,643,1024,1,644,0,1024,17938,0,0,2,0
shop-image-bundle-mbp1,13261,1889,286,434,571,857,1,435,17939,0,0,0,0
shop-image-bundle-mbp2,13262,1889,568,463,1,569,1,464,17940,0,0,0,0
clickcastlist-buttonbackground,13264,117,393,46,1,394,1,47,17942,0,0,0,0
clickcastlist-buttonhighlight,13265,117,393,46,1,394,49,95,17943,0,0,0,0
clickcastlist-buttonnew,13266,117,393,46,1,394,97,143,17944,0,0,0,0
clickcast-highlight-spellbook,13267,1890,72,72,1,73,231,303,17945,0,0,0,0
clickcast-icon-mouse,13268,1890,63,63,1,64,305,368,17946,0,0,0,0
sliderbar-button,13269,1839,13,19,1,14,21,40,17947,0,0,0,0
shop-card-full-lunar180gametime,13322,1894,568,463,1,569,1,464,17976,0,0,0,0
shop-card-full-lunar6subscription,13323,1894,568,463,1,569,466,929,17977,0,0,0,0
tooltip_innerglow_mask_corner,13327,1895,32,32,0,32,0,32,17981,0,0,16,0
item_upgrade_tooltip_fullmask,13328,1896,256,256,0,256,0,256,17980,0,0,16,0
itemupgradetooltip-nineslice-corner,13343,1898,32,32,1,33,69,101,17994,0,0,0,0
_itemupgradetooltip-nineslice-edgebottom,13344,1898,32,32,0,32,1,33,17995,0,0,4,0
_itemupgradetooltip-nineslice-edgetop,13345,1898,32,32,0,32,35,67,17996,0,0,4,0
!itemupgradetooltip-nineslice-edgeleft,13346,1893,32,32,1,33,0,32,17997,0,0,2,0
!itemupgradetooltip-nineslice-edgeright,13347,1893,32,32,35,67,0,32,17998,0,0,2,0
itemupgrade_helptiparrow,13348,1881,28,65,1,29,829,894,17999,0,0,0,0
itemupgrade_fx_framedecor_ring,13360,1897,722,722,1,723,1,723,18006,0,0,0,0
itemupgrade_fx_buttonglow,13362,1881,178,40,1,179,1,41,18007,0,0,0,0
itemupgrade_fx_tooltip_confirmsheen,13363,1881,473,410,1117,1591,404,831,18008,0,0,0,0
flightmaster_progenitor-taxi_frame_gray,13364,1900,40,40,1,41,1,41,18009,0,0,0,0
flightmaster_progenitor-taxi_frame_green,13365,1900,40,40,43,83,1,41,18010,0,0,0,0
flightmaster_progenitor-taxi_frame_yellow,13366,1900,40,40,85,125,1,41,18011,0,0,0,0
flightmaster_progenitor-taxinode_neutral,13367,647,40,40,203,243,664,704,18012,20,20,0,0
progenitorflightmaster-32x32,13368,647,32,32,717,749,477,509,18013,0,0,0,0
clickcast-background-tutorial,13369,1890,487,228,1,488,1,229,18014,0,0,0,0
dressingroom-itemborder-illusion,13370,1878,40,40,400,440,85,125,18015,20,20,0,0
dressingroom-itemborder-small-illusion,13371,1878,28,28,442,470,85,113,18016,14,14,0,0
shop-card-half-915celestialbundle,13373,1902,286,471,1,287,1,472,17906,0,0,0,0
clickcast-icon-add,13375,1890,39,39,1,40,411,450,18018,0,0,0,0
clickcast-highlight-binding,13376,1890,39,39,1,40,370,409,18019,0,0,0,0
shop-count-ring,13410,654,32,32,453,485,1,33,18053,0,0,0,0
classicon-evoker,13449,897,128,128,1,129,391,519,18674,0,0,0,0
raceicon-dracthyr-female,13450,897,64,64,1633,1697,131,195,18078,0,0,0,0
raceicon-dracthyr-male,13451,897,64,64,1699,1763,131,195,18079,0,0,0,0
raceicon128-dracthyr-female,13452,897,128,128,261,389,391,519,18080,0,0,0,0
raceicon128-dracthyr-male,13453,897,128,128,261,389,521,649,18081,0,0,0,0
cyphertalents-background,13454,1908,730,524,1,731,1,525,18082,0,0,0,0
shop-bundles-915-ate,13455,1909,566,225,1,567,1,226,18083,0,0,0,0
shop-bundles-915-ath,13456,1909,566,225,569,1135,1,226,18084,0,0,0,0
shop-bundles-915-athe,13457,1909,566,225,1137,1703,1,226,18085,0,0,0,0
shop-bundles-915-brb,13458,1909,566,225,1,567,228,453,18086,0,0,0,0
shop-bundles-915-bre,13459,1909,566,225,569,1135,228,453,18087,0,0,0,0
shop-bundles-915-brh,13460,1909,566,225,1137,1703,228,453,18088,0,0,0,0
shop-bundles-915-brn,13461,1909,566,225,1,567,455,680,18089,0,0,0,0
shop-bundles-915-cba,13462,1909,277,224,1705,1982,1,225,18090,0,0,0,0
shop-bundles-915-cbh,13463,1909,277,224,1705,1982,228,452,18091,0,0,0,0
shop-bundles-915-cbi,13464,1909,277,224,1705,1982,455,679,18092,0,0,0,0
shop-bundles-915-cbo,13465,1909,277,224,1705,1982,682,906,18093,0,0,0,0
shop-bundles-915-nh,13466,1909,277,224,1705,1982,909,1133,18094,0,0,0,0
shop-bundles-915-tb,13467,1909,277,224,1,278,1136,1360,18095,0,0,0,0
shop-bundles-915-tbe,13468,1909,566,225,569,1135,455,680,18096,0,0,0,0
shop-bundles-915-tbh,13469,1909,277,224,1,278,1362,1586,18097,0,0,0,0
shop-bundles-915-te,13470,1909,566,225,1137,1703,455,680,18098,0,0,0,0
shop-bundles-915-tecc,13471,1909,566,225,1,567,682,907,18099,0,0,0,0
shop-bundles-915-th,13472,1909,277,224,1,278,1588,1812,18100,0,0,0,0
shop-bundles-915-thcc,13473,1909,277,224,1,278,1814,2038,18101,0,0,0,0
shop-bundles-915-the,13474,1909,566,225,569,1135,682,907,18102,0,0,0,0
splash-915-botleft,13475,1910,137,371,374,511,589,960,18103,0,0,0,0
splash-915-right,13476,1910,510,586,1,511,1,587,18104,0,0,0,0
splash-915-topleft,13477,1910,371,434,1,372,589,1023,18105,0,0,0,0
orderhalltalents-choice-talent-middle,13478,758,56,60,73,129,279,339,18106,0,0,0,0
orderhalltalents-choice-talent-side,13479,758,61,60,1,62,437,497,18107,0,0,0,0
orderhalltalents-choice-track-on,13480,758,60,60,73,133,217,277,18108,0,0,0,0
orderhalltalents-choice-track,13481,758,60,60,73,133,155,215,18109,0,0,0,0
cypher-customization-background,13482,1908,666,372,1,667,527,899,18110,0,0,0,0
bastionanima-horizontal-bg,13487,1911,256,50,1,257,67,117,18115,0,0,0,0
bastionanima-horizontal-fill,13488,1911,256,50,1,257,119,169,18116,0,0,0,0
bastionanima-horizontal-flash,13489,1911,256,64,1,257,1,65,18117,0,0,0,0
bastionanima-horizontal-spark,13490,1911,8,64,259,267,1,65,18118,0,0,0,0
orderhalltalents-choice-prereq-highlight-glow,13501,758,152,152,1,153,1,153,18129,76,76,0,0
ui-frame-cypherchoice-cardparchment-style1,13503,1912,292,573,1,293,1,574,18131,0,0,0,0
ui-frame-cypherchoice-cardparchment-style2,13504,1912,292,573,295,587,1,574,18132,0,0,0,0
ui-frame-cypherchoice-cardparchment-style3,13505,1912,292,573,589,881,1,574,18133,0,0,0,0
ui-frame-cypherchoice-fx-wisps,13510,1912,232,384,1,233,576,960,18138,0,0,0,0
flightmaster_bastion-taxi_frame_special,13516,1734,38,38,1,39,41,79,18144,0,0,0,0
ui-frame-cypherchoice-portrait-border,13521,1912,178,180,295,473,775,955,18145,0,0,0,0
ui-frame-cypherchoice-portrait-qualityepic-border,13522,1912,178,180,589,767,576,756,18141,0,0,0,0
ui-frame-cypherchoice-portrait-qualityrare-border,13523,1912,178,180,589,767,758,938,18142,0,0,0,0
ui-frame-cypherchoice-portrait-qualityuncommon-border,13524,1912,178,180,883,1061,128,308,18143,0,0,0,0
ui-frame-cypherchoice-fx-bottomglow,13525,1912,205,197,295,500,576,773,18134,0,0,0,0
ui-frame-cypherchoice-fx-pixels01,13527,1912,117,135,883,1000,310,445,18136,0,0,0,0
ui-frame-cypherchoice-fx-pixels02,13528,1912,126,113,1501,1627,1,114,18137,0,0,0,0
ui-frame-cypherchoice-fx-glowmask,13530,1914,256,256,0,256,0,256,18146,0,0,16,0
ui-frame-cypherchoice-fx-linemask,13532,1913,512,512,0,512,0,512,18130,0,0,16,0
ui-frame-cypherchoice-hidebutton,13534,1912,203,54,1,204,962,1016,18139,0,0,0,0
ui-frame-cypherchoice-pendingbutton,13535,1912,267,54,1232,1499,1,55,18150,0,0,0,0
ui-frame-cypherchoice-pendingbuttonhighlight,13536,1912,267,54,1232,1499,57,111,18151,0,0,0,0
ui-frame-cypherchoice-countdownshadow,13537,1912,347,125,883,1230,1,126,18152,0,0,0,0
cypher-zone-ability-2,13539,1916,256,128,1,257,131,259,18154,0,0,0,0
cypher-zone-ability,13540,1916,256,128,1,257,1,129,18155,0,0,0,0
progenitor-extrabutton,13541,1916,256,128,1,257,261,389,18156,0,0,0,0
ui-frame-cypherchoice-fx-lineglow,13542,1915,239,512,1,240,0,512,18135,0,0,2,0
ui-frame-cypherchoice-pendingbuttonfxglow,13543,1912,112,38,295,407,957,995,18157,0,0,0,0
ui-frame-cypherchoice-portrait-fx-goldglow,13544,1912,113,121,883,996,685,806,18148,0,0,0,0
ui-frame-cypherchoice-pendingbuttonfxmask,13545,1917,253,39,1,254,1,40,18158,0,0,0,0
warlockportal-yellow-32x32,13587,647,32,32,955,987,613,645,18200,0,0,0,0
perks-backbutton-disabled,13589,1918,42,42,603,645,644,686,18160,0,0,0,0
perks-backbutton-down,13590,1918,42,42,603,645,688,730,18161,0,0,0,0
perks-backbutton,13591,1918,42,42,603,645,600,642,18162,0,0,0,0
perks-button-down,13592,1918,49,47,956,1005,500,547,18163,0,0,0,0
perks-button-up,13593,1918,49,47,533,582,794,841,18164,0,0,0,0
perks-clock,13595,1918,15,16,997,1012,550,566,18166,0,0,0,0
perks-divider-short,13596,1918,359,3,523,882,1212,1215,18167,0,0,0,0
perks-divider,13597,1918,484,3,523,1007,1207,1210,18168,0,0,0,0
perks-dropdown-clear,13598,1918,30,31,961,991,382,413,18169,0,0,0,0
perks-dropdown-mouseover-side,13599,1918,12,40,1007,1019,500,540,18171,0,0,0,0
perks-hold-slot-corner,13607,1918,30,31,993,1023,382,413,18179,0,0,0,0
perks-icon-rotate-left,13609,1918,28,26,927,955,297,323,18181,0,0,0,0
perks-icon-rotate-right,13610,1918,26,25,997,1023,293,318,18182,0,0,0,0
perks-nextbutton-disabled,13616,1918,42,42,603,645,776,818,18188,0,0,0,0
perks-nextbutton-down,13617,1918,42,42,647,689,600,642,18189,0,0,0,0
perks-nextbutton,13618,1918,42,42,603,645,732,774,18190,0,0,0,0
perks-owned-large,13619,1918,38,39,957,995,293,332,18191,0,0,0,0
perks-radio-background,13621,1918,20,20,945,965,472,492,18193,0,0,0,0
perks-radio-dot,13622,1918,18,18,989,1007,472,490,18194,0,0,0,0
perks-warning-large,13626,1918,40,34,885,925,297,331,18198,0,0,0,0
perks-warning-small,13627,1918,22,20,881,903,472,492,18199,0,0,0,0
perks-checkbox,13632,1918,20,20,923,943,472,492,18207,0,0,0,0
perks-icon-checkmark,13633,1918,21,18,997,1018,451,469,18208,0,0,0,0
perks-forwardarrow,13634,1918,12,16,1009,1021,472,488,18209,0,0,0,0
ui-frame-cypherchoice-portrait-fx-mask,13635,1920,113,121,1,114,1,122,18210,0,0,0,0
minimal-scrollbar-arrow-bottom,13636,1921,17,11,31,48,52,63,18211,0,0,0,0
minimal-scrollbar-arrow-top,13637,1921,17,11,88,105,1,12,18212,0,0,0,0
minimal-scrollbar-thumb-bottom,13638,1921,8,36,1,9,1,37,18213,0,0,0,0
minimal-scrollbar-thumb-top,13639,1921,8,8,1,9,39,47,18214,0,0,0,0
minimal-scrollbar-track-bottom,13640,1921,8,8,11,19,49,57,18215,0,0,0,0
minimal-scrollbar-track-top,13641,1921,8,8,21,29,39,47,18216,0,0,0,0
!minimal-scrollbar-track-middle,13642,1922,8,1,1,9,0,1,18217,0,0,2,0
_perks-dropdown-mouseover-middle,13647,1918,1,40,0,1,141,181,18222,0,0,4,0
minimal-scrollbar-arrow-bottom-down,13651,1921,17,11,50,67,1,12,18226,0,0,0,0
minimal-scrollbar-arrow-bottom-over,13652,1921,17,11,69,86,1,12,18227,0,0,0,0
minimal-scrollbar-arrow-top-down,13653,1921,17,11,107,124,1,12,18228,0,0,0,0
minimal-scrollbar-arrow-top-over,13654,1921,17,11,50,67,14,25,18229,0,0,0,0
minimal-scrollbar-thumb-bottom-down,13655,1921,8,36,11,19,1,37,18230,0,0,0,0
minimal-scrollbar-thumb-bottom-over,13656,1921,8,36,21,29,1,37,18231,0,0,0,0
minimal-scrollbar-thumb-top-down,13657,1921,8,8,1,9,49,57,18232,0,0,0,0
minimal-scrollbar-thumb-top-over,13658,1921,8,8,11,19,39,47,18233,0,0,0,0
dropdown-hover-arrow,13665,1923,14,8,1,15,433,441,18238,0,0,0,0
dropdown-hover-left-cap,13666,1923,16,46,1,17,145,191,18239,0,0,0,0
dropdown-hover-right-cap,13667,1923,16,46,1,17,193,239,18240,0,0,0,0
dropdown-left-cap,13668,1923,16,46,1,17,241,287,18241,0,0,0,0
dropdown-open-left-cap,13669,1923,16,46,1,17,289,335,18242,0,0,0,0
dropdown-open-right-cap,13670,1923,16,46,1,17,337,383,18243,0,0,0,0
dropdown-right-cap,13671,1923,16,46,1,17,385,431,18244,0,0,0,0
_dropdown-hover-middle,13672,1923,16,46,0,16,1,47,18245,0,0,4,0
_dropdown-middle,13673,1923,16,46,0,16,49,95,18246,0,0,4,0
_dropdown-open-middle,13674,1923,16,46,0,16,97,143,18247,0,0,4,0
cosmic-bar-runes-bg,13685,1924,333,97,1,334,1,98,18258,0,0,0,0
widgetstatusbar-bgcenter,13687,1925,64,18,0,64,67,85,18260,0,0,4,0
widgetstatusbar-bgleft,13688,1925,29,18,94,123,172,190,18261,0,0,0,0
widgetstatusbar-bgright,13689,1925,29,18,94,123,192,210,18262,0,0,0,0
widgetstatusbar-bordercenter,13690,1925,64,31,0,64,1,32,18263,0,0,4,0
widgetstatusbar-borderleft,13691,1925,35,31,1,36,172,203,18264,0,0,0,0
widgetstatusbar-borderright,13692,1925,35,31,1,36,205,236,18265,0,0,0,0
widgetstatusbar-bordertick,13693,1925,17,31,75,92,172,203,18266,0,0,0,0
widgetstatusbar-fill-blue,13694,1925,256,15,0,256,87,102,18267,0,0,4,0
widgetstatusbar-fill-green,13695,1925,256,15,0,256,104,119,18268,0,0,4,0
widgetstatusbar-fill-red,13696,1925,256,15,0,256,121,136,18269,0,0,4,0
widgetstatusbar-fill-white,13697,1925,256,15,0,256,138,153,18270,0,0,4,0
widgetstatusbar-fill-yellow,13698,1925,256,15,0,256,155,170,18271,0,0,4,0
widgetstatusbar-glowcenter,13699,1925,64,31,0,64,34,65,18272,0,0,4,0
widgetstatusbar-glowleft,13700,1925,35,31,38,73,172,203,18273,0,0,0,0
widgetstatusbar-glowright,13701,1925,34,31,38,72,205,236,18274,0,0,0,0
widgetstatusbar-spark,13702,1925,8,32,75,83,205,237,18275,0,0,0,0
perks-gradient-orgrimmar-left,13733,1918,950,1,1,951,1357,1358,18276,0,0,0,0
perks-gradient-orgrimmar-right,13734,1918,600,1,1,601,1363,1364,18277,0,0,0,0
perks-gradient-stormwind-left,13735,1918,950,1,1,951,1360,1361,18278,0,0,0,0
perks-gradient-stormwind-right,13736,1918,600,1,1,601,1366,1367,18279,0,0,0,0
cyphersetupgrade-arrow-empty,13830,1928,17,45,455,472,1,46,18281,0,0,0,0
cyphersetupgrade-arrow-full,13831,1928,17,45,455,472,48,93,18282,0,0,0,0
cyphersetupgrade-background,13832,1928,322,193,1,323,1,194,18283,0,0,0,0
cyphersetupgrade-leftitem-border-empty,13833,1928,82,95,1,83,196,291,18284,0,0,0,0
cyphersetupgrade-leftitem-border-full,13834,1928,82,95,1,83,293,388,18285,0,0,0,0
cyphersetupgrade-rightitem-border-empty,13835,1928,82,95,1,83,390,485,18286,0,0,0,0
cyphersetupgrade-rightitem-border-full,13836,1928,82,95,85,167,196,291,18287,0,0,0,0
flightmaster_progenitorobelisk-taxi_frame_gray,13838,1929,40,40,1,41,1,41,18289,0,0,0,0
flightmaster_progenitorobelisk-taxi_frame_green,13839,1929,40,40,43,83,1,41,18290,0,0,0,0
flightmaster_progenitorobelisk-taxi_frame_yellow,13840,1929,40,40,85,125,1,41,18291,0,0,0,0
creationcatalyst-32x32,13841,647,32,32,377,409,477,509,18292,0,0,0,0
flightmaster_progenitorobelisk-taxinode_neutral,13842,647,40,40,203,243,706,746,18293,20,20,0,0
flightmaster_progenitorobelisk-taxi_frame_special,13843,1929,40,40,1,41,43,83,18294,0,0,0,0
cosmic-bar-bgcenter,13844,1924,190,31,1,191,134,165,18248,0,0,0,0
cosmic-bar-bgleft,13845,1924,33,31,425,458,1,32,18249,0,0,0,0
cosmic-bar-bgright,13846,1924,32,31,460,492,1,32,18250,0,0,0,0
cosmic-bar-bordercenter,13847,1924,189,32,1,190,100,132,18251,0,0,0,0
cosmic-bar-borderleft,13848,1924,39,32,384,423,1,33,18252,0,0,0,0
cosmic-bar-borderright,13849,1924,38,32,384,422,35,67,18253,0,0,0,0
cosmic-bar-bordertick-flash,13850,1924,46,31,336,382,34,65,18254,0,0,0,0
cosmic-bar-bordertick-full,13851,1924,46,31,336,382,67,98,18255,0,0,0,0
cosmic-bar-bordertick,13852,1924,46,31,336,382,1,32,18256,0,0,0,0
cosmic-bar-fill-white,13853,1924,244,24,192,436,100,124,18257,0,0,0,0
cosmic-bar-spark,13854,1924,7,37,425,432,34,71,18259,0,0,0,0
generic-extrabutton,13855,1930,256,128,0,256,0,128,18295,0,0,6,0
cyphersetupgrade-leftitem-slotinnerglow,13856,1928,128,128,325,453,1,129,18296,0,0,0,0
friendslist-invitebutton-alliance-disabled,13857,869,24,32,1,25,29,61,18297,0,0,0,0
friendslist-invitebutton-alliance-normal,13858,869,24,32,27,51,29,61,18298,0,0,0,0
friendslist-invitebutton-alliance-pressed,13859,869,24,32,53,77,29,61,18299,0,0,0,0
friendslist-invitebutton-default-disabled,13860,869,24,32,79,103,29,61,18300,0,0,0,0
friendslist-invitebutton-default-normal,13861,869,24,32,105,129,29,61,18301,0,0,0,0
friendslist-invitebutton-default-pressed,13862,869,24,32,131,155,29,61,18302,0,0,0,0
friendslist-invitebutton-highlight,13863,869,24,32,157,181,29,61,18303,0,0,0,0
friendslist-invitebutton-horde-disabled,13864,869,24,32,183,207,29,61,18304,0,0,0,0
friendslist-invitebutton-horde-normal,13865,869,24,32,209,233,29,61,18305,0,0,0,0
friendslist-invitebutton-horde-pressed,13866,869,24,32,235,259,29,61,18306,0,0,0,0
professions-icon-quality-tier2,13895,1933,50,50,375,425,56,106,18330,0,0,0,0
professions-icon-quality-tier3,13899,1933,50,50,1362,1412,1,51,18334,0,0,0,0
professions-icon-quality-tier1,13900,1933,50,50,1886,1936,1,51,18335,0,0,0,0
professions-icon-quality-tier1-small,13901,1933,26,26,1835,1861,1,27,18331,0,0,0,0
professions-icon-quality-tier2-small,13902,1933,26,26,1282,1308,1,27,18332,0,0,0,0
professions-icon-quality-tier3-small,13903,1933,26,26,1254,1280,1,27,18333,0,0,0,0
raceicon-visage-female,13904,897,64,64,1237,1301,791,855,18336,0,0,0,0
raceicon-visage-male,13905,897,64,64,1237,1301,857,921,18337,0,0,0,0
raceicon128-visage-female,13906,897,128,128,1171,1299,1,129,18338,0,0,0,0
raceicon128-visage-male,13907,897,128,128,1301,1429,1,129,18339,0,0,0,0
splash-920-botleft,13908,1934,137,371,374,511,587,958,18340,0,0,0,0
splash-920-right,13909,1934,510,584,1,511,1,585,18341,0,0,0,0
splash-920-topleft,13910,1934,371,434,1,372,587,1021,18342,0,0,0,0
splash-9202-botleft,13911,1935,137,371,374,511,587,958,18343,0,0,0,0
splash-9202-topleft,13913,1935,371,434,1,372,587,1021,18345,0,0,0,0
professions-icon-quality-mixed,13914,1933,50,50,1961,2011,1,51,18346,0,0,0,0
professions-icon-quality-tier4,13916,1933,50,50,1174,1224,1,51,18348,0,0,0,0
professions-icon-quality-tier5,13917,1933,50,50,1310,1360,1,51,18349,0,0,0,0
cyphersetupgrade-portrait,13919,1928,64,64,85,149,293,357,18351,0,0,0,0
perks-list-active,13920,1918,520,48,1,521,1207,1255,18183,0,0,0,0
perks-list-hover,13921,1918,520,48,1,521,1257,1305,18186,0,0,0,0
splash-9202-right,13922,1935,510,584,1,511,1,585,18344,0,0,0,0
perks-mount-shadow,13924,1918,729,347,1,730,858,1205,18353,0,0,0,0
perks-char-shadow,13925,1918,280,74,533,813,424,498,18352,0,0,0,0
cosmic-bar-spark-mask,13926,1936,242,37,0,242,0,37,18354,0,0,16,0
common-button-dropdown-closed,14170,1938,22,22,1,23,1,23,18374,0,0,0,0
common-button-dropdown-closedpressed,14171,1938,22,22,25,47,1,23,18375,0,0,0,0
common-button-dropdown-open,14172,1938,22,22,1,23,25,47,18376,0,0,0,0
common-button-dropdown-openpressed,14173,1938,22,22,25,47,25,47,18377,0,0,0,0
cursor_point_128,14174,1937,128,128,1,129,1,129,18378,0,0,0,0
cursor_point_32,14175,1937,32,32,261,293,67,99,18379,0,0,0,0
cursor_point_48,14176,1937,48,48,393,441,1,49,18380,0,0,0,0
cursor_point_64,14177,1937,64,64,261,325,1,65,18381,0,0,0,0
cursor_point_96,14178,1937,96,96,1,97,131,227,18382,0,0,0,0
cursor_unablepoint_128,14179,1937,128,128,131,259,1,129,18383,0,0,0,0
cursor_unablepoint_32,14180,1937,32,32,261,293,101,133,18384,0,0,0,0
cursor_unablepoint_48,14181,1937,48,48,443,491,1,49,18385,0,0,0,0
cursor_unablepoint_64,14182,1937,64,64,327,391,1,65,18386,0,0,0,0
cursor_unablepoint_96,14183,1937,96,96,131,227,131,227,18387,0,0,0,0
reportlist-buttonselect,14184,117,393,46,1,394,145,191,18388,0,0,0,0
communities-icon-faction-alliance,14185,1017,14,16,287,301,481,497,18389,0,0,0,0
communities-icon-faction-horde,14186,1017,14,16,311,325,477,493,18390,0,0,0,0
ui-castingbar-background,14231,1942,209,11,57,266,85,96,18435,0,0,0,0
ui-castingbar-filling-applyingcrafting,14232,1942,209,11,268,477,111,122,18436,0,0,0,0
ui-castingbar-filling-channel,14233,1942,209,11,57,266,124,135,18437,0,0,0,0
ui-castingbar-filling-standard,14234,1942,209,11,268,477,124,135,18438,0,0,0,0
ui-castingbar-frame,14235,1942,214,16,1,215,31,47,18439,0,0,0,0
ui-castingbar-full-applyingcrafting,14236,1942,209,11,57,266,137,148,18440,0,0,0,0
ui-castingbar-full-channel,14237,1942,209,11,268,477,137,148,18441,0,0,0,0
ui-castingbar-full-glow-applyingcrafting,14238,1942,214,16,217,431,31,47,18442,0,0,0,0
ui-castingbar-full-glow-channel,14239,1942,214,16,1,215,49,65,18443,0,0,0,0
ui-castingbar-full-glow-standard,14240,1942,214,16,217,431,49,65,18444,0,0,0,0
ui-castingbar-full-standard,14241,1942,209,11,57,266,150,161,18445,0,0,0,0
ui-castingbar-interrupted,14242,1942,209,11,268,477,176,187,18446,0,0,0,0
ui-castingbar-pip,14243,1942,6,30,1,7,151,181,18447,0,0,0,0
ui-castingbar-shield,14247,1942,54,64,1,55,85,149,18451,0,0,0,0
ui-castingbar-uninterruptable,14248,1942,209,11,268,477,215,226,18452,0,0,0,0
ui-castingbar-background-2x,14249,1943,422,26,1,423,188,214,18435,0,0,0,0
ui-castingbar-filling-applyingcrafting-2x,14250,1943,418,22,421,839,240,262,18436,0,0,0,0
ui-castingbar-filling-channel-2x,14251,1943,418,22,1,419,264,286,18437,0,0,0,0
ui-castingbar-filling-standard-2x,14252,1943,418,22,421,839,264,286,18438,0,0,0,0
ui-castingbar-frame-2x,14253,1943,426,30,422,848,1,31,18439,0,0,0,0
ui-castingbar-full-applyingcrafting-2x,14254,1943,426,30,1,427,60,90,18440,0,0,0,0
ui-castingbar-full-channel-2x,14255,1943,426,30,429,855,60,90,18441,0,0,0,0
ui-castingbar-full-glow-applyingcrafting-2x,14256,1943,426,30,1,427,92,122,18442,0,0,0,0
ui-castingbar-full-glow-channel-2x,14257,1943,426,30,429,855,92,122,18443,0,0,0,0
ui-castingbar-full-glow-standard-2x,14258,1943,426,30,1,427,124,154,18444,0,0,0,0
ui-castingbar-full-standard-2x,14259,1943,424,28,429,853,156,184,18445,0,0,0,0
ui-castingbar-interrupted-2x,14260,1943,418,22,1,419,336,358,18446,0,0,0,0
ui-castingbar-pip-2x,14261,1943,10,60,78,88,408,468,18447,0,0,0,0
ui-castingbar-shield-2x,14265,1943,75,89,1,76,408,497,18451,0,0,0,0
ui-castingbar-uninterruptable-2x,14266,1943,418,22,421,839,384,406,18452,0,0,0,0
ui-castingbar-textbox-2x,14273,1943,419,57,1,420,1,58,18478,0,0,0,0
ui-castingbar-textbox,14274,1942,210,28,1,211,1,29,18478,0,0,0,0
professions-icon-quality-tier5_small,14275,1933,26,26,1146,1172,1,27,18498,0,0,0,0
professions-icon-quality-tier4-small,14276,1933,26,26,1226,1252,1,27,18480,0,0,0,0
perks-owned-small,14283,1918,20,18,967,987,472,490,18192,0,0,0,0
shop-card-full-m64,14286,1947,568,463,1,569,1,464,18487,0,0,0,0
shop-card-full-m68,14288,1948,568,463,1,569,1,464,18488,0,0,0,0
charactercreate-icon-customize-mirror-selected,14289,708,156,158,281,437,1297,1455,18307,0,0,0,0
charactercreate-icon-customize-mirror,14290,708,156,158,281,437,1137,1295,18308,0,0,0,0
gmchat-watermark-blizzard,14291,1949,305,161,1,306,1,162,17904,0,0,0,0
raceicon128-dracthyrvisage-female,14292,897,128,128,261,389,651,779,18489,0,0,0,0
raceicon128-dracthyrvisage-male,14293,897,128,128,261,389,781,909,18490,0,0,0,0
raceicon-dracthyrvisage-female,14296,897,64,64,1765,1829,131,195,18493,0,0,0,0
raceicon-dracthyrvisage-male,14297,897,64,64,1831,1895,131,195,18494,0,0,0,0
creditsscreen-keyart-9,14298,1950,1425,966,1,1426,1,967,18495,0,0,0,0
creditsscreen-background-9,14300,1951,512,512,0,512,0,512,18496,0,0,6,0
worldquest-icon-empoweredraid,14301,743,19,19,489,508,91,110,18497,14,14,0,0
cast_crafting_linetexturemask,14322,1954,512,32,0,512,0,32,18519,0,0,16,0
,14323,1952,846,208,0,0,0,0,18520,0,0,0,0
cast_standard_barmask,14324,1955,420,24,1,421,1,25,18521,0,0,0,0
cast_standard_linetexturemask,14325,1956,420,24,0,420,0,24,18522,0,0,16,0
cast_channel_wispmask,14326,1957,109,76,1,110,1,77,18523,0,0,0,0
splash-925-topleft,14327,1958,371,434,1,372,587,1021,18527,0,0,0,0
splash-925-right,14329,1958,510,584,1,511,1,585,18529,0,0,0,0
splash-9252-topleft,14332,1959,371,434,1,372,587,1021,18532,0,0,0,0
splash-9252-botleft,14333,1959,137,371,374,511,587,958,18530,0,0,0,0
splash-925-botleft,14334,1958,137,371,374,511,587,958,18528,0,0,0,0
editmode-actionbar-highlight-nineslice-corner,14335,1960,16,16,1,17,73,89,18533,0,0,0,0
_editmode-actionbar-highlight-nineslice-edgebottom,14337,1960,16,16,0,16,1,17,18535,0,0,4,0
_editmode-actionbar-highlight-nineslice-edgetop,14338,1960,16,16,0,16,19,35,18536,0,0,4,0
!editmode-actionbar-highlight-nineslice-edgeleft,14343,1963,16,16,1,17,0,16,18541,0,0,2,0
!editmode-actionbar-highlight-nineslice-edgeright,14344,1963,16,16,19,35,0,16,18542,0,0,2,0
cast_channel_pipshadow,14347,1964,22,22,1001,1023,1,23,18545,0,0,0,0
cast_channel_sparkles_01,14348,1964,48,15,813,861,221,236,18546,0,0,0,0
cast_channel_sparkles_02,14349,1964,65,17,813,878,202,219,18547,0,0,0,0
cast_channel_wispglow,14350,1964,104,32,813,917,142,174,18548,0,0,0,0
cast_crafting_pipglow,14351,1964,74,24,919,993,142,166,18549,0,0,0,0
cast_crafting_shinewipe,14352,1964,552,239,1,553,1,240,18550,0,0,0,0
cast_empowered_flakess01,14353,1964,9,13,776,785,181,194,18551,0,0,0,0
cast_empowered_flakess02,14354,1964,18,14,1001,1019,53,67,18552,0,0,0,0
cast_empowered_flakess03,14355,1964,18,21,1001,1019,25,46,18553,0,0,0,0
cast_empowered_outerglow,14356,1964,444,50,555,999,1,51,18554,0,0,0,0
cast_interrupt_outerglow,14358,1964,444,50,555,999,53,103,18556,0,0,0,0
cast_standard_flakes01,14359,1964,219,46,555,774,181,227,18557,0,0,0,0
cast_standard_flakes02,14360,1964,256,74,555,811,105,179,18558,0,0,0,0
cast_standard_flakes03,14361,1964,205,35,813,1018,105,140,18559,0,0,0,0
cast_standard_glowline,14364,1964,483,244,1,484,242,486,18562,0,0,0,0
cast_standard_pipglow,14365,1964,74,24,813,887,176,200,18563,0,0,0,0
channel_wispglow2,14366,1964,42,22,889,931,176,198,18564,0,0,0,0
splash-9252-right,14374,1959,510,584,1,511,1,585,18531,0,0,0,0
minimal-scrollbar-thumb-middle-down,14377,1922,8,715,11,19,1,716,18234,0,0,0,0
minimal-scrollbar-thumb-middle-over,14378,1922,8,715,21,29,1,716,18235,0,0,0,0
minimal-scrollbar-thumb-middle,14379,1922,8,715,31,39,1,716,18218,0,0,0,0
professions-icon-quality-mixed-small,14390,1933,26,26,1807,1833,1,27,18583,0,0,0,0
perks-hold-nineslice-center,14392,1918,1,1,927,928,325,326,18584,0,0,0,0
perks-hold-nineslice-cornertopleft,14395,1918,40,40,843,883,382,422,18587,0,0,0,0
perks-hold-nineslice-cornertopright,14396,1918,40,40,885,925,382,422,18588,0,0,0,0
perks-list-nineslice-center,14397,1918,1,1,927,928,328,329,18589,0,0,0,0
perks-list-nineslice-cornertopleft,14398,1918,68,68,533,601,600,668,18590,0,0,0,0
perks-tooltip-nineslice-cornertopleft,14399,1918,68,68,533,601,670,738,18591,0,0,0,0
_perks-hold-nineslice-edgetop,14400,1918,1,40,0,1,183,223,18592,0,0,4,0
_perks-list-nineslice-edgetop,14401,1918,1,68,0,1,1,69,18593,0,0,4,0
_perks-tooltip-nineslice-edgetop,14402,1918,1,68,0,1,71,139,18594,0,0,4,0
perks-tooltip-nineslice-center,14403,1918,1,1,927,928,331,332,18595,0,0,0,0
!perks-hold-nineslice-edgeleft,14404,1919,40,16,141,181,0,16,18596,0,0,2,0
!perks-list-nineslice-edgeleft,14405,1919,68,16,1,69,0,16,18597,0,0,2,0
!perks-tooltip-nineslice-edgeleft,14406,1919,68,16,71,139,0,16,18598,0,0,2,0
editmode-actionbar-highlight-nineslice-center,14408,1961,16,16,0,16,0,16,18600,0,0,6,0
editmode-actionbar-selected-nineslice-center,14409,1962,16,16,0,16,0,16,18601,0,0,6,0
ui-chaticon-app,14410,1971,32,32,1,33,35,67,18622,0,0,0,0
ui-chaticon-rtro,14411,1971,32,32,103,135,35,67,18603,0,0,0,0
ui-chaticon-vipr,14412,1971,32,32,171,203,1,33,18604,0,0,0,0
ui-chaticon-zeus,14413,1971,32,32,205,237,35,67,18605,0,0,0,0
ui-chaticon-lazr,14414,1971,32,32,69,101,35,67,18606,0,0,0,0
ui-chaticon-callofdutymwicon,14415,1971,32,32,69,101,69,101,18607,0,0,0,0
ui-chaticon-fore,14416,1971,32,32,35,67,35,67,18608,0,0,0,0
ui-chaticon-wlby,14417,1971,32,32,137,169,35,67,18609,0,0,0,0
ui-chaticon-d3,14418,1971,32,32,1,33,69,101,18610,0,0,0,0
ui-chaticon-dst2,14419,1971,32,32,35,67,1,33,18611,0,0,0,0
ui-chaticon-osi,14420,1971,32,32,103,135,1,33,18612,0,0,0,0
ui-chaticon-diabloimmortal,14421,1971,32,32,1,33,1,33,18613,0,0,0,0
ui-chaticon-hero,14422,1971,32,32,69,101,1,33,18614,0,0,0,0
ui-chaticon-s1,14424,1971,32,32,103,135,69,101,18616,0,0,0,0
ui-chaticon-s2,14425,1971,32,32,137,169,1,33,18617,0,0,0,0
ui-chaticon-warcraft3reforged,14426,1971,32,32,205,237,1,33,18618,0,0,0,0
ui-chaticon-gry,14427,1971,32,32,35,67,69,101,18619,0,0,0,0
ui-chaticon-wow,14428,1971,32,32,137,169,69,101,18620,0,0,0,0
ui-chaticon-wtcg,14429,1971,32,32,171,203,35,67,18621,0,0,0,0
battlenet-clienticon-app,14430,1972,32,32,1,33,35,67,18623,0,0,0,0
battlenet-clienticon-rtro,14431,1972,32,32,103,135,35,67,18624,0,0,0,0
battlenet-clienticon-vipr,14432,1972,32,32,171,203,1,33,18625,0,0,0,0
battlenet-clienticon-zeus,14433,1972,32,32,205,237,35,67,18626,0,0,0,0
battlenet-clienticon-lazr,14434,1972,32,32,69,101,35,67,18627,0,0,0,0
battlenet-callofdutymwicon,14435,1972,32,32,69,101,69,101,18628,0,0,0,0
battlenet-callofdutyvanguardicon,14436,1972,32,32,35,67,35,67,18629,0,0,0,0
battlenet-clienticon-wlby,14437,1972,32,32,137,169,35,67,18630,0,0,0,0
battlenet-clienticon-d3,14438,1972,32,32,1,33,69,101,18631,0,0,0,0
battlenet-clienticon-dst2,14439,1972,32,32,35,67,1,33,18632,0,0,0,0
battlenet-clienticon-osi,14440,1972,32,32,103,135,1,33,18633,0,0,0,0
battlenet-diabloimmortalicon,14441,1972,32,32,1,33,1,33,18634,0,0,0,0
battlenet-clienticon-hero,14442,1972,32,32,69,101,1,33,18635,0,0,0,0
battlenet-clienticon-s2,14444,1972,32,32,137,169,1,33,18637,0,0,0,0
battlenet-clienticon-s1,14445,1972,32,32,103,135,69,101,18638,0,0,0,0
battlenet-warcraft3reforged,14446,1972,32,32,205,237,1,33,18639,0,0,0,0
battlenet-clienticon-gry,14447,1972,32,32,35,67,69,101,18640,0,0,0,0
battlenet-clienticon-wow,14448,1972,32,32,137,169,69,101,18641,0,0,0,0
battlenet-clienticon-wtcg,14449,1972,32,32,171,203,35,67,18642,0,0,0,0
cast_standard_lineglow,14451,1964,420,24,486,906,242,266,18643,0,0,0,0
options_categoryheader_1,14453,733,199,144,1,200,1,145,18644,0,0,0,0
options_categoryheader_2,14454,733,199,144,403,602,1,145,18645,0,0,0,0
options_categoryheader_3,14455,733,199,144,202,401,1,145,18646,0,0,0,0
options_horizontaldivider,14456,733,630,1,1,631,767,768,18647,0,0,0,0
options_list_active,14457,733,187,21,604,791,1,22,18648,0,0,0,0
options_list_hover,14458,733,187,21,793,980,1,22,18649,0,0,0,0
options_innerframe,14460,733,886,618,1,887,147,765,18651,0,0,0,0
minimal_sliderbar_button,14461,1973,20,19,1,21,20,39,18652,0,0,0,0
minimal_sliderbar_button_left,14462,1973,11,19,1,12,41,60,18653,0,0,0,0
minimal_sliderbar_button_right,14463,1973,9,18,1,10,81,99,18654,0,0,0,0
minimal_sliderbar_left,14464,1973,11,17,14,25,41,58,18655,0,0,0,0
minimal_sliderbar_right,14465,1973,11,17,1,12,62,79,18656,0,0,0,0
_minimal_sliderbar_middle,14466,1973,1,17,0,1,1,18,18657,0,0,4,0
options_listexpand_left,14474,1974,12,26,1,13,84,110,18661,0,0,0,0
options_listexpand_right,14475,1974,28,26,1,29,56,82,18662,0,0,0,0
options_listexpand_right_expanded,14476,1974,28,26,31,59,56,82,18659,0,0,0,0
_options_listexpand_middle,14477,1974,1,26,0,1,28,54,18660,0,0,4,0
options_tab_active_left,14486,733,7,26,604,611,49,75,18666,0,0,0,0
options_tab_active_right,14488,733,7,26,613,620,24,50,18668,0,0,0,0
options_tab_left,14489,733,7,23,604,611,24,47,18671,0,0,0,0
options_tab_right,14491,733,7,23,604,611,77,100,18673,0,0,0,0
options_tab_active_middle,14492,733,1,26,607,608,102,128,18667,0,0,0,0
options_tab_middle,14493,733,1,23,604,605,102,125,18672,0,0,0,0
common-icon-checkmark-yellow,14617,1563,256,256,259,515,1,257,18688,25,25,0,0
ui-hud-actionbar-frame-divider-borderbottom,14663,1979,12,15,229,241,411,426,19149,0,0,0,0
ui-hud-actionbar-frame-divider-bordertop,14664,1979,12,14,243,255,411,425,19151,0,0,0,0
ui-hud-actionbar-frame-nineslice-cornerbottomleft,14665,1979,17,23,235,252,200,223,18736,0,0,0,0
ui-hud-actionbar-frame-nineslice-cornerbottomright,14666,1979,22,23,229,251,254,277,18737,0,0,0,0
ui-hud-actionbar-frame-nineslice-cornertopleft,14667,1979,17,16,235,252,225,241,18738,0,0,0,0
ui-hud-actionbar-frame-nineslice-cornertopright,14668,1979,22,16,229,251,279,295,18739,0,0,0,0
_ui-hud-actionbar-frame-nineslice-edgebottom,14683,1979,16,23,0,16,50,73,18754,0,0,4,0
_ui-hud-actionbar-frame-nineslice-edgetop,14684,1979,16,16,0,16,75,91,18755,0,0,4,0
!ui-hud-actionbar-frame-divider-bordercenter,14702,1981,12,16,93,105,0,16,19152,0,0,2,0
!ui-hud-actionbar-frame-nineslice-edgeleft,14703,1981,17,16,74,91,0,16,18771,0,0,2,0
!ui-hud-actionbar-frame-nineslice-edgeright,14704,1981,22,16,50,72,0,16,18772,0,0,2,0
checkbox-minimal,14713,1983,30,29,1,31,1,30,18779,0,0,0,0
checkmark-minimal-disabled,14714,1983,30,29,33,63,1,30,18780,0,0,0,0
checkmark-minimal,14715,1983,30,29,1,31,32,61,18781,0,0,0,0
ui-hud-actionbar-frame-background-nineslice-center,14737,1984,4,4,1,5,1,5,18793,0,0,0,0
ui-hud-actionbar-frame-background-nineslice-cornerbottomleft,14738,1979,11,12,229,240,444,456,18794,0,0,0,0
ui-hud-actionbar-frame-background-nineslice-cornerbottomright,14739,1979,11,12,229,240,458,470,18795,0,0,0,0
ui-hud-actionbar-frame-background-nineslice-cornertopleft,14740,1979,11,11,242,253,444,455,18796,0,0,0,0
ui-hud-actionbar-frame-background-nineslice-cornertopright,14741,1979,11,11,242,253,457,468,18797,0,0,0,0
ui-hud-actionbar-gryphon-left,14744,1979,178,167,1,179,136,303,18800,100,94,0,0
ui-hud-actionbar-gryphon-right,14745,1979,178,167,1,179,305,472,18801,100,94,0,0
ui-hud-actionbar-wyvern-left,14748,1979,178,167,1,179,474,641,18804,100,94,0,0
ui-hud-actionbar-wyvern-right,14749,1979,178,167,1,179,643,810,18805,100,94,0,0
_ui-hud-actionbar-frame-background-nineslice-edgebottom,14750,1979,16,12,0,16,109,121,18806,0,0,4,0
_ui-hud-actionbar-frame-background-nineslice-edgetop,14751,1979,16,11,0,16,123,134,18807,0,0,4,0
!ui-hud-actionbar-frame-background-nineslice-edgeleft,14752,1981,11,16,107,118,0,16,18808,0,0,2,0
!ui-hud-actionbar-frame-background-nineslice-edgeright,14753,1981,11,16,120,131,0,16,18809,0,0,2,0
ui-hud-actionbar-frame-divider-borderbottom-2x,14759,1986,24,30,395,419,833,863,19149,0,0,0,0
ui-hud-actionbar-frame-divider-bordertop-2x,14760,1986,24,28,421,445,833,861,19151,0,0,0,0
ui-hud-actionbar-frame-nineslice-cornerbottomleft-2x,14761,1986,34,46,465,499,383,429,18736,0,0,0,0
ui-hud-actionbar-frame-nineslice-cornerbottomright-2x,14762,1986,44,46,465,509,335,381,18737,0,0,0,0
ui-hud-actionbar-frame-nineslice-cornertopleft-2x,14763,1986,34,32,463,497,475,507,18738,0,0,0,0
ui-hud-actionbar-frame-nineslice-cornertopright-2x,14764,1986,44,32,463,507,441,473,18739,0,0,0,0
ui-hud-actionbar-gryphon-left-2x,14767,1986,356,334,1,357,209,543,18800,200,188,0,0
ui-hud-actionbar-gryphon-right-2x,14768,1986,356,334,1,357,545,879,18801,200,188,0,0
ui-hud-actionbar-wyvern-left-2x,14781,1986,356,334,1,357,881,1215,18804,200,188,0,0
ui-hud-actionbar-wyvern-right-2x,14782,1986,356,334,1,357,1217,1551,18805,200,188,0,0
_ui-hud-actionbar-frame-nineslice-edgebottom-2x,14785,1986,32,46,0,32,97,143,18754,0,0,4,0
_ui-hud-actionbar-frame-nineslice-edgetop-2x,14786,1986,32,32,0,32,145,177,18755,0,0,4,0
!ui-hud-actionbar-frame-divider-bordercenter-2x,14793,1987,24,32,179,203,0,32,19152,0,0,2,0
!ui-hud-actionbar-frame-nineslice-edgeleft-2x,14794,1987,34,32,143,177,0,32,18771,0,0,2,0
!ui-hud-actionbar-frame-nineslice-edgeright-2x,14795,1987,44,32,97,141,0,32,18772,0,0,2,0
groupfinder-eye-flipbook-searching,14832,1989,484,352,1,485,313,665,18887,0,0,0,0
ui-hud-minimap-button-down-nineslice-cornerbottomleft,14833,1990,6,8,77,83,498,506,18888,0,0,0,0
ui-hud-minimap-button-down-nineslice-cornerbottomright,14834,1990,8,8,58,66,498,506,18889,0,0,0,0
ui-hud-minimap-button-down-nineslice-cornertopleft,14835,1990,6,6,112,118,498,504,18890,0,0,0,0
ui-hud-minimap-button-down-nineslice-cornertopright,14836,1990,8,6,85,93,498,504,18891,0,0,0,0
ui-hud-minimap-button-down,14837,1990,20,19,441,461,140,159,18892,0,0,0,0
ui-hud-minimap-button-nineslice-cornerbottomleft,14838,1990,6,7,95,101,498,505,18893,0,0,0,0
ui-hud-minimap-button-nineslice-cornerbottomright,14839,1990,7,7,68,75,498,505,18894,0,0,0,0
ui-hud-minimap-button-nineslice-cornertopleft,14840,1990,6,6,120,126,498,504,18895,0,0,0,0
ui-hud-minimap-button-nineslice-cornertopright,14841,1990,7,6,103,110,498,504,18896,0,0,0,0
ui-hud-minimap-button,14842,1990,20,18,491,511,100,118,18897,0,0,0,0
ui-hud-minimap-frame,14843,1990,438,460,1,439,36,496,18898,215,226,0,0
ui-hud-minimap-mail-down,14844,1990,20,15,466,486,120,135,18899,0,0,0,0
ui-hud-minimap-mail-mouseover,14845,1990,20,15,488,508,120,135,18900,0,0,0,0
ui-hud-minimap-mail-up,14846,1990,20,15,463,483,140,155,18901,0,0,0,0
ui-hud-minimap-tracking-down,14847,1990,17,16,479,496,180,196,18902,0,0,0,0
ui-hud-minimap-tracking-mouseover,14848,1990,16,15,441,457,198,213,18903,0,0,0,0
ui-hud-minimap-tracking-up,14849,1990,16,15,459,475,198,213,18904,0,0,0,0
_ui-hud-minimap-button-down-nineslice-edgebottom,14850,1990,16,8,0,16,1,9,18905,0,0,4,0
_ui-hud-minimap-button-down-nineslice-edgetop,14851,1990,16,6,0,16,20,26,18906,0,0,4,0
_ui-hud-minimap-button-nineslice-edgebottom,14852,1990,16,7,0,16,11,18,18907,0,0,4,0
_ui-hud-minimap-button-nineslice-edgetop,14853,1990,16,6,0,16,28,34,18908,0,0,4,0
!ui-hud-minimap-button-down-nineslice-edgeleft,14854,1991,6,16,20,26,0,16,18909,0,0,2,0
!ui-hud-minimap-button-down-nineslice-edgeright,14855,1991,8,16,1,9,0,16,18910,0,0,2,0
!ui-hud-minimap-button-nineslice-edgeleft,14856,1991,6,16,28,34,0,16,18911,0,0,2,0
!ui-hud-minimap-button-nineslice-edgeright,14857,1991,7,16,11,18,0,16,18912,0,0,2,0
ui-hud-minimap-button-nineslice-center,14858,1992,16,16,1,17,1,17,18913,0,0,0,0
ui-hud-minimap-button-down-nineslice-center,14859,1993,16,16,1,17,1,17,18914,0,0,0,0
ui-hud-calendar-1-down,14860,1994,21,19,1,22,1,20,18915,0,0,0,0
ui-hud-calendar-1-mouseover,14861,1994,21,19,24,45,1,20,18916,0,0,0,0
ui-hud-calendar-1-up,14862,1994,21,19,47,68,1,20,18917,0,0,0,0
ui-hud-calendar-10-down,14863,1994,21,19,70,91,1,20,18918,0,0,0,0
ui-hud-calendar-10-mouseover,14864,1994,21,19,93,114,1,20,18919,0,0,0,0
ui-hud-calendar-10-up,14865,1994,21,19,116,137,1,20,18920,0,0,0,0
ui-hud-calendar-11-down,14866,1994,21,19,139,160,1,20,18921,0,0,0,0
ui-hud-calendar-11-mouseover,14867,1994,21,19,162,183,1,20,18922,0,0,0,0
ui-hud-calendar-11-up,14868,1994,21,19,185,206,1,20,18923,0,0,0,0
ui-hud-calendar-12-down,14869,1994,21,19,208,229,1,20,18924,0,0,0,0
ui-hud-calendar-12-mouseover,14870,1994,21,19,231,252,1,20,18925,0,0,0,0
ui-hud-calendar-12-up,14871,1994,21,19,1,22,22,41,18926,0,0,0,0
ui-hud-calendar-13-down,14872,1994,21,19,24,45,22,41,18927,0,0,0,0
ui-hud-calendar-13-mouseover,14873,1994,21,19,47,68,22,41,18928,0,0,0,0
ui-hud-calendar-13-up,14874,1994,21,19,70,91,22,41,18929,0,0,0,0
ui-hud-calendar-14-down,14875,1994,21,19,93,114,22,41,18930,0,0,0,0
ui-hud-calendar-14-mouseover,14876,1994,21,19,116,137,22,41,18931,0,0,0,0
ui-hud-calendar-14-up,14877,1994,21,19,139,160,22,41,18932,0,0,0,0
ui-hud-calendar-15-down,14878,1994,21,19,162,183,22,41,18933,0,0,0,0
ui-hud-calendar-15-mouseover,14879,1994,21,19,185,206,22,41,18934,0,0,0,0
ui-hud-calendar-15-up,14880,1994,21,19,208,229,22,41,18935,0,0,0,0
ui-hud-calendar-16-down,14881,1994,21,19,231,252,22,41,18936,0,0,0,0
ui-hud-calendar-16-mouseover,14882,1994,21,19,1,22,43,62,18937,0,0,0,0
ui-hud-calendar-16-up,14883,1994,21,19,1,22,64,83,18938,0,0,0,0
ui-hud-calendar-17-down,14884,1994,21,19,1,22,85,104,18939,0,0,0,0
ui-hud-calendar-17-mouseover,14885,1994,21,19,1,22,106,125,18940,0,0,0,0
ui-hud-calendar-17-up,14886,1994,21,19,1,22,127,146,18941,0,0,0,0
ui-hud-calendar-18-down,14887,1994,21,19,1,22,148,167,18942,0,0,0,0
ui-hud-calendar-18-mouseover,14888,1994,21,19,1,22,169,188,18943,0,0,0,0
ui-hud-calendar-18-up,14889,1994,21,19,1,22,190,209,18944,0,0,0,0
ui-hud-calendar-19-down,14890,1994,21,19,1,22,211,230,18945,0,0,0,0
ui-hud-calendar-19-mouseover,14891,1994,21,19,1,22,232,251,18946,0,0,0,0
ui-hud-calendar-19-up,14892,1994,21,19,24,45,43,62,18947,0,0,0,0
ui-hud-calendar-2-down,14893,1994,21,19,47,68,43,62,18948,0,0,0,0
ui-hud-calendar-2-mouseover,14894,1994,21,19,70,91,43,62,18949,0,0,0,0
ui-hud-calendar-2-up,14895,1994,21,19,93,114,43,62,18950,0,0,0,0
ui-hud-calendar-20-down,14896,1994,21,19,116,137,43,62,18951,0,0,0,0
ui-hud-calendar-20-mouseover,14897,1994,21,19,139,160,43,62,18952,0,0,0,0
ui-hud-calendar-20-up,14898,1994,21,19,162,183,43,62,18953,0,0,0,0
ui-hud-calendar-21-down,14899,1994,21,19,185,206,43,62,18954,0,0,0,0
ui-hud-calendar-21-mouseover,14900,1994,21,19,208,229,43,62,18955,0,0,0,0
ui-hud-calendar-21-up,14901,1994,21,19,231,252,43,62,18956,0,0,0,0
ui-hud-calendar-22-down,14902,1994,21,19,24,45,64,83,18957,0,0,0,0
ui-hud-calendar-22-mouseover,14903,1994,21,19,24,45,85,104,18958,0,0,0,0
ui-hud-calendar-22-up,14904,1994,21,19,24,45,106,125,18959,0,0,0,0
ui-hud-calendar-23-down,14905,1994,21,19,24,45,127,146,18960,0,0,0,0
ui-hud-calendar-23-mouseover,14906,1994,21,19,24,45,148,167,18961,0,0,0,0
ui-hud-calendar-23-up,14907,1994,21,19,24,45,169,188,18962,0,0,0,0
ui-hud-calendar-24-down,14908,1994,21,19,24,45,190,209,18963,0,0,0,0
ui-hud-calendar-24-mouseover,14909,1994,21,19,24,45,211,230,18964,0,0,0,0
ui-hud-calendar-24-up,14910,1994,21,19,24,45,232,251,18965,0,0,0,0
ui-hud-calendar-25-down,14911,1994,21,19,47,68,64,83,18966,0,0,0,0
ui-hud-calendar-25-mouseover,14912,1994,21,19,70,91,64,83,18967,0,0,0,0
ui-hud-calendar-25-up,14913,1994,21,19,93,114,64,83,18968,0,0,0,0
ui-hud-calendar-26-down,14914,1994,21,19,116,137,64,83,18969,0,0,0,0
ui-hud-calendar-26-mouseover,14915,1994,21,19,139,160,64,83,18970,0,0,0,0
ui-hud-calendar-26-up,14916,1994,21,19,162,183,64,83,18971,0,0,0,0
ui-hud-calendar-27-down,14917,1994,21,19,185,206,64,83,18972,0,0,0,0
ui-hud-calendar-27-mouseover,14918,1994,21,19,208,229,64,83,18973,0,0,0,0
ui-hud-calendar-27-up,14919,1994,21,19,231,252,64,83,18974,0,0,0,0
ui-hud-calendar-28-down,14920,1994,21,19,47,68,85,104,18975,0,0,0,0
ui-hud-calendar-28-mouseover,14921,1994,21,19,47,68,106,125,18976,0,0,0,0
ui-hud-calendar-28-up,14922,1994,21,19,47,68,127,146,18977,0,0,0,0
ui-hud-calendar-29-down,14923,1994,21,19,47,68,148,167,18978,0,0,0,0
ui-hud-calendar-29-mouseover,14924,1994,21,19,47,68,169,188,18979,0,0,0,0
ui-hud-calendar-29-up,14925,1994,21,19,47,68,190,209,18980,0,0,0,0
ui-hud-calendar-3-down,14926,1994,21,19,47,68,211,230,18981,0,0,0,0
ui-hud-calendar-3-mouseover,14927,1994,21,19,47,68,232,251,18982,0,0,0,0
ui-hud-calendar-3-up,14928,1994,21,19,70,91,85,104,18983,0,0,0,0
ui-hud-calendar-30-down,14929,1994,21,19,93,114,85,104,18984,0,0,0,0
ui-hud-calendar-30-mouseover,14930,1994,21,19,116,137,85,104,18985,0,0,0,0
ui-hud-calendar-30-up,14931,1994,21,19,139,160,85,104,18986,0,0,0,0
ui-hud-calendar-31-down,14932,1994,21,19,162,183,85,104,18987,0,0,0,0
ui-hud-calendar-31-mouseover,14933,1994,21,19,185,206,85,104,18988,0,0,0,0
ui-hud-calendar-31-up,14934,1994,21,19,208,229,85,104,18989,0,0,0,0
ui-hud-calendar-4-down,14935,1994,21,19,231,252,85,104,18990,0,0,0,0
ui-hud-calendar-4-mouseover,14936,1994,21,19,70,91,106,125,18991,0,0,0,0
ui-hud-calendar-4-up,14937,1994,21,19,70,91,127,146,18992,0,0,0,0
ui-hud-calendar-5-down,14938,1994,21,19,70,91,148,167,18993,0,0,0,0
ui-hud-calendar-5-mouseover,14939,1994,21,19,70,91,169,188,18994,0,0,0,0
ui-hud-calendar-5-up,14940,1994,21,19,70,91,190,209,18995,0,0,0,0
ui-hud-calendar-6-down,14941,1994,21,19,70,91,211,230,18996,0,0,0,0
ui-hud-calendar-6-mouseover,14942,1994,21,19,70,91,232,251,18997,0,0,0,0
ui-hud-calendar-6-up,14943,1994,21,19,93,114,106,125,18998,0,0,0,0
ui-hud-calendar-7-down,14944,1994,21,19,116,137,106,125,18999,0,0,0,0
ui-hud-calendar-7-mouseover,14945,1994,21,19,139,160,106,125,19000,0,0,0,0
ui-hud-calendar-7-up,14946,1994,21,19,162,183,106,125,19001,0,0,0,0
ui-hud-calendar-8-down,14947,1994,21,19,185,206,106,125,19002,0,0,0,0
ui-hud-calendar-8-mouseover,14948,1994,21,19,208,229,106,125,19003,0,0,0,0
ui-hud-calendar-8-up,14949,1994,21,19,231,252,106,125,19004,0,0,0,0
ui-hud-calendar-9-down,14950,1994,21,19,93,114,127,146,19005,0,0,0,0
ui-hud-calendar-9-mouseover,14951,1994,21,19,93,114,148,167,19006,0,0,0,0
ui-hud-calendar-9-up,14952,1994,21,19,93,114,169,188,19007,0,0,0,0
ui-hud-minimap-button-2x,14953,1995,39,38,441,480,402,440,18897,0,0,0,0
ui-hud-minimap-button-down-2x,14954,1995,39,38,441,480,442,480,18892,0,0,0,0
ui-hud-minimap-button-down-nineslice-cornerbottomleft-2x,14955,1995,12,14,488,500,269,283,18888,0,0,0,0
ui-hud-minimap-button-down-nineslice-cornerbottomright-2x,14956,1995,15,14,488,503,238,252,18889,0,0,0,0
ui-hud-minimap-button-down-nineslice-cornertopleft-2x,14957,1995,12,11,488,500,337,348,18890,0,0,0,0
ui-hud-minimap-button-down-nineslice-cornertopright-2x,14958,1995,15,11,488,503,285,296,18891,0,0,0,0
ui-hud-minimap-button-nineslice-cornerbottomleft-2x,14959,1995,12,13,488,500,298,311,18893,0,0,0,0
ui-hud-minimap-button-nineslice-cornerbottomright-2x,14960,1995,14,13,488,502,254,267,18894,0,0,0,0
ui-hud-minimap-button-nineslice-cornertopleft-2x,14961,1995,12,11,488,500,350,361,18895,0,0,0,0
ui-hud-minimap-button-nineslice-cornertopright-2x,14962,1995,14,11,488,502,324,335,18896,0,0,0,0
ui-hud-minimap-frame-2x,14963,1995,438,460,1,439,58,518,18898,0,0,0,0
ui-hud-minimap-mail-down-2x,14964,1995,39,30,441,480,482,512,18899,0,0,0,0
ui-hud-minimap-mail-mouseover-2x,14965,1995,39,30,1,40,520,550,18900,0,0,0,0
ui-hud-minimap-mail-up-2x,14966,1995,39,30,42,81,520,550,18901,0,0,0,0
ui-hud-minimap-tracking-down-2x,14967,1995,32,30,83,115,520,550,18902,0,0,0,0
ui-hud-minimap-tracking-mouseover-2x,14968,1995,30,28,117,147,520,548,18903,0,0,0,0
ui-hud-minimap-tracking-up-2x,14969,1995,30,28,149,179,520,548,18904,0,0,0,0
_ui-hud-minimap-button-down-nineslice-edgebottom-2x,14970,1995,32,14,0,32,1,15,18905,0,0,4,0
_ui-hud-minimap-button-down-nineslice-edgetop-2x,14971,1995,32,11,0,32,32,43,18906,0,0,4,0
_ui-hud-minimap-button-nineslice-edgebottom-2x,14972,1995,32,13,0,32,17,30,18907,0,0,4,0
_ui-hud-minimap-button-nineslice-edgetop-2x,14973,1995,32,11,0,32,45,56,18908,0,0,4,0
ui-hud-minimap-button-nineslice-center-2x,14974,1996,32,33,1,33,1,34,18913,0,0,0,0
ui-hud-minimap-button-down-nineslice-center-2x,14975,1997,32,33,1,33,1,34,18914,0,0,0,0
!ui-hud-minimap-button-down-nineslice-edgeleft-2x,14976,1998,12,33,34,46,0,33,18909,0,0,2,0
!ui-hud-minimap-button-down-nineslice-edgeright-2x,14977,1998,15,33,1,16,0,33,18910,0,0,2,0
!ui-hud-minimap-button-nineslice-edgeleft-2x,14978,1998,12,33,48,60,0,33,18911,0,0,2,0
!ui-hud-minimap-button-nineslice-edgeright-2x,14979,1998,14,33,18,32,0,33,18912,0,0,2,0
ui-hud-actionbar-flyout-down,14998,1979,19,8,235,254,243,251,19053,0,0,0,0
ui-hud-actionbar-flyout-mouseover,14999,1979,18,7,229,247,483,490,19054,0,0,0,0
ui-hud-actionbar-flyout,15000,1979,18,7,229,247,474,481,19055,0,0,0,0
ui-hud-actionbar-pagedownarrow-down,15001,1979,17,14,234,251,321,335,19056,0,0,0,0
ui-hud-actionbar-pagedownarrow-mouseover,15002,1979,17,14,234,251,337,351,19057,0,0,0,0
ui-hud-actionbar-pagedownarrow-up,15003,1979,17,14,234,251,358,372,19058,0,0,0,0
ui-hud-actionbar-pageuparrow-down,15004,1979,17,14,234,251,390,404,19059,0,0,0,0
ui-hud-actionbar-pageuparrow-mouseover,15005,1979,17,14,181,198,458,472,19060,0,0,0,0
ui-hud-actionbar-pageuparrow-up,15006,1979,17,14,200,217,458,472,19061,0,0,0,0
ui-hud-actionbar-pagedownarrow-down-2x,15010,1986,34,28,463,497,545,573,19056,0,0,0,0
ui-hud-actionbar-pagedownarrow-mouseover-2x,15011,1986,34,28,463,497,575,603,19057,0,0,0,0
ui-hud-actionbar-pagedownarrow-up-2x,15012,1986,34,28,463,497,605,633,19058,0,0,0,0
ui-hud-actionbar-pageuparrow-down-2x,15013,1986,34,28,453,487,679,707,19059,0,0,0,0
ui-hud-actionbar-pageuparrow-mouseover-2x,15014,1986,34,28,453,487,709,737,19060,0,0,0,0
ui-hud-actionbar-pageuparrow-up-2x,15015,1986,34,28,359,393,833,861,19061,0,0,0,0
groupfinder-eye-flipbook-mouseover,15016,1989,516,43,973,1489,313,356,19069,0,0,0,0
groupfinder-eye-flipbook-initial,15017,1989,484,220,487,971,313,533,19070,0,0,0,0
groupfinder-eye-flipbook-poke-initial,15018,1989,484,264,1419,1903,1,265,19071,0,0,0,0
groupfinder-eye-flipbook-poke-loop,15019,1989,484,264,1,485,667,931,19072,0,0,0,0
groupfinder-eye-flipbook-poke-end,15020,1989,484,176,487,971,713,889,19073,0,0,0,0
ui-hud-minimap-frame-mask,15023,1999,256,256,0,256,0,256,19076,0,0,16,0
ui-hud-minimap-frame-mask-2x,15024,2000,512,512,0,512,0,512,19076,0,0,16,0
ui-hud-minimap-zoom-in,15025,1990,17,17,485,502,140,157,19078,0,0,0,0
ui-hud-minimap-zoom-out,15026,1990,17,9,1,18,498,507,19079,0,0,0,0
ui-hud-minimap-zoom-in-2x,15027,1995,34,34,1,35,552,586,19078,0,0,0,0
ui-hud-minimap-zoom-out-2x,15028,1995,34,18,181,215,520,538,19079,0,0,0,0
questbg-skinning,15029,2001,299,407,1,300,1,408,19082,0,0,0,0
questbg-tailoring,15030,2002,299,407,1,300,1,408,19083,0,0,0,0
ui-hud-minimap-arrow-guard,15031,1990,23,18,441,464,120,138,19084,0,0,0,0
ui-hud-minimap-arrow-player,15032,1990,22,22,473,495,68,90,19085,0,0,0,0
ui-hud-minimap-arrow-questtracking,15033,1990,30,30,473,503,36,66,19086,0,0,0,0
ui-hud-minimap-arrow-vignettes,15034,1990,30,30,441,471,68,98,19087,0,0,0,0
ui-hud-minimap-arrow-guard-2x,15035,1995,45,37,441,486,363,400,19084,0,0,0,0
ui-hud-minimap-arrow-player-2x,15036,1995,45,45,441,486,238,283,19085,0,0,0,0
ui-hud-minimap-arrow-questtracking-2x,15037,1995,58,58,441,499,118,176,19086,0,0,0,0
ui-hud-minimap-arrow-vignettes-2x,15038,1995,58,58,441,499,178,236,19087,0,0,0,0
questbg-alchemy,15039,2003,299,407,1,300,1,408,19092,0,0,0,0
questbg-blacksmithing,15040,2004,299,407,1,300,1,408,19093,0,0,0,0
questbg-cooking,15041,2005,299,407,1,300,1,408,19094,0,0,0,0
questbg-enchanting,15042,2006,299,407,1,300,1,408,19095,0,0,0,0
questbg-engineering,15043,2007,299,407,1,300,1,408,19096,0,0,0,0
questbg-fishing,15044,2008,299,407,1,300,1,408,19097,0,0,0,0
questbg-herbalism,15045,2009,299,407,1,300,1,408,19098,0,0,0,0
questbg-inscription,15046,2010,299,407,1,300,1,408,19099,0,0,0,0
questbg-jewelcrafting,15047,2011,299,407,1,300,1,408,19100,0,0,0,0
questbg-leatherworking,15048,2012,299,407,1,300,1,408,19101,0,0,0,0
questbg-mining,15049,2013,299,407,1,300,1,408,19102,0,0,0,0
groupfinder-eye-flipbook-foundfx,15050,1989,930,310,1,931,1,311,19103,0,0,0,0
groupfinder-eye-flipbook-found-initial,15051,1989,484,308,933,1417,1,309,19104,0,0,0,0
groupfinder-eye-flipbook-found-loop,15052,1989,484,176,487,971,535,711,19105,0,0,0,0
ui-hud-actionbar-pagedownarrow-disabled,15053,1979,17,14,234,251,305,319,19106,0,0,0,0
ui-hud-actionbar-pageuparrow-disabled,15054,1979,17,14,234,251,374,388,19107,0,0,0,0
ui-hud-actionbar-pagedownarrow-disabled-2x,15055,1986,34,28,463,497,509,537,19106,0,0,0,0
ui-hud-actionbar-pageuparrow-disabled-2x,15056,1986,34,28,453,487,649,677,19107,0,0,0,0
ui-hud-actionbar-iconframe-slot,15073,1979,64,62,181,245,136,198,19124,45,45,0,0
ui-hud-actionbar-iconframe-slot-2x,15086,1986,128,124,359,487,209,333,19124,0,0,0,0
groupfinder-eye-backglow,15095,1989,82,82,1905,1987,1,83,19146,0,0,0,0
groupfinder-eye-circshine,15096,1989,41,41,1465,1506,267,308,19147,0,0,0,0
groupfinder-eye-frontglow,15097,1989,50,50,1905,1955,85,135,19148,0,0,0,0
charactercreate-icon-customize-speechbubble-selected,15098,708,156,158,281,437,1617,1775,18777,0,0,0,0
charactercreate-icon-customize-speechbubble,15099,708,156,158,281,437,1457,1615,18778,0,0,0,0
charactercreate-customize-playbutton-down,15100,708,76,76,359,435,1959,2035,19153,38,38,0,0
charactercreate-customize-playbutton,15101,708,76,76,281,357,1959,2035,19154,38,38,0,0
charactercreate-customize-speakeroffbutton-down,15102,708,76,76,1625,1701,497,573,19155,38,38,0,0
charactercreate-customize-speakeroffbutton,15103,708,76,76,1547,1623,497,573,19156,38,38,0,0
charactercreate-customize-speakeronbutton-down,15104,708,76,76,1781,1857,497,573,19157,38,38,0,0
charactercreate-customize-speakeronbutton,15105,708,76,76,1703,1779,497,573,19158,38,38,0,0
charactercreate-customize-button-redglow,15106,708,106,102,281,387,1777,1879,19175,53,51,0,0
cursor_campaignquestturnin_128,15157,2021,128,128,131,259,1,129,19224,0,0,0,0
cursor_campaignquestturnin_32,15158,2021,32,32,131,163,363,395,19225,0,0,0,0
cursor_campaignquestturnin_48,15159,2021,48,48,51,99,457,505,19226,0,0,0,0
cursor_campaignquestturnin_64,15160,2021,64,64,295,359,131,195,19227,0,0,0,0
cursor_campaignquestturnin_96,15161,2021,96,96,1,97,261,357,19228,0,0,0,0
cursor_campaignquest_128,15162,2021,128,128,1,129,1,129,19229,0,0,0,0
cursor_campaignquest_32,15163,2021,32,32,131,163,329,361,19230,0,0,0,0
cursor_campaignquest_48,15164,2021,48,48,1,49,457,505,19231,0,0,0,0
cursor_campaignquest_64,15165,2021,64,64,229,293,131,195,19232,0,0,0,0
cursor_campaignquest_96,15166,2021,96,96,391,487,1,97,19233,0,0,0,0
cursor_unablecampaignquestturnin_128,15167,2021,128,128,1,129,131,259,19234,0,0,0,0
cursor_unablecampaignquestturnin_32,15168,2021,32,32,131,163,431,463,19235,0,0,0,0
cursor_unablecampaignquestturnin_48,15169,2021,48,48,131,179,279,327,19236,0,0,0,0
cursor_unablecampaignquestturnin_64,15170,2021,64,64,427,491,131,195,19237,0,0,0,0
cursor_unablecampaignquestturnin_96,15171,2021,96,96,131,227,131,227,19238,0,0,0,0
cursor_unablecampaignquest_128,15172,2021,128,128,261,389,1,129,19239,0,0,0,0
cursor_unablecampaignquest_32,15173,2021,32,32,131,163,397,429,19240,0,0,0,0
cursor_unablecampaignquest_48,15174,2021,48,48,131,179,229,277,19241,0,0,0,0
cursor_unablecampaignquest_64,15175,2021,64,64,361,425,131,195,19242,0,0,0,0
cursor_unablecampaignquest_96,15176,2021,96,96,1,97,359,455,19243,0,0,0,0
professions-qualitybar-bg,15177,1933,185,25,1772,1957,56,81,19244,0,0,0,0
professions-qualitybar-frame,15178,1933,193,36,29,222,786,822,19245,0,0,0,0
professions-qualitybar-marker,15179,1933,26,37,1370,1396,56,93,19246,0,0,0,0
professions-slot-bg,15182,1933,43,43,29,72,824,867,19249,0,0,0,0
professions-slot-frame,15183,1933,40,40,29,69,953,993,19250,0,0,0,0
professions-slot-plus-over,15184,1933,15,16,1835,1850,29,45,19251,0,0,0,0
professions-qualitypane-bg-bottom,15185,1933,260,99,271,531,350,449,19252,0,0,0,0
professions-qualitypane-divider,15188,1933,202,1,1772,1974,107,108,19255,0,0,0,0
professions-slot-plus,15189,1933,15,16,1938,1953,22,38,19256,0,0,0,0
actionbar_proc_internalmask,15190,2020,60,60,1,61,1,61,19219,0,0,0,0
perks-item-background,15215,1918,530,631,1,531,225,856,19289,0,0,0,0
spec-dividerline,15219,2026,254,2,1,255,1921,1923,19293,0,0,0,0
spec-role-dps,15220,2026,29,29,325,354,1779,1808,19294,0,0,0,0
spec-role-heal,15221,2026,29,29,356,385,1779,1808,19295,0,0,0,0
spec-role-tank,15222,2026,29,29,325,354,1810,1839,19296,0,0,0,0
spec-sampleabilityring,15223,2026,62,60,325,387,1717,1777,19297,0,0,0,0
spec-selected-background1,15224,2026,395,856,1,396,859,1715,19298,0,0,0,0
spec-selected-background2,15225,2026,395,856,398,793,859,1715,19299,0,0,0,0
spec-selected-background3,15226,2026,395,856,795,1190,859,1715,19300,0,0,0,0
spec-selected-background4,15227,2026,395,856,1192,1587,859,1715,19301,0,0,0,0
spec-selected-background5,15228,2026,395,856,1589,1984,859,1715,19302,0,0,0,0
spec-thumbnailborder-off,15229,2026,322,202,1,323,1717,1919,19303,0,0,0,0
spec-thumbnailborder-on,15230,2026,322,202,398,720,1717,1919,19304,0,0,0,0
spec-thumbnail-deathknight-blood,15231,2027,306,186,1,307,1,187,19305,0,0,0,0
spec-thumbnail-deathknight-frost,15232,2027,306,186,309,615,1,187,19306,0,0,0,0
spec-thumbnail-deathknight-unholy,15233,2027,306,186,617,923,1,187,19307,0,0,0,0
spec-thumbnail-demonhunter-havoc,15234,2027,306,186,925,1231,1,187,19308,0,0,0,0
spec-thumbnail-demonhunter-vengeance,15235,2027,306,186,1233,1539,1,187,19309,0,0,0,0
spec-thumbnail-druid-balance,15236,2027,306,186,1541,1847,1,187,19310,0,0,0,0
spec-thumbnail-druid-feral,15237,2027,306,186,1,307,189,375,19311,0,0,0,0
spec-thumbnail-druid-guardian,15238,2027,306,186,309,615,189,375,19312,0,0,0,0
spec-thumbnail-druid-restoration,15239,2027,306,186,617,923,189,375,19313,0,0,0,0
spec-thumbnail-evoker-devastation,15240,2027,306,186,925,1231,189,375,19314,0,0,0,0
spec-thumbnail-hunter-beastmastery,15242,2027,306,186,1541,1847,189,375,19316,0,0,0,0
spec-thumbnail-hunter-marksmanship,15243,2027,306,186,1,307,377,563,19317,0,0,0,0
spec-thumbnail-hunter-survival,15244,2027,306,186,309,615,377,563,19318,0,0,0,0
spec-thumbnail-mage-arcane,15245,2027,306,186,617,923,377,563,19319,0,0,0,0
spec-thumbnail-mage-fire,15246,2027,306,186,925,1231,377,563,19320,0,0,0,0
spec-thumbnail-mage-frost,15247,2027,306,186,1233,1539,377,563,19321,0,0,0,0
spec-thumbnail-monk-brewmaster,15248,2027,306,186,1541,1847,377,563,19322,0,0,0,0
spec-thumbnail-monk-mistweaver,15249,2027,306,186,1,307,565,751,19323,0,0,0,0
spec-thumbnail-monk-windwalker,15250,2027,306,186,309,615,565,751,19324,0,0,0,0
spec-thumbnail-paladin-holy,15251,2027,306,186,617,923,565,751,19325,0,0,0,0
spec-thumbnail-paladin-protection,15252,2027,306,186,925,1231,565,751,19326,0,0,0,0
spec-thumbnail-paladin-retribution,15253,2027,306,186,1233,1539,565,751,19327,0,0,0,0
spec-thumbnail-priest-discipline,15254,2027,306,186,1541,1847,565,751,19328,0,0,0,0
spec-thumbnail-priest-holy,15255,2027,306,186,1,307,753,939,19329,0,0,0,0
spec-thumbnail-priest-shadow,15256,2027,306,186,309,615,753,939,19330,0,0,0,0
spec-thumbnail-rogue-assassination,15257,2027,306,186,617,923,753,939,19331,0,0,0,0
spec-thumbnail-rogue-outlaw,15258,2027,306,186,925,1231,753,939,19332,0,0,0,0
spec-thumbnail-rogue-subtlety,15259,2027,306,186,1233,1539,753,939,19333,0,0,0,0
spec-thumbnail-shaman-elemental,15260,2027,306,186,1541,1847,753,939,19334,0,0,0,0
spec-thumbnail-shaman-enhancement,15261,2027,306,186,1,307,941,1127,19335,0,0,0,0
spec-thumbnail-shaman-restoration,15262,2027,306,186,1,307,1129,1315,19336,0,0,0,0
spec-thumbnail-warlock-affliction,15263,2027,306,186,1,307,1317,1503,19337,0,0,0,0
spec-thumbnail-warlock-demonology,15264,2027,306,186,1,307,1505,1691,19338,0,0,0,0
spec-thumbnail-warlock-destruction,15265,2027,306,186,1,307,1693,1879,19339,0,0,0,0
spec-thumbnail-warrior-arms,15266,2027,306,186,309,615,941,1127,19340,0,0,0,0
spec-thumbnail-warrior-fury,15267,2027,306,186,617,923,941,1127,19341,0,0,0,0
spec-thumbnail-warrior-protection,15268,2027,306,186,925,1231,941,1127,19342,0,0,0,0
spec-columndivider,15269,2026,7,856,2012,2019,1,857,19343,0,0,0,0
professions-qualitypane-bg-middle,15360,1933,260,1,1772,2032,104,105,19253,0,0,0,0
professions-skillbar-bg,15729,1933,451,29,1098,1549,110,139,19247,0,0,0,0
professions-skillbar-frame,15730,1933,451,29,645,1096,110,139,19248,0,0,0,0
professions-skillbar-mask,15731,2029,512,512,0,512,0,512,19723,0,0,16,0
professionsshadow-threeslice-center,15732,1933,4,18,1161,1165,29,47,19724,0,0,0,0
professionsshadow-threeslice-edgeleft,15733,1933,54,18,427,481,83,101,19725,0,0,0,0
professionsshadow-threeslice-edgeright,15734,1933,53,18,483,536,83,101,19726,0,0,0,0
professions_qualitybar_outerglow,15735,1933,217,58,354,571,631,689,19727,0,0,0,0
ui-hud-actionbar-iconframe-addrow,15801,1979,51,51,181,232,305,356,19737,0,0,0,0
ui-hud-actionbar-iconframe-down,15802,1979,46,45,181,227,521,566,19738,0,0,0,0
ui-hud-actionbar-iconframe-flash,15803,1979,46,45,181,227,568,613,19739,0,0,0,0
ui-hud-actionbar-iconframe-flyoutbordershadow,15804,1979,52,52,181,233,200,252,19740,0,0,0,0
ui-hud-actionbar-iconframe-mouseover,15805,1979,46,45,181,227,643,688,19741,0,0,0,0
ui-hud-actionbar-iconframe,15806,1979,46,45,181,227,254,299,19742,0,0,0,0
ui-hud-actionbar-iconframe-2x,15807,1986,92,90,359,451,649,739,19742,0,0,0,0
ui-hud-actionbar-iconframe-addrow-2x,15808,1986,102,102,359,461,441,543,19737,0,0,0,0
ui-hud-actionbar-iconframe-down-2x,15809,1986,92,90,359,451,881,971,19738,0,0,0,0
ui-hud-actionbar-iconframe-flash-2x,15810,1986,92,90,359,451,973,1063,19739,0,0,0,0
ui-hud-actionbar-iconframe-flyoutbordershadow-2x,15811,1986,104,104,359,463,335,439,19740,0,0,0,0
ui-hud-actionbar-iconframe-mouseover-2x,15812,1986,92,90,359,451,1065,1155,19741,0,0,0,0
cursor_item_128,15813,2030,128,128,1,129,1,129,19749,0,0,0,0
cursor_item_32,15814,2030,32,32,67,99,131,163,19750,0,0,0,0
cursor_item_48,15815,2030,48,48,1,49,197,245,19751,0,0,0,0
cursor_item_64,15816,2030,64,64,1,65,131,195,19752,0,0,0,0
cursor_item_96,15817,2030,96,96,131,227,1,97,19753,0,0,0,0
vignetteloot-locked,15819,647,32,32,989,1021,579,611,19755,24,24,0,0
vignettelootelite-locked,15820,647,32,32,581,613,647,679,19756,0,0,0,0
ui-hud-actionbar-iconframe-mask,15848,2032,64,64,0,64,0,64,19759,0,0,16,0
ui-hud-actionbar-iconframe-border,15850,1979,46,45,181,227,474,519,19761,0,0,0,0
ui-hud-actionbar-iconframe-border-2x,15851,1986,92,90,359,451,741,831,19761,0,0,0,0
ui-hud-actionbar-iconframe-flyoutbutton,15854,1979,47,29,181,228,690,719,19764,0,0,0,0
ui-hud-actionbar-iconframe-flyoutbutton-2x,15857,1986,94,58,359,453,1157,1215,19764,0,0,0,0
_ui-hud-actionbar-iconframe-flyoutmidleft-2x,15862,1986,64,94,0,64,1,95,19771,0,0,4,0
!ui-hud-actionbar-iconframe-flyoutmid-2x,15863,1987,94,64,1,95,0,64,19770,0,0,2,0
groupfinder-eye-frame,15864,1989,52,52,1989,2041,1,53,19774,0,0,0,0
professions-recipe-divider,15908,1933,1,326,271,272,553,879,19818,0,0,0,0
groupfinder-eye-single,15909,1989,44,44,1419,1463,267,311,19819,0,0,0,0
talents-background-deathknight-blood,15910,2035,1612,774,1,1613,1,775,19820,0,0,0,0
talents-background-deathknight-frost,15911,2035,1612,774,1,1613,777,1551,19821,0,0,0,0
talents-background-deathknight-unholy,15914,2036,1612,774,1,1613,1,775,19822,0,0,0,0
talents-background-demonhunter-havoc,15950,2037,1612,774,1,1613,1,775,19823,0,0,0,0
talents-background-demonhunter-vengeance,15951,2037,1612,774,1,1613,777,1551,19824,0,0,0,0
talents-background-druid-balance,15952,2038,1612,774,1,1613,1,775,19825,0,0,0,0
talents-background-druid-feral,15953,2038,1612,774,1,1613,777,1551,19826,0,0,0,0
talents-background-druid-guardian,15954,2039,1612,774,1,1613,1,775,19827,0,0,0,0
talents-background-druid-restoration,15955,2039,1612,774,1,1613,777,1551,19828,0,0,0,0
talents-background-evoker-devastation,15956,2040,1612,774,1,1613,1,775,19829,0,0,0,0
talents-background-evoker-preservation,15957,2040,1612,774,1,1613,777,1551,19830,0,0,0,0
talents-background-hunter-beastmastery,15958,2041,1612,774,1,1613,1,775,19831,0,0,0,0
talents-background-hunter-marksmanship,15959,2041,1612,774,1,1613,777,1551,19832,0,0,0,0
talents-background-hunter-survival,15960,2042,1612,774,1,1613,1,775,19833,0,0,0,0
talents-background-mage-arcane,15961,2043,1612,774,1,1613,1,775,19834,0,0,0,0
talents-background-mage-fire,15962,2043,1612,774,1,1613,777,1551,19835,0,0,0,0
talents-background-mage-frost,15963,2044,1612,774,1,1613,1,775,19836,0,0,0,0
talents-background-monk-brewmaster,15964,2045,1612,774,1,1613,1,775,19837,0,0,0,0
talents-background-monk-mistweaver,15965,2045,1612,774,1,1613,777,1551,19838,0,0,0,0
talents-background-monk-windwalker,15966,2046,1612,774,1,1613,1,775,19839,0,0,0,0
talents-background-paladin-holy,15967,2047,1612,774,1,1613,1,775,19840,0,0,0,0
talents-background-paladin-protection,15968,2047,1612,774,1,1613,777,1551,19841,0,0,0,0
talents-background-paladin-retribution,15969,2048,1612,774,1,1613,1,775,19842,0,0,0,0
talents-background-priest-discipline,15970,2049,1612,774,1,1613,1,775,19843,0,0,0,0
talents-background-priest-holy,15971,2049,1612,774,1,1613,777,1551,19844,0,0,0,0
talents-background-priest-shadow,15972,2050,1612,774,1,1613,1,775,19845,0,0,0,0
talents-background-rogue-assassination,15973,2051,1612,774,1,1613,1,775,19846,0,0,0,0
talents-background-rogue-outlaw,15974,2051,1612,774,1,1613,777,1551,19847,0,0,0,0
talents-background-rogue-subtlety,15975,2052,1612,774,1,1613,1,775,19848,0,0,0,0
talents-background-shaman-elemental,15976,2053,1612,774,1,1613,1,775,19849,0,0,0,0
talents-background-shaman-enhancement,15977,2053,1612,774,1,1613,777,1551,19850,0,0,0,0
talents-background-shaman-restoration,15978,2054,1612,774,1,1613,1,775,19851,0,0,0,0
talents-background-warlock-affliction,16011,2055,1612,774,1,1613,1,775,19852,0,0,0,0
talents-background-warlock-demonology,16012,2055,1612,774,1,1613,777,1551,19853,0,0,0,0
talents-background-warlock-destruction,16017,2056,1612,774,1,1613,1,775,19854,0,0,0,0
talents-background-warrior-arms,16018,2057,1612,774,1,1613,1,775,19855,0,0,0,0
talents-background-warrior-fury,16019,2057,1612,774,1,1613,777,1551,19856,0,0,0,0
talents-background-warrior-protection,16020,2058,1612,774,1,1613,1,775,19857,0,0,0,0
talents-background-bottombar,16021,1970,1612,82,1,1613,1,83,19858,0,0,0,0
talents-button-reset,16022,1970,40,40,1938,1978,115,155,19859,20,20,0,0
talents-button-undo,16023,1970,42,40,1894,1936,115,155,19860,21,20,0,0
talents-gate,16024,1970,168,28,1,169,989,1017,19861,84,14,0,0
talents-node-choice-gray,16025,1970,116,104,759,875,431,535,19862,58,52,0,0
talents-node-choice-green,16026,1970,116,104,759,875,537,641,19863,58,52,0,0
talents-node-choice-locked,16027,1970,116,104,759,875,643,747,19864,58,52,0,0
talents-node-choice-shadow,16028,1970,76,76,1452,1528,85,161,19865,0,0,0,0
talents-node-choice-yellow,16029,1970,116,104,759,875,855,959,19866,58,52,0,0
talents-node-circle-gray,16030,1970,50,50,219,269,569,619,19867,40,40,0,0
talents-node-circle-green,16031,1970,50,50,219,269,621,671,19868,40,40,0,0
talents-node-circle-locked,16032,1970,50,50,219,269,673,723,19869,40,40,0,0
talents-node-circle-shadow,16033,1970,76,76,1530,1606,85,161,19870,0,0,0,0
talents-node-circle-yellow,16034,1970,50,50,1842,1892,115,165,19871,40,40,0,0
talents-node-pvp-filled,16035,1970,116,104,887,1003,175,279,19872,58,52,0,0
talents-node-pvp-green,16036,1970,116,104,887,1003,281,385,19873,58,52,0,0
talents-node-pvp-locked,16037,1970,116,104,887,1003,599,703,19874,58,52,0,0
talents-node-pvp-shadow,16038,1970,78,77,1372,1450,85,162,19875,0,0,0,0
talents-node-square-gray,16039,1970,80,80,1872,1952,1,81,19876,40,40,0,0
talents-node-square-green,16040,1970,80,80,1954,2034,1,81,19877,40,40,0,0
talents-node-square-locked,16041,1970,80,80,191,271,787,867,19878,40,40,0,0
talents-node-square-shadow,16042,1970,78,78,1292,1370,85,163,19879,0,0,0,0
talents-node-square-yellow,16043,1970,80,80,1210,1290,85,165,19880,40,40,0,0
talents-warmode-indent,16044,1970,97,87,1111,1208,85,172,19881,0,0,0,0
talents-warmode-ring-disabled,16045,1970,188,200,279,467,175,375,19882,94,100,0,0
talents-warmode-ring,16046,1970,188,200,1,189,787,987,19883,94,100,0,0
professions-slot-frame-blue,16047,1933,40,40,29,69,911,951,19884,0,0,0,0
professions-slot-frame-epic,16048,1933,40,40,29,69,869,909,19885,0,0,0,0
professions-slot-frame-green,16049,1933,40,40,1551,1591,110,150,19886,0,0,0,0
professions-slot-frame-legendary,16050,1933,40,40,580,620,56,96,19887,0,0,0,0
ui-hud-unitframe-player-portraitoff-bar-health,16105,2060,126,23,690,816,160,183,19913,0,0,0,0
ui-hud-unitframe-player-portraitoff-bar-mana,16106,2060,126,12,332,458,235,247,19914,0,0,0,0
ui-hud-unitframe-player-portraitoff,16107,2060,133,51,195,328,160,211,19915,0,0,0,0
ui-hud-unitframe-player-portraiton-bar-health,16108,2060,124,20,705,829,213,233,19916,0,0,0,0
ui-hud-unitframe-player-portraiton-bar-mana,16109,2060,124,10,647,771,301,311,19917,0,0,0,0
ui-hud-unitframe-player-portraiton,16110,2060,198,71,1,199,87,158,19918,0,0,0,0
ui-hud-unitframe-target-portraiton-bar-health,16111,2060,126,20,195,321,213,233,19919,0,0,0,0
ui-hud-unitframe-target-portraiton-bar-mana,16112,2060,134,10,525,659,255,265,19920,0,0,0,0
ui-hud-unitframe-target-portraiton,16118,2060,192,67,1,193,229,296,19926,0,0,0,0
ui-hud-unitframe-targetoftarget-portraiton-bar-health,16119,2060,70,10,950,1020,160,170,19927,0,0,0,0
ui-hud-unitframe-targetoftarget-portraiton-bar-mana,16120,2060,74,7,389,463,267,274,19928,0,0,0,0
ui-hud-unitframe-targetoftarget-portraiton,16121,2060,120,49,330,450,160,209,19929,0,0,0,0
talents-arrow-head-gray,16122,1970,28,24,417,445,887,911,19930,14,12,0,0
talents-arrow-head-locked,16123,1970,28,24,417,445,913,937,19931,14,12,0,0
talents-arrow-head-yellow,16124,1970,28,24,417,445,965,989,19932,14,12,0,0
talents-node-circle-mask,16128,2061,64,64,0,64,0,64,19936,0,0,16,0
talents-node-choice-mask,16129,2062,64,64,0,64,0,64,19937,0,0,16,0
spec-thumbnail-evoker-preservation,16130,2027,306,186,1233,1539,189,375,19938,0,0,0,0
perks-backarrow,16131,1918,16,26,905,921,472,498,18159,0,0,0,0
campaign_azurespan,16135,2063,608,138,611,1219,1,139,19942,0,0,0,2
campaign_dracthyrawaken,16136,2063,608,138,1221,1829,1,139,19943,0,0,0,2
campaign_dragonflight,16137,2063,608,138,1,609,141,279,19944,0,0,0,2
campaign_ohnplains,16138,2063,608,138,611,1219,141,279,19945,0,0,0,2
campaign_thaldraszus,16139,2063,608,138,1221,1829,141,279,19946,0,0,0,2
campaign_walkingshore,16140,2063,608,138,611,1219,281,419,19947,0,0,0,2
talents-node-choice-greenglow,16141,1970,176,168,279,455,377,545,19948,88,84,0,0
talents-node-circle-greenglow,16142,1970,82,82,1788,1870,1,83,19949,0,0,0,0
talents-node-square-greenglow,16143,1970,168,168,279,447,717,885,19950,84,84,0,0
questbg-walkingshore,16144,2064,299,407,1,300,1,408,19951,0,0,0,0
questbg-ohnplains,16145,2065,299,407,1,300,1,408,19952,0,0,0,0
questbg-azurespan,16146,2066,299,407,1,300,1,408,19953,0,0,0,0
questbg-dracthyrawaken,16147,2067,299,407,1,300,1,408,19954,0,0,0,0
questbg-thaldraszus,16148,2068,299,407,1,300,1,408,19955,0,0,0,0
questbg-dragonflight,16149,2069,299,407,1,300,1,408,19956,0,0,0,0
dragonriding-barbershop-icon-drake,16150,2070,128,128,317,445,1,129,19957,0,0,0,0
dragonriding-barbershop-icon-protodrake,16151,2070,128,128,447,575,1,129,19958,0,0,0,0
dragonriding-barbershop-icon-pterrodax,16152,2070,128,128,447,575,131,259,19959,0,0,0,0
dragonriding-barbershop-icon-wyvernspirit,16153,2070,128,128,577,705,1,129,19960,0,0,0,0
talents-arrow-line-gray,16255,2071,16,16,0,16,19,35,19933,8,8,4,0
talents-arrow-line-locked,16256,2071,16,16,0,16,37,53,19934,8,8,4,0
talents-arrow-line-yellow,16257,2071,16,16,0,16,55,71,19935,8,8,4,0
uf-essence-bg-active,16258,2034,24,24,294,318,224,248,19775,0,0,0,0
uf-essence-bg,16259,2034,24,24,324,348,107,131,19776,0,0,0,0
uf-essence-flipbook-deplete,16260,2034,156,57,348,504,1,58,19889,0,0,0,0
uf-essence-flipbook-fill-a,16261,2034,246,140,1,247,107,247,19890,0,0,0,0
uf-essence-flipbook-fx-circ,16262,2034,345,104,1,346,1,105,19888,0,0,0,0
uf-essence-fx-burst,16263,2034,43,47,249,292,107,154,19910,0,0,0,0
uf-essence-fx-depletedbg,16264,2034,26,26,294,320,196,222,19779,0,0,0,0
uf-essence-fx-depsmoke,16265,2034,14,26,350,364,211,237,19911,0,0,0,0
uf-essence-fx-rimglw,16266,2034,24,24,324,348,133,157,19792,0,0,0,0
uf-essence-fx-rimglwdep,16267,2034,24,24,324,348,159,183,19891,0,0,0,0
uf-essence-fx-rimshine,16268,2034,18,18,324,342,237,255,19793,0,0,0,0
uf-essence-icon-active,16269,2034,24,24,324,348,185,209,19892,0,0,0,0
uf-essence-icon-dep,16270,2034,28,28,450,478,60,88,19972,0,0,0,0
uf-essence-icon-glw,16271,2034,24,24,324,348,211,235,19798,0,0,0,0
uf-essence-icon-prog,16272,2034,24,24,350,374,107,131,19799,0,0,0,0
uf-essence-icon-progb,16273,2034,28,28,480,508,60,88,19973,0,0,0,0
uf-essence-icon-progc,16274,2034,28,28,249,277,156,184,19974,0,0,0,0
uf-essence-icon-progd,16275,2034,28,28,249,277,186,214,19975,0,0,0,0
uf-essence-icon,16276,2034,24,24,350,374,133,157,19805,0,0,0,0
uf-essence-spin-outbg,16277,2034,28,28,249,277,216,244,19976,0,0,0,0
uf-essence-spin-star1,16278,2034,32,32,348,380,60,92,19977,0,0,0,0
uf-essence-spin-star2,16279,2034,32,32,382,414,60,92,19978,0,0,0,0
uf-essence-spin-stars,16280,2034,32,32,416,448,60,92,19979,0,0,0,0
uf-essence-spinner,16281,2034,24,24,350,374,159,183,19811,0,0,0,0
uf-essence-spinnerin,16282,2034,26,27,294,320,167,194,19812,0,0,0,0
uf-essence-spinnerout,16283,2034,28,28,294,322,107,135,19980,0,0,0,0
uf-essence-timerspin-trail,16284,2034,28,28,294,322,137,165,19981,0,0,0,0
uf-essence-timerspin,16285,2034,24,24,350,374,185,209,19912,0,0,0,0
uf-essence-bg-2x,16286,2059,48,48,582,630,380,428,19776,0,0,0,0
uf-essence-bg-active-2x,16287,2059,48,48,582,630,430,478,19775,0,0,0,0
uf-essence-flipbook-deplete-2x,16288,2059,312,114,693,1005,1,115,19889,0,0,0,0
uf-essence-flipbook-fill-a-2x,16289,2059,492,280,1,493,210,490,19890,0,0,0,0
uf-essence-flipbook-fx-circ-2x,16290,2059,690,207,1,691,1,208,19888,0,0,0,0
uf-essence-fx-burst-2x,16291,2059,85,93,495,580,210,303,19910,0,0,0,0
uf-essence-fx-depletedbg-2x,16292,2059,52,52,582,634,326,378,19779,0,0,0,0
uf-essence-fx-depsmoke-2x,16293,2059,28,52,690,718,310,362,19911,0,0,0,0
uf-essence-fx-rimglw-2x,16294,2059,48,48,640,688,210,258,19792,0,0,0,0
uf-essence-fx-rimglwdep-2x,16295,2059,48,48,640,688,260,308,19891,0,0,0,0
uf-essence-fx-rimshine-2x,16296,2059,35,35,690,725,364,399,19793,0,0,0,0
uf-essence-icon-2x,16297,2059,48,48,640,688,310,358,19805,0,0,0,0
uf-essence-icon-active-2x,16298,2059,48,48,640,688,360,408,19892,0,0,0,0
uf-essence-icon-dep-2x,16299,2059,56,56,891,947,117,173,19972,0,0,0,0
uf-essence-icon-glw-2x,16300,2059,48,48,640,688,410,458,19798,0,0,0,0
uf-essence-icon-prog-2x,16301,2059,48,48,640,688,460,508,19799,0,0,0,0
uf-essence-icon-progb-2x,16302,2059,56,56,949,1005,117,173,19973,0,0,0,0
uf-essence-icon-progc-2x,16303,2059,56,56,495,551,305,361,19974,0,0,0,0
uf-essence-icon-progd-2x,16304,2059,56,56,495,551,363,419,19975,0,0,0,0
uf-essence-spin-outbg-2x,16305,2059,56,56,495,551,421,477,19976,0,0,0,0
uf-essence-spin-star1-2x,16306,2059,64,64,693,757,117,181,19977,0,0,0,0
uf-essence-spin-star2-2x,16307,2059,64,64,759,823,117,181,19978,0,0,0,0
uf-essence-spin-stars-2x,16308,2059,64,64,825,889,117,181,19979,0,0,0,0
uf-essence-spinner-2x,16309,2059,48,48,690,738,210,258,19811,0,0,0,0
uf-essence-spinnerout-2x,16310,2059,56,56,582,638,210,266,19980,0,0,0,0
uf-essence-timerspin-2x,16311,2059,48,48,690,738,260,308,19912,0,0,0,0
uf-essence-timerspin-trail-2x,16312,2059,56,56,582,638,268,324,19981,0,0,0,0
talents-node-choiceflyout-mask,16362,2072,64,64,0,64,0,64,20041,0,0,16,0
talents-pvpflyout-background-bottom,16363,1970,276,36,833,1109,85,121,20042,0,0,0,0
talents-pvpflyout-background-middle,16364,1970,276,482,1,277,85,567,20043,0,0,0,0
talents-pvpflyout-background-top,16365,1970,276,29,833,1109,123,152,20044,0,0,0,0
talents-pvpflyout-rowhighlight,16366,1970,552,88,279,831,85,173,20045,276,44,0,0
talents-node-pvpflyout-green,16367,1970,76,76,1608,1684,85,161,20046,38,38,0,0
talents-node-pvpflyout-yellow,16368,1970,76,76,1686,1762,85,161,20047,38,38,0,0
talents-node-pvpflyout-yellow-dimmed,16369,1970,76,76,1764,1840,85,161,20048,38,38,0,0
ui-hud-minimap-arrow-corpse,16370,1990,30,30,441,471,36,66,20049,0,0,0,0
ui-hud-minimap-arrow-genericdistantpoi,16371,1990,23,18,441,464,100,118,20050,0,0,0,0
ui-hud-minimap-arrow-group,16372,1990,23,18,466,489,100,118,20051,0,0,0,0
ui-hud-minimap-arrow-corpse-2x,16373,1995,58,58,441,499,58,116,20049,0,0,0,0
ui-hud-minimap-arrow-genericdistantpoi-2x,16374,1995,45,37,441,486,285,322,20050,0,0,0,0
ui-hud-minimap-arrow-group-2x,16375,1995,45,37,441,486,324,361,20051,0,0,0,0
ui-hud-minimap-zoom-in-down-2x,16376,1995,34,34,1,35,588,622,20059,0,0,0,0
ui-hud-minimap-zoom-out-down-2x,16377,1995,34,18,217,251,520,538,20061,0,0,0,0
ui-hud-minimap-zoom-in-mouseover-2x,16378,1995,34,34,1,35,624,658,20060,0,0,0,0
ui-hud-minimap-zoom-out-mouseover-2x,16379,1995,34,18,253,287,520,538,20062,0,0,0,0
ui-hud-minimap-zoom-in-down,16380,1990,17,17,441,458,161,178,20059,0,0,0,0
ui-hud-minimap-zoom-in-mouseover,16381,1990,17,17,460,477,161,178,20060,0,0,0,0
ui-hud-minimap-zoom-out-down,16382,1990,17,9,20,37,498,507,20061,0,0,0,0
ui-hud-minimap-zoom-out-mouseover,16383,1990,17,9,39,56,498,507,20062,0,0,0,0
talents-node-choice-mask-half,16422,2073,64,64,0,64,0,64,20065,0,0,16,0
ui-hud-unitframe-target-minusmob-portraiton-bar-health,16423,2060,125,12,460,585,235,247,20066,0,0,0,0
ui-hud-unitframe-target-minusmob-portraiton,16424,2060,192,67,1,193,160,227,20067,0,0,0,0
ui-hud-actionbar-iconframe-flyoutbottom,16441,1979,47,5,181,228,615,620,20084,0,0,0,0
ui-hud-actionbar-iconframe-flyoutbottom-2x,16442,1986,94,10,359,453,1217,1227,20084,0,0,0,0
ui-hud-actionbar-frame-divider-threeslice-edgeleft,16483,1979,12,14,229,241,428,442,20087,0,0,0,0
ui-hud-actionbar-frame-divider-threeslice-edgeright,16484,1979,12,14,243,255,428,442,20088,0,0,0,0
_ui-hud-actionbar-frame-divider-threeslice-center,16485,1979,16,14,0,16,93,107,20089,0,0,4,0
_ui-hud-actionbar-iconframe-flyoutmidleft,16486,1979,32,47,0,32,1,48,19771,0,0,4,0
!ui-hud-actionbar-iconframe-flyoutmid,16487,1981,47,32,1,48,0,32,19770,0,0,2,0
talents-node-choiceflyout-circle-gray,16558,1970,64,64,191,255,951,1015,20099,0,0,0,0
talents-node-choiceflyout-circle-green,16559,1970,64,64,629,693,949,1013,20100,0,0,0,0
talents-node-choiceflyout-circle-locked,16560,1970,64,64,887,951,955,1019,20101,0,0,0,0
talents-node-choiceflyout-circle-yellow,16561,1970,64,64,1005,1069,453,517,20102,0,0,0,0
talents-node-choiceflyout-square-gray,16562,1970,128,128,469,597,645,773,20103,64,64,0,0
talents-node-choiceflyout-square-green,16563,1970,128,128,469,597,775,903,20104,64,64,0,0
talents-node-choiceflyout-square-locked,16564,1970,128,128,629,757,175,303,20105,64,64,0,0
talents-node-choiceflyout-square-yellow,16565,1970,128,128,629,757,435,563,20106,64,64,0,0
talents-node-choiceflyout-circle-shadow,16566,1970,154,154,469,623,335,489,20107,0,0,0,0
talents-node-choiceflyout-square-shadow,16567,1970,158,158,469,627,175,333,20108,0,0,0,0
ui-hud-unitframe-player-rest-flipbook,16568,2075,360,420,1,361,1,421,20109,0,0,0,0
charactercreate-icon-requiredarrow,16570,708,80,66,439,519,575,641,20111,40,33,0,0
editmode-actionbar-selected-nineslice-corner,16571,1960,16,16,1,17,91,107,18534,0,0,0,0
_editmode-actionbar-selected-nineslice-edgebottom,16572,1960,16,16,0,16,37,53,18537,0,0,4,0
_editmode-actionbar-selected-nineslice-edgetop,16573,1960,16,16,0,16,55,71,18538,0,0,4,0
!editmode-actionbar-selected-nineslice-edgeleft,16574,1963,16,16,37,53,0,16,18543,0,0,2,0
!editmode-actionbar-selected-nineslice-edgeright,16575,1963,16,16,55,71,0,16,18544,0,0,2,0
editmode-down-arrow,16577,1960,16,11,1,17,145,156,20113,0,0,0,0
editmode-up-arrow,16578,1960,16,11,1,17,158,169,20114,0,0,0,0
majorfactions_icons_centaur512,16579,2079,512,512,1,513,1,513,20115,0,0,0,0
majorfactions_icons_expedition512,16580,2079,512,512,1029,1541,1,513,20116,0,0,0,0
majorfactions_icons_tuskarr512,16581,2079,512,512,1,513,1029,1541,20117,0,0,0,0
majorfactions_icons_valdrakken512,16582,2079,512,512,515,1027,515,1027,20118,0,0,0,0
majorfactions_mapicons_centaur64,16583,647,64,64,71,135,395,459,20119,42,42,0,0
majorfactions_mapicons_expedition64,16584,647,64,64,71,135,527,591,20120,42,42,0,0
majorfactions_mapicons_tuskarr64,16585,647,64,64,71,135,659,723,20121,42,42,0,0
majorfactions_mapicons_valdrakken64,16586,647,64,64,71,135,725,789,20122,42,42,0,0
quickkeybind-actionbar-iconframe-glow,16587,1685,46,45,1,47,938,983,20123,0,0,0,0
quickkeybind-actionbar-pagearrow-glow,16588,1685,17,14,31,48,985,999,20124,0,0,0,0
quickkeybind-microbar-iconframe-glow,16589,1685,33,40,51,84,888,928,20125,0,0,0,0
dragonriding-barbershop-icon-category-body1,16590,2070,156,158,1,157,1,159,20126,0,0,0,0
dragonriding-barbershop-icon-category-body1selected,16591,2070,156,158,1,157,161,319,20127,0,0,0,0
dragonriding-barbershop-icon-category-body2,16592,2070,156,158,1,157,321,479,20128,0,0,0,0
dragonriding-barbershop-icon-category-body2selected,16593,2070,156,158,159,315,1,159,20129,0,0,0,0
dragonriding-barbershop-icon-category-head,16594,2070,156,158,159,315,161,319,20130,0,0,0,0
dragonriding-barbershop-icon-category-headselected,16595,2070,156,158,159,315,321,479,20131,0,0,0,0
talents-node-choice-ghost,16596,1970,120,104,469,589,905,1009,20132,60,52,0,0
talents-node-circle-ghost,16597,1970,104,104,1005,1109,175,279,20133,52,52,0,0
talents-node-square-ghost,16598,1970,104,104,1005,1109,281,385,20134,52,52,0,0
talents-arrow-line-ghost,16599,2071,16,16,0,16,1,17,20135,8,8,4,0
ui-hud-actionbar-iconframe-flyoutbottomleft,16616,1979,5,47,247,252,136,183,20152,0,0,0,0
ui-hud-actionbar-iconframe-flyoutbuttonleft,16617,1979,29,47,181,210,721,768,20153,0,0,0,0
ui-hud-actionbar-iconframe-flyoutbottomleft-2x,16618,1986,10,94,489,499,209,303,20152,0,0,0,0
ui-hud-actionbar-iconframe-flyoutbuttonleft-2x,16619,1986,58,94,453,511,741,835,20153,0,0,0,0
professions-qualitypane-bg-top,16620,1933,260,100,271,531,451,551,19254,0,0,0,0
professions-recipe-header-left,16623,1933,14,26,1788,1802,26,52,20156,0,0,0,0
professions-recipe-header-middle,16624,1933,1,26,1804,1805,26,52,20157,0,0,0,0
professions-recipe-header-right,16625,1933,14,26,1863,1877,22,48,20158,0,0,0,0
professions-icon-skill-high,16626,1933,13,15,1254,1267,29,44,20159,0,0,0,0
professions-icon-skill-low,16627,1933,13,15,1226,1239,29,44,20160,0,0,0,0
professions-icon-skill-medium,16628,1933,13,15,1146,1159,29,44,20161,0,0,0,0
dial_edgeshinemask,16629,2083,512,512,0,512,0,512,20162,0,0,16,0
ui-hud-actionbar-flyout-2x,16630,1986,36,14,453,489,899,913,19055,0,0,0,0
ui-hud-actionbar-flyout-down-2x,16631,1986,38,16,453,491,881,897,19053,0,0,0,0
ui-hud-actionbar-flyout-mouseover-2x,16632,1986,36,14,453,489,915,929,19054,0,0,0,0
ui-hud-actionbar-frame-divider-threeslice-edgeleft-2x,16633,1986,24,28,453,477,837,865,20087,0,0,0,0
ui-hud-actionbar-frame-divider-threeslice-edgeright-2x,16634,1986,24,28,479,503,837,865,20088,0,0,0,0
_ui-hud-actionbar-frame-divider-threeslice-center-2x,16635,1986,32,28,0,32,179,207,20089,0,0,4,0
professions_recipe_active,16636,1933,267,19,1772,2039,83,102,20169,0,0,0,0
professions_recipe_hover,16637,1933,309,21,645,954,141,162,20170,0,0,0,0
ui-hud-actionbar-iconframe-addrow-down,16642,1979,51,51,181,232,358,409,20175,0,0,0,0
ui-hud-actionbar-iconframe-addrow-down-2x,16643,1986,102,102,359,461,545,647,20175,0,0,0,0
ui-hud-unitframe-target-portraiton-bar-health-mask,16645,2085,128,32,0,128,0,32,20177,0,0,16,0
ui-hud-unitframe-target-portraiton-bar-mana-mask,16646,2086,256,16,0,256,0,16,20178,0,0,16,0
specdial_center_innerring,16647,1933,73,73,404,477,831,904,20179,0,0,0,0
specdial_center_outerring,16648,1933,130,130,595,725,691,821,20180,0,0,0,0
specdial_center_outerringtitanline,16649,1933,118,118,404,522,711,829,20181,0,0,0,0
specdial_center_shadow,16650,1933,100,100,404,504,906,1006,20182,0,0,0,0
specdial_divider,16651,1933,21,47,1,22,957,1004,20183,0,0,0,0
specdial_edgeshine,16652,1933,353,353,1359,1712,199,552,20184,0,0,0,0
specdial_outer_base,16656,1933,338,338,1359,1697,554,892,20188,0,0,0,0
specdial_outer_titanlinering,16657,1933,281,281,1076,1357,199,480,20189,0,0,0,0
specdial_outer_titanlines,16658,1933,276,276,1076,1352,482,758,20190,0,0,0,0
specdial_outer_top,16659,1933,338,338,1699,2037,554,892,20191,0,0,0,0
specdial_pip_borderglow,16660,1933,34,54,233,267,684,738,20192,0,0,0,0
specdial_pip_empty,16661,1933,38,60,533,571,451,511,20193,0,0,0,0
specdial_titanlineglow,16662,1933,289,290,1714,2003,199,489,20194,0,0,0,0
ui-hud-unitframe-player-portrait-mask,16667,2088,64,64,0,64,0,64,20199,0,0,16,0
specdial_pip_flipbook_blacksmithing,16669,2089,360,360,1,361,1385,1745,20200,0,0,0,0
specdial_titanlinemask,16691,2081,512,512,0,512,0,512,20204,0,0,16,0
ui-hud-actionbar-iconframe-background,16692,1979,46,45,181,227,411,456,20205,0,0,0,0
qualitybar_mockup_flare,16693,1933,14,60,1,15,895,955,19215,0,0,0,0
editmode-new-layout-plus-disabled,16702,1960,16,16,1,17,109,125,20214,0,0,0,0
editmode-new-layout-plus,16703,1960,16,16,1,17,127,143,20215,0,0,0,0
ui-hud-unitframe-player-group-guideicon,16704,2060,16,16,975,991,213,229,20216,0,0,0,0
ui-hud-unitframe-player-group-leadericon,16705,2060,16,16,993,1009,213,229,20217,0,0,0,0
specdial_dividerglow_blacksmithing,16707,2089,344,344,543,887,1023,1367,20219,0,0,0,0
ui-hud-unitframe-target-portraiton-type,16713,2060,135,18,195,330,235,253,20225,0,0,0,0
specdial_fillmask,16714,2093,512,512,0,512,0,512,20226,0,0,16,0
specdial_fill_flipbook_blacksmithing,16715,2094,1980,1980,1,1981,1,1981,20206,0,0,0,0
skillbar_fill_flipbook_blacksmithing,16718,2089,1712,1020,1,1713,1,1021,20227,0,0,0,0
talents-search-exactmatch,16720,1970,126,126,629,755,565,691,20229,63,63,0,0
talents-search-match,16721,1970,126,126,629,755,693,819,20230,63,63,0,0
talents-search-relatedmatch,16722,1970,126,126,759,885,303,429,20231,63,63,0,0
talents-search-suggestion-itemborder,16723,1970,18,18,171,189,989,1007,20232,0,0,0,0
talents-search-suggestion-magnifyingglass,16724,1970,24,24,2020,2044,115,139,20233,12,12,0,0
talents-node-pvp-inspect-empty,16733,1970,116,104,887,1003,493,597,20242,58,52,0,0
talents-node-pvp-inspect,16734,1970,116,104,887,1003,387,491,20243,58,52,0,0
quest-campaign-available-trivial,16735,647,32,32,819,851,477,509,20244,0,0,0,0
bag-arrow-2x,16749,2098,20,32,484,504,1,33,20252,0,0,0,2
bag-border-2x,16750,2098,61,61,295,356,1,62,20254,0,0,0,2
bag-border-empty-2x,16751,2098,61,61,295,356,64,125,20253,0,0,0,2
bag-main-2x,16752,2098,96,96,1,97,1,97,20255,0,0,0,2
bag-reagent-border-2x,16753,2098,61,61,358,419,64,125,20257,0,0,0,2
bag-reagent-border-empty-2x,16754,2098,61,61,421,482,1,62,20256,0,0,0,2
looting_itemcard_bg,16755,2099,298,76,1,299,457,533,20264,0,0,0,0
looting_itemcard_highlightstate,16756,2099,298,76,1,299,535,611,20265,0,0,0,0
looting_itemcard_stroke_clickstate,16757,2099,298,76,1,299,613,689,20266,0,0,0,0
looting_itemcard_stroke_normal,16758,2099,298,76,1,299,691,767,20267,0,0,0,0
looting_raritytag_frame,16759,2099,208,15,301,509,457,472,20268,0,0,0,0
ui-hud-unitframe-player-portraiton-cornerembellishment,16761,2060,23,23,982,1005,133,156,20270,0,0,0,0
ui-hud-unitframe-player-portraiton-status,16763,2060,196,71,201,397,87,158,20272,0,0,0,0
skillbar_fill_flipbook_enchanting,16764,2100,1712,1258,1,1713,1,1259,20273,0,0,0,0
specdial_dividerglow_enchanting,16765,2100,344,344,543,887,1261,1605,20274,0,0,0,0
specdial_pip_flipbook_enchanting,16767,2100,360,360,1,361,1623,1983,20276,0,0,0,0
specdial_fill_flipbook_enchanting,16768,2101,1980,1980,1,1981,1,1981,20277,0,0,0,0
skillbar_fill_flipbook_tailoring,16769,2102,1712,1020,1,1713,1,1021,20278,0,0,0,0
specdial_dividerglow_tailoring,16770,2102,344,344,543,887,1023,1367,20279,0,0,0,0
specdial_pip_flipbook_tailoring,16772,2102,360,360,1,361,1385,1745,20281,0,0,0,0
specdial_fill_flipbook_tailoring,16773,2103,1980,1980,1,1981,1,1981,20282,0,0,0,0
skillbar_fill_flipbook_jewelcrafting,16774,2104,1712,748,1,1713,1,749,20283,0,0,0,0
specdial_dividerglow_jewelcrafting,16775,2104,344,344,1,345,1475,1819,20284,0,0,0,0
specdial_pip_flipbook_jewelcrafting,16777,2104,360,360,1,361,1113,1473,20286,0,0,0,0
specdial_fill_flipbook_jewelcrafting,16778,2105,1980,1980,1,1981,1,1981,20287,0,0,0,0
ui-hud-unitframe-player-combaticon,16779,2060,16,16,1007,1023,133,149,20288,0,0,0,0
ui-hud-unitframe-player-group-friendonlineicon,16780,2060,16,16,957,973,213,229,20289,0,0,0,0
ui-hud-unitframe-target-highleveltarget_icon,16781,2060,11,14,1008,1019,35,49,20290,0,0,0,0
ui-hud-unitframe-player-combaticon-2x,16782,2074,32,32,2005,2037,1,33,20288,0,0,0,0
ui-hud-unitframe-player-group-friendonlineicon-2x,16783,2074,32,32,2005,2037,35,67,20289,0,0,0,0
ui-hud-unitframe-player-group-guideicon-2x,16784,2074,32,32,2005,2037,69,101,20216,0,0,0,0
ui-hud-unitframe-player-group-leadericon-2x,16785,2074,32,32,2005,2037,103,135,20217,0,0,0,0
ui-hud-unitframe-player-pvp-allianceicon,16788,2060,28,41,195,223,337,378,20297,0,0,0,0
ui-hud-unitframe-player-pvp-ffaicon,16789,2060,28,44,982,1010,87,131,20298,0,0,0,0
ui-hud-unitframe-player-pvp-hordeicon,16790,2060,44,44,195,239,291,335,20299,0,0,0,0
dragonflight-scenario-titlebg,16791,2106,467,141,1,468,12,153,20300,0,0,0,0
dragonflight-scenario-trackerheader,16792,2106,243,77,246,489,155,232,20301,0,0,0,0
racing,16793,647,32,32,751,783,511,543,20302,22,22,0,0
professions-crafting-orders-icon,16794,647,32,32,581,613,477,509,20303,0,0,0,0
dragonflight-score-background,16795,2107,467,253,1,468,1,254,20304,0,0,0,0
dragonflight-score-footer,16796,2107,467,71,1,468,256,327,20305,0,0,0,0
dragonflight-score-topper,16797,2107,467,71,1,468,329,400,20306,0,0,0,0
accountupgradebanner-dragonflight,16798,558,200,134,203,403,1,135,20307,0,0,0,0
dragonflight-scenario-frame,16799,2106,243,77,1,244,155,232,20308,0,0,0,0
ui-castingbar-disabled-tier1-empower,16800,1942,209,11,268,477,85,96,20309,0,0,0,0
ui-castingbar-disabled-tier2-empower,16801,1942,209,11,57,266,98,109,20310,0,0,0,0
ui-castingbar-disabled-tier3-empower,16802,1942,209,11,268,477,98,109,20311,0,0,0,0
ui-castingbar-disabled-tier4-empower,16803,1942,209,11,57,266,111,122,20312,0,0,0,0
ui-castingbar-empower-cursor,16804,1942,12,17,430,442,1,18,20313,0,0,0,0
ui-castingbar-empower-pip,16805,1942,2,11,471,473,1,12,20314,0,0,0,0
ui-castingbar-glow-tier1-empower,16806,1942,209,11,268,477,150,161,20315,0,0,0,0
ui-castingbar-glow-tier2-empower,16807,1942,209,11,57,266,163,174,20316,0,0,0,0
ui-castingbar-glow-tier3-empower,16808,1942,209,11,268,477,163,174,20317,0,0,0,0
ui-castingbar-glow-tier4-empower,16809,1942,209,11,57,266,176,187,20318,0,0,0,0
ui-castingbar-tier1-empower,16810,1942,209,11,268,477,189,200,20319,0,0,0,0
ui-castingbar-tier2-empower,16811,1942,209,11,57,266,202,213,20320,0,0,0,0
ui-castingbar-tier3-empower,16812,1942,209,11,268,477,202,213,20321,0,0,0,0
ui-castingbar-tier4-empower,16813,1942,209,11,57,266,215,226,20322,0,0,0,0
ui-castingbar-disabled-tier1-empower-2x,16814,1943,418,22,422,840,33,55,20323,0,0,0,0
ui-castingbar-disabled-tier2-empower-2x,16815,1943,418,22,1,419,216,238,20324,0,0,0,0
ui-castingbar-disabled-tier3-empower-2x,16816,1943,418,22,421,839,216,238,20325,0,0,0,0
ui-castingbar-disabled-tier4-empower-2x,16817,1943,418,22,1,419,240,262,20326,0,0,0,0
ui-castingbar-empower-cursor-2x,16818,1943,16,32,90,106,408,440,20327,0,0,0,0
ui-castingbar-empower-pip-2x,16819,1943,2,22,898,900,1,23,20328,0,0,0,0
ui-castingbar-glow-tier1-empower-2x,16820,1943,418,22,1,419,288,310,20329,0,0,0,0
ui-castingbar-glow-tier2-empower-2x,16821,1943,418,22,421,839,288,310,20330,0,0,0,0
ui-castingbar-glow-tier3-empower-2x,16822,1943,418,22,1,419,312,334,20331,0,0,0,0
ui-castingbar-glow-tier4-empower-2x,16823,1943,418,22,421,839,312,334,20332,0,0,0,0
ui-castingbar-tier1-empower-2x,16824,1943,418,22,421,839,336,358,20333,0,0,0,0
ui-castingbar-tier2-empower-2x,16825,1943,418,22,1,419,360,382,20334,0,0,0,0
ui-castingbar-tier3-empower-2x,16826,1943,418,22,421,839,360,382,20335,0,0,0,0
ui-castingbar-tier4-empower-2x,16827,1943,418,22,1,419,384,406,20336,0,0,0,0
ui-castingbar-pressandhold-background-2x,16828,1943,422,26,425,847,188,214,18466,0,0,0,0
ui-castingbar-pressandhold-frame-2x,16829,1943,426,30,429,855,124,154,18467,0,0,0,0
ui-castingbar-pressandhold-frame-pip1-2x,16830,1943,14,30,850,864,1,31,18474,0,0,0,0
ui-castingbar-pressandhold-frame-pip2-2x,16831,1943,14,30,866,880,1,31,18475,0,0,0,0
ui-castingbar-pressandhold-full-glow-2x,16832,1943,426,30,1,427,156,186,18468,0,0,0,0
ui-castingbar-pressandhold-full-glow-frame-pip-2x,16833,1943,14,22,882,896,1,23,18476,0,0,0,0
ui-castingbar-pressandhold-background,16834,1942,209,11,57,266,189,200,18448,0,0,0,0
ui-castingbar-pressandhold-frame-pip1,16835,1942,7,10,444,451,1,11,18471,0,0,0,0
ui-castingbar-pressandhold-frame-pip2,16836,1942,7,10,453,460,1,11,18472,0,0,0,0
ui-castingbar-pressandhold-frame,16837,1942,212,14,217,429,67,81,18449,0,0,0,0
ui-castingbar-pressandhold-full-glow-frame-pip,16838,1942,7,10,462,469,1,11,18473,0,0,0,0
ui-castingbar-pressandhold-full-glow,16839,1942,214,16,1,215,67,83,18450,0,0,0,0
dragonriding-winds,16841,647,32,32,377,409,783,815,20338,0,0,0,0
ui-ej-dragonflight,16842,1304,786,425,1,787,428,853,20339,0,0,0,0
quickkeybind-bag-iconframe-glow,16846,1685,28,28,1,29,985,1013,20343,0,0,0,0
quickkeybind-mainbag-iconframe-glow,16848,1685,48,48,1,49,888,936,20345,0,0,0,0
flightmaster_ancientwaygate-taxinode_neutral,16849,647,30,30,627,657,99,129,20346,22,22,0,0
skillbar_fill_flipbook_alchemy,16850,2109,1712,1020,1,1713,1,1021,20347,0,0,0,0
specdial_dividerglow_alchemy,16851,2109,344,344,543,887,1023,1367,20348,0,0,0,0
specdial_endpip_flipbook_alchemy,16852,2109,540,360,1,541,1023,1383,20349,0,0,0,0
specdial_pip_flipbook_alchemy,16853,2109,360,360,1,361,1385,1745,20350,0,0,0,0
specdial_fill_flipbook_alchemy,16854,2110,1980,1980,1,1981,1,1981,20351,0,0,0,0
skillbar_fill_flipbook_leatherworking,16855,2111,1712,1020,1,1713,1,1021,20352,0,0,0,0
specdial_dividerglow_leatherworking,16856,2111,344,344,543,887,1023,1367,20353,0,0,0,0
specdial_pip_flipbook_leatherworking,16858,2111,360,360,1,361,1385,1745,20355,0,0,0,0
specdial_fill_flipbook_leatherworking,16859,2112,1980,1980,1,1981,1,1981,20356,0,0,0,0
dragonriding-widget-raceposition,16861,2113,362,50,1,363,1,51,20337,0,0,0,0
dragonriding-widget-reticle,16862,2113,16,16,365,381,1,17,20358,0,0,0,0
ui-hud-unitframe-player-playtimetired,16864,2060,29,29,227,256,380,409,20360,0,0,0,0
ui-hud-unitframe-player-playtimeunhealthy,16865,2060,29,29,195,224,412,441,20361,0,0,0,0
ui-hud-unitframe-player-portraitoff-bar-energy,16866,2060,124,10,527,651,289,299,20362,0,0,0,0
ui-hud-unitframe-player-portraitoff-bar-focus,16867,2060,124,10,653,777,289,299,20363,0,0,0,0
ui-hud-unitframe-player-portraitoff-bar-rage,16868,2060,124,10,779,903,289,299,20364,0,0,0,0
ui-hud-unitframe-player-portraitoff-bar-runicpower,16869,2060,124,10,269,393,301,311,20365,0,0,0,0
ui-hud-unitframe-player-portraiton-bar-energy,16870,2060,124,10,395,519,301,311,20366,0,0,0,0
ui-hud-unitframe-player-portraiton-bar-focus,16871,2060,124,10,521,645,301,311,20367,0,0,0,0
ui-hud-unitframe-player-portraiton-bar-rage,16872,2060,124,10,899,1023,301,311,20368,0,0,0,0
ui-hud-unitframe-player-portraiton-bar-runicpower,16873,2060,124,10,269,393,313,323,20369,0,0,0,0
ui-hud-unitframe-target-minusmob-portraiton-bar-energy,16874,2060,127,10,405,532,277,287,20370,0,0,0,0
ui-hud-unitframe-target-minusmob-portraiton-bar-focus,16875,2060,127,10,534,661,277,287,20371,0,0,0,0
ui-hud-unitframe-target-minusmob-portraiton-bar-mana,16876,2060,127,10,663,790,277,287,20372,0,0,0,0
ui-hud-unitframe-target-minusmob-portraiton-bar-rage,16877,2060,127,10,269,396,289,299,20373,0,0,0,0
ui-hud-unitframe-target-minusmob-portraiton-bar-runicpower,16878,2060,127,10,398,525,289,299,20374,0,0,0,0
ui-hud-unitframe-target-portraiton-bar-energy,16879,2060,134,10,841,975,235,245,20375,0,0,0,0
ui-hud-unitframe-target-portraiton-bar-focus,16880,2060,134,10,389,523,255,265,20376,0,0,0,0
ui-hud-unitframe-target-portraiton-bar-rage,16881,2060,134,10,797,931,255,265,20377,0,0,0,0
ui-hud-unitframe-target-portraiton-bar-runicpower,16882,2060,134,10,269,403,277,287,20378,0,0,0,0
ui-hud-unitframe-targetoftarget-portraiton-bar-energy,16884,2060,74,7,808,882,77,84,20380,0,0,0,0
ui-hud-unitframe-targetoftarget-portraiton-bar-focus,16885,2060,74,7,884,958,77,84,20381,0,0,0,0
ui-hud-unitframe-targetoftarget-portraiton-bar-rage,16886,2060,74,7,661,735,267,274,20382,0,0,0,0
ui-hud-unitframe-targetoftarget-portraiton-bar-runicpower,16887,2060,74,7,933,1007,255,262,20383,0,0,0,0
ui-hud-unitframe-player-portraiton-bar-health-mask,16896,2114,128,32,0,128,0,32,20392,0,0,16,0
ui-hud-unitframe-player-portraiton-bar-mana-mask,16897,2115,128,16,0,128,0,16,20393,0,0,16,0
redbutton-condense-2x,16904,2116,36,38,1,37,1,39,20571,0,0,0,0
redbutton-condense-disabled-2x,16905,2116,36,38,1,37,41,79,20572,0,0,0,0
redbutton-condense-pressed-2x,16907,2116,36,38,1,37,81,119,20573,0,0,0,0
redbutton-exit-2x,16908,2116,36,38,39,75,1,39,20574,0,0,0,0
redbutton-exit-disabled-2x,16909,2116,36,38,39,75,41,79,20575,0,0,0,0
redbutton-exit-pressed-2x,16911,2116,36,38,39,75,81,119,20576,0,0,0,0
redbutton-expand-2x,16912,2116,36,38,77,113,1,39,20577,0,0,0,0
redbutton-expand-disabled-2x,16913,2116,36,38,77,113,41,79,20578,0,0,0,0
redbutton-expand-pressed-2x,16915,2116,36,38,77,113,81,119,20579,0,0,0,0
redbutton-minicondense-2x,16916,2116,36,38,115,151,41,79,20581,0,0,0,0
redbutton-minicondense-disabled-2x,16917,2116,36,38,115,151,81,119,20582,0,0,0,0
redbutton-minicondense-pressed-2x,16919,2116,36,38,153,189,1,39,20583,0,0,0,0
redbutton-highlight-2x,16920,2116,36,38,115,151,1,39,20580,0,0,0,0
ui-hud-unitframe-player-portraitoff-bar-health-status,16921,2060,124,20,579,703,213,233,20417,0,0,0,0
ui-hud-unitframe-player-portraiton-bar-health-status,16922,2060,124,20,831,955,213,233,20418,0,0,0,0
ui-hud-unitframe-target-minusmob-portraiton-bar-health-status,16923,2060,125,12,587,712,235,247,20419,0,0,0,0
ui-hud-unitframe-target-portraiton-bar-health-status,16924,2060,126,20,323,449,213,233,20420,0,0,0,0
ui-hud-unitframe-targetoftarget-portraiton-bar-health-status,16925,2060,70,10,946,1016,183,193,20421,0,0,0,0
ui-hud-unitframe-player-absorb-edge,16928,2060,8,32,1008,1016,1,33,20424,0,0,0,0
ui-hud-unitframe-player-portraiton-incombat,16931,2060,192,71,593,785,87,158,20425,0,0,0,0
ui-frame-dragonflight-titleleft,16932,2117,202,85,373,575,152,237,20426,0,0,0,0
_ui-frame-dragonflight-titlemiddle,16933,2117,128,85,0,128,1,86,20427,0,0,4,0
ui-frame-dragonflight-backgroundtile,16934,2118,256,256,0,256,0,256,20428,0,0,6,0
ui-frame-dragonflight-titleright,16945,2117,202,85,169,371,152,237,20439,0,0,0,0
!ui-frame-dragonflight-tileleft,16946,2119,30,256,1,31,0,256,20542,0,0,2,0
!ui-frame-dragonflight-tileright,16947,2119,30,256,33,63,0,256,20539,0,0,2,0
bag-border-highlight-2x,16948,2098,61,61,358,419,1,62,20517,0,0,0,2
bag-main-highlight-2x,16949,2098,96,96,99,195,1,97,20518,0,0,0,2
dragonflight-golddetailtop,17025,2117,180,57,577,757,152,209,20519,0,0,0,0
dragonflight-nineslice-cornerbottomright,17026,2117,166,166,1,167,488,654,20520,0,0,0,0
dragonflight-dragonheadright,17027,2117,160,74,1,161,656,730,20521,0,0,0,0
dragonflight-nineslice-cornertopright,17028,2117,166,166,1,167,152,318,20522,0,0,0,0
dragonflight-nineslice-cornerbottomleft,17029,2117,166,166,1,167,732,898,20523,0,0,0,0
dragonflight-dragonheadleft,17030,2117,160,74,1,161,935,1009,20524,0,0,0,0
dragonflight-golddetailbottom,17031,2117,120,33,1,121,900,933,20525,0,0,0,0
dragonflight-nineslice-cornertopleft,17032,2117,166,166,1,167,320,486,20526,0,0,0,0
_dragonflight-nineslice-edgetop,17036,2117,256,30,0,256,88,118,20530,0,0,4,0
_dragonflight-nineslice-edgebottom,17038,2117,256,30,0,256,120,150,20532,0,0,4,0
uiframebackground-nineslice-cornerbottomleft,17053,2120,16,16,1,17,1,17,20550,0,0,0,0
uiframebackground-nineslice-cornerbottomright,17054,2120,16,16,19,35,1,17,20551,0,0,0,0
_looting_itemcard_shadow-cornerbottomleft,17062,2099,8,150,0,8,153,303,20559,0,0,4,0
_looting_itemcard_shadow-cornerbottomright,17063,2099,8,150,0,8,305,455,20560,0,0,4,0
quickkeybind-actionbar-iconframe-glow-2x,17065,2123,92,90,99,191,1,91,20123,0,0,0,0
quickkeybind-actionbar-pagearrow-glow-2x,17066,2123,34,28,1,35,99,127,20124,0,0,0,0
quickkeybind-bag-iconframe-glow-2x,17067,2123,56,56,193,249,1,57,20343,0,0,0,0
quickkeybind-mainbag-iconframe-glow-2x,17068,2123,96,96,1,97,1,97,20345,0,0,0,0
professions-icon-quality-mixed-inv,17074,2124,33,28,37,70,37,65,20234,0,0,0,0
professions-icon-quality-tier1-inv,17075,2124,33,28,72,105,37,65,20209,0,0,0,0
professions-icon-quality-tier2-inv,17076,2124,33,28,37,70,67,95,20210,0,0,0,0
professions-icon-quality-tier3-inv,17077,2124,33,28,37,70,97,125,20211,0,0,0,0
professions-icon-quality-tier4-inv,17078,2124,33,28,72,105,67,95,20240,0,0,0,0
professions-icon-quality-tier5-inv,17079,2124,33,28,72,105,97,125,20241,0,0,0,0
bags-item-slot64-2x,17084,2127,64,64,0,64,0,64,20567,0,0,6,0
bags-icon-junk,17085,202,50,50,157,207,98,148,20569,0,0,0,0
bags-icon-questitem,17086,202,50,50,157,207,202,252,20570,0,0,0,0
common-coinbox-left,17093,2128,16,34,1,17,37,71,20590,0,0,0,0
common-coinbox-right,17094,2128,16,34,1,17,73,107,20591,0,0,0,0
_common-coinbox-center,17095,2128,16,34,0,16,1,35,20592,0,0,4,0
common-currencybox-left,17096,2129,16,34,1,17,37,71,20593,0,0,0,0
common-currencybox-right,17097,2129,16,34,1,17,73,107,20594,0,0,0,0
_common-currencybox-center,17098,2129,16,34,0,16,1,35,20595,0,0,4,0
_looting_itemcard_shadow-center,17099,2099,8,150,0,8,1,151,20596,0,0,4,0
_common-search-border-center,17100,1541,16,40,0,16,1,41,20597,0,0,4,0
newplayertutorial-yellowglow-redbutton-left,17103,575,50,98,105,155,902,1000,20598,25,49,0,0
newplayertutorial-yellowglow-redbutton-middle,17104,575,4,98,2009,2013,131,229,20599,2,49,0,0
newplayertutorial-yellowglow-redbutton-right,17105,575,50,98,157,207,902,1000,20600,25,49,0,0
talents-node-choiceflyout-circle-ghost,17106,1970,136,136,279,415,887,1023,20601,68,68,0,0
talents-node-choiceflyout-square-ghost,17107,1970,152,152,469,621,491,643,20602,76,76,0,0
talents-node-choiceflyout-circle-greenglow,17108,1970,108,108,887,995,845,953,20603,0,0,0,0
talents-node-choiceflyout-square-greenglow,17109,1970,216,216,1,217,569,785,20604,108,108,0,0
bags-icon-addauthenticator,17110,202,50,50,93,143,110,160,20605,0,0,0,0
bags-padlock-authenticator,17111,202,63,76,1,64,93,169,20606,0,0,0,0
ui-hud-experiencebar-background,17112,1980,563,9,1,564,20,29,20607,0,0,0,0
ui-hud-experiencebar-fill-prediction,17113,1980,563,9,574,1137,1,10,20608,0,0,0,0
ui-hud-experiencebar-frame-pip-mouseover,17115,1980,12,14,574,586,45,59,20610,0,0,0,0
ui-hud-experiencebar-frame-pip,17116,1980,10,14,588,598,45,59,20611,0,0,0,0
ui-hud-experiencebar-frame,17117,1980,571,17,1,572,1,18,20612,0,0,0,0
ui-hud-unitframe-target-portraiton-boss-gold-winged,17119,2130,99,81,1,100,1,82,20544,0,0,0,0
ui-hud-unitframe-target-portraiton-boss-gold,17120,2130,80,79,1,81,84,163,20545,0,0,0,0
ui-hud-unitframe-target-portraiton-boss-quest,17121,2130,26,26,219,245,29,55,20546,20,20,0,0
ui-hud-unitframe-target-portraiton-boss-rare-star,17122,2130,26,26,83,109,148,174,20547,20,20,0,0
ui-hud-unitframe-target-portraiton-boss-gold,17125,2131,160,158,1,161,165,323,20545,0,0,0,0
ui-hud-unitframe-target-portraiton-boss-gold-winged-2x,17126,2131,198,162,1,199,1,163,20544,0,0,0,0
ui-hud-unitframe-target-portraiton-boss-quest-2x,17127,2131,52,52,433,485,55,107,20546,40,40,0,0
ui-hud-unitframe-target-portraiton-boss-rare-star-2x,17128,2131,52,52,163,215,289,341,20547,40,40,0,0
ui-hud-unitframe-player-combaticon-glow,17131,2060,32,32,225,257,337,369,20613,0,0,0,0
ui-frame-portraitmetal-cornertopleftsmall-2x,17133,1390,150,150,1,151,305,455,20616,0,0,0,2
centaur-customization-background,17134,2132,678,268,1,679,1,269,20617,0,0,0,0
centaurtalents-background,17135,2132,372,267,1,373,271,538,20618,0,0,0,0
ui-hud-experiencebar-fill-artifactpower,17144,1980,563,9,1,564,31,40,20627,0,0,0,0
ui-hud-experiencebar-fill-experience,17145,1980,563,9,1,564,42,51,20628,0,0,0,0
ui-hud-experiencebar-fill-honor,17146,1980,563,9,1,564,53,62,20629,0,0,0,0
ui-hud-experiencebar-fill-reputation,17147,1980,563,9,1139,1702,1,10,20630,0,0,0,0
ui-hud-experiencebar-fill-rested,17148,1980,563,9,574,1137,34,43,20631,0,0,0,0
ui-hud-experiencebar-fill-reputation-faction-green,17149,1980,563,9,574,1137,12,21,20632,0,0,0,0
ui-hud-experiencebar-fill-reputation-faction-orange,17150,1980,563,9,1139,1702,12,21,20633,0,0,0,0
ui-hud-experiencebar-fill-reputation-faction-red,17151,1980,563,9,574,1137,23,32,20634,0,0,0,0
ui-hud-experiencebar-fill-reputation-faction-yellow,17152,1980,563,9,1139,1702,23,32,20635,0,0,0,0
uiframe-activetab-left,17153,2134,35,42,1,36,127,169,20636,0,0,0,0
uiframe-activetab-right,17154,2134,37,42,1,38,83,125,20637,0,0,0,0
uiframe-tab-left,17155,2134,35,36,1,36,209,245,20638,0,0,0,0
uiframe-tab-right,17156,2134,37,36,1,38,171,207,20639,0,0,0,0
_uiframe-activetab-center,17157,2134,1,42,0,1,1,43,20640,0,0,4,0
_uiframe-tab-center,17158,2134,1,36,0,1,45,81,20641,0,0,4,0
spec-hover-background,17160,2026,395,856,1615,2010,1,857,20643,0,0,0,0
spec-background,17162,2026,1612,856,1,1613,1,857,19292,0,0,0,0
ui-hud-micromenu-achievements-disabled-2x,17163,2136,64,82,1,65,1,83,18723,32,41,0,2
ui-hud-micromenu-achievements-down-2x,17164,2136,64,82,1,65,85,167,18689,32,41,0,2
ui-hud-micromenu-achievements-mouseover-2x,17165,2136,64,82,1,65,169,251,18690,32,41,0,2
ui-hud-micromenu-achievements-up-2x,17166,2136,64,82,1,65,253,335,18691,32,41,0,2
ui-hud-micromenu-adventureguide-disabled-2x,17167,2136,64,82,1,65,337,419,18724,32,41,0,2
ui-hud-micromenu-adventureguide-down-2x,17168,2136,64,82,1,65,421,503,18692,32,41,0,2
ui-hud-micromenu-adventureguide-mouseover-2x,17169,2136,64,82,67,131,1,83,18693,32,41,0,2
ui-hud-micromenu-adventureguide-up-2x,17170,2136,64,82,67,131,85,167,18694,32,41,0,2
ui-hud-micromenu-collections-disabled-2x,17175,2136,64,82,67,131,337,419,18726,32,41,0,2
ui-hud-micromenu-collections-down-2x,17176,2136,64,82,67,131,421,503,18698,32,41,0,2
ui-hud-micromenu-collections-mouseover-2x,17177,2136,64,82,133,197,1,83,18699,32,41,0,2
ui-hud-micromenu-collections-up-2x,17178,2136,64,82,133,197,85,167,18700,32,41,0,2
ui-hud-micromenu-communities-icon-notification-2x,17179,2136,28,28,595,623,421,449,18722,14,14,0,2
ui-hud-micromenu-gamemenu-disabled-2x,17180,2136,64,82,133,197,169,251,18727,32,41,0,2
ui-hud-micromenu-gamemenu-down-2x,17181,2136,64,82,133,197,253,335,18701,32,41,0,2
ui-hud-micromenu-gamemenu-mouseover-2x,17182,2136,64,82,133,197,337,419,18702,32,41,0,2
ui-hud-micromenu-gamemenu-up-2x,17183,2136,64,82,133,197,421,503,18703,32,41,0,2
ui-hud-micromenu-groupfinder-disabled-2x,17184,2136,64,82,199,263,1,83,18728,32,41,0,2
ui-hud-micromenu-groupfinder-down-2x,17185,2136,64,82,199,263,85,167,18704,32,41,0,2
ui-hud-micromenu-groupfinder-mouseover-2x,17186,2136,64,82,199,263,169,251,18705,32,41,0,2
ui-hud-micromenu-groupfinder-up-2x,17187,2136,64,82,199,263,253,335,18706,32,41,0,2
ui-hud-micromenu-guildcommunities-disabled-2x,17188,2136,64,82,199,263,337,419,18729,32,41,0,2
ui-hud-micromenu-guildcommunities-down-2x,17189,2136,64,82,199,263,421,503,18707,32,41,0,2
ui-hud-micromenu-guildcommunities-mouseover-2x,17190,2136,64,82,265,329,337,419,18708,32,41,0,2
ui-hud-micromenu-guildcommunities-up-2x,17191,2136,64,82,265,329,421,503,18709,32,41,0,2
ui-hud-micromenu-highlightalert-2x,17192,2136,64,82,331,395,1,83,19817,32,41,0,2
ui-hud-micromenu-questlog-disabled-2x,17193,2136,64,82,331,395,253,335,18730,32,41,0,2
ui-hud-micromenu-questlog-down-2x,17194,2136,64,82,331,395,337,419,18710,32,41,0,2
ui-hud-micromenu-questlog-mouseover-2x,17195,2136,64,82,331,395,421,503,18711,32,41,0,2
ui-hud-micromenu-questlog-up-2x,17196,2136,64,82,397,461,1,83,18712,32,41,0,2
ui-hud-micromenu-shop-disabled-2x,17197,2136,64,82,397,461,85,167,18731,32,41,0,2
ui-hud-micromenu-shop-mouseover-2x,17198,2136,64,82,397,461,169,251,18714,32,41,0,2
ui-hud-micromenu-shop-mouseover-down-2x,17199,2136,64,82,397,461,253,335,19763,32,41,0,2
ui-hud-micromenu-shop-up-2x,17200,2136,64,82,397,461,337,419,18715,32,41,0,2
ui-hud-micromenu-spectalents-disabled-2x,17201,2136,64,82,397,461,421,503,18732,32,41,0,2
ui-hud-micromenu-spectalents-down-2x,17202,2136,64,82,463,527,1,83,18716,32,41,0,2
ui-hud-micromenu-spectalents-mouseover-2x,17203,2136,64,82,463,527,85,167,18717,32,41,0,2
ui-hud-micromenu-spectalents-up-2x,17204,2136,64,82,463,527,169,251,18718,32,41,0,2
ui-hud-micromenu-spellbookabilities-disabled-2x,17205,2136,64,82,463,527,253,335,18733,32,41,0,2
ui-hud-micromenu-spellbookabilities-down-2x,17206,2136,64,82,463,527,337,419,18719,32,41,0,2
ui-hud-micromenu-spellbookabilities-mouseover-2x,17207,2136,64,82,463,527,421,503,18720,32,41,0,2
ui-hud-micromenu-spellbookabilities-up-2x,17208,2136,64,82,529,593,1,83,18721,32,41,0,2
dragonflight-weeklyrewards-divider,17209,1646,1057,7,973,2030,10,17,20644,0,0,0,0
dragonflight-weeklyrewards-frame-button,17210,1646,237,26,734,971,10,36,20645,0,0,0,0
dragonflight-weeklyrewards-frame-mode,17211,1646,359,137,1022,1381,242,379,20646,0,0,0,0
ui-hud-experiencebar-fill-reputation-faction-blue,17212,1980,563,9,1139,1702,34,43,20647,0,0,0,0
ui-hud-micromenu-streamdlgreen-down-2x,17215,2136,64,82,529,593,85,167,20650,32,41,0,2
ui-hud-micromenu-streamdlgreen-up-2x,17216,2136,64,82,529,593,169,251,20651,32,41,0,2
ui-hud-micromenu-streamdlred-down-2x,17217,2136,64,82,529,593,253,335,20652,32,41,0,2
ui-hud-micromenu-streamdlred-up-2x,17218,2136,64,82,529,593,337,419,20653,32,41,0,2
ui-hud-micromenu-streamdlyellow-down-2x,17219,2136,64,82,529,593,421,503,20654,32,41,0,2
ui-hud-micromenu-streamdlyellow-up-2x,17220,2136,64,82,595,659,1,83,20655,32,41,0,2
bag-border-search-2x,17221,2098,61,61,421,482,64,125,20656,0,0,0,2
bag-main-search-2x,17222,2098,96,96,197,293,1,97,20657,0,0,0,2
dressingroom-background-evoker,17223,2137,478,500,1,479,1,501,20658,0,0,0,0
uf-soulshard-fx-frameglow,17224,2138,29,36,1,30,162,198,20659,0,0,0,0
uf-soulshard-fx-holderglow,17225,2138,27,33,1,28,200,233,20660,0,0,0,0
uf-soulshard-fx-smoke,17226,2138,20,37,61,81,196,233,20661,0,0,0,0
uf-soulshard-fx1,17227,2138,15,20,61,76,235,255,20662,0,0,0,0
uf-soulshard-fx2,17228,2138,16,20,1,17,235,255,20663,0,0,0,0
uf-soulshard-fx3,17229,2138,16,23,32,48,230,253,20664,0,0,0,0
uf-soulshard-holder,17230,2138,23,30,90,113,162,192,20665,0,0,0,0
uf-soulshard-icon,17231,2138,15,20,206,221,191,211,20666,0,0,0,0
uf-soulshard-iconglow,17232,2138,15,20,223,238,191,211,20667,0,0,0,0
uf-soulshard-refill,17233,2138,15,20,206,221,213,233,20668,0,0,0,0
uf-soulshard-refillbg,17234,2138,15,20,206,221,235,255,20669,0,0,0,0
uf-soulshard-fx-frameglow-2x,17235,2139,58,71,1,59,321,392,20659,0,0,0,0
uf-soulshard-fx-holderglow-2x,17236,2139,54,66,1,55,394,460,20660,0,0,0,0
uf-soulshard-fx-smoke-2x,17237,2139,40,73,116,156,387,460,20661,0,0,0,0
uf-soulshard-fx1-2x,17238,2139,30,40,389,419,321,361,20662,0,0,0,0
uf-soulshard-fx2-2x,17239,2139,31,39,116,147,462,501,20663,0,0,0,0
uf-soulshard-fx3-2x,17240,2139,32,45,1,33,462,507,20664,0,0,0,0
uf-soulshard-holder-2x,17241,2139,46,59,171,217,321,380,20665,0,0,0,0
uf-soulshard-icon-2x,17242,2139,30,40,421,451,321,361,20666,0,0,0,0
uf-soulshard-iconglow-2x,17243,2139,30,40,389,419,363,403,20667,0,0,0,0
uf-soulshard-refill-2x,17244,2139,30,40,421,451,363,403,20668,0,0,0,0
uf-soulshard-refillbg-2x,17245,2139,30,40,389,419,405,445,20669,0,0,0,0
uf-soulshards-flipbook-soul-2x,17246,2139,476,318,1,477,1,319,20688,0,0,0,0
uf-soulshards-flipbook-depletea-2x,17247,2139,252,234,733,985,213,447,20685,0,0,0,0
uf-soulshards-flipbook-depleteb-2x,17248,2139,252,246,479,731,213,459,20686,0,0,0,0
uf-soulshards-flipbook-depletec-2x,17249,2139,348,210,479,827,1,211,20687,0,0,0,0
uf-soulshards-flipbook-depletea,17250,2138,126,117,369,495,108,225,20685,0,0,0,0
uf-soulshards-flipbook-depleteb,17251,2138,126,123,241,367,108,231,20686,0,0,0,0
uf-soulshards-flipbook-depletec,17252,2138,174,105,241,415,1,106,20687,0,0,0,0
uf-soulshards-flipbook-soul,17253,2138,238,159,1,239,1,160,20688,0,0,0,0
uf-soulshard-inc1-2x,17254,2139,32,54,355,387,321,375,20708,0,0,0,0
uf-soulshard-inc1glow-2x,17255,2139,37,54,316,353,321,375,20709,0,0,0,0
uf-soulshard-inc2-2x,17256,2139,32,54,355,387,377,431,20710,0,0,0,0
uf-soulshard-inc2glow-2x,17257,2139,37,54,316,353,377,431,20711,0,0,0,0
uf-soulshard-inc3-2x,17258,2139,32,54,355,387,433,487,20712,0,0,0,0
uf-soulshard-inc3glow-2x,17259,2139,37,54,316,353,433,487,20713,0,0,0,0
uf-soulshard-inc4-2x,17260,2139,44,54,270,314,321,375,20714,0,0,0,0
uf-soulshard-inc4glow-2x,17261,2139,49,54,219,268,321,375,20715,0,0,0,0
uf-soulshard-inc5-2x,17262,2139,44,54,270,314,377,431,20716,0,0,0,0
uf-soulshard-inc5glow-2x,17263,2139,49,54,219,268,377,431,20717,0,0,0,0
uf-soulshard-inc6-2x,17264,2139,44,54,270,314,433,487,20718,0,0,0,0
uf-soulshard-inc6glow-2x,17265,2139,49,54,219,268,433,487,20719,0,0,0,0
uf-soulshard-inc7-2x,17266,2139,46,58,61,107,453,511,20720,0,0,0,0
uf-soulshard-inc7glow-2x,17267,2139,53,64,61,114,321,385,20721,0,0,0,0
uf-soulshard-inc8-2x,17268,2139,46,58,171,217,382,440,20722,0,0,0,0
uf-soulshard-inc8glow-2x,17269,2139,53,64,61,114,387,451,20723,0,0,0,0
uf-soulshard-inc9-2x,17270,2139,46,58,171,217,442,500,20724,0,0,0,0
uf-soulshard-inc9glow-2x,17271,2139,53,64,116,169,321,385,20725,0,0,0,0
uf-soulshard-refillfx-2x,17272,2139,30,40,389,419,447,487,20726,0,0,0,0
uf-soulshard-inc1,17273,2138,16,27,167,183,220,247,20708,0,0,0,0
uf-soulshard-inc1glow,17274,2138,19,27,191,210,162,189,20709,0,0,0,0
uf-soulshard-inc2,17275,2138,16,27,188,204,191,218,20710,0,0,0,0
uf-soulshard-inc2glow,17276,2138,19,27,212,231,162,189,20711,0,0,0,0
uf-soulshard-inc3,17277,2138,16,27,188,204,220,247,20712,0,0,0,0
uf-soulshard-inc3glow,17278,2138,19,27,167,186,191,218,20713,0,0,0,0
uf-soulshard-inc4,17279,2138,22,27,142,164,193,220,20714,0,0,0,0
uf-soulshard-inc4glow,17280,2138,25,27,115,140,162,189,20715,0,0,0,0
uf-soulshard-inc5,17281,2138,22,27,142,164,222,249,20716,0,0,0,0
uf-soulshard-inc5glow,17282,2138,25,27,115,140,191,218,20717,0,0,0,0
uf-soulshard-inc6,17283,2138,22,27,167,189,162,189,20718,0,0,0,0
uf-soulshard-inc6glow,17284,2138,25,27,115,140,220,247,20719,0,0,0,0
uf-soulshard-inc7,17285,2138,23,29,90,113,194,223,20720,0,0,0,0
uf-soulshard-inc7glow,17286,2138,27,32,32,59,162,194,20721,0,0,0,0
uf-soulshard-inc8,17287,2138,23,29,90,113,225,254,20722,0,0,0,0
uf-soulshard-inc8glow,17288,2138,27,32,32,59,196,228,20723,0,0,0,0
uf-soulshard-inc9,17289,2138,23,29,142,165,162,191,20724,0,0,0,0
uf-soulshard-inc9glow,17290,2138,27,32,61,88,162,194,20725,0,0,0,0
uf-soulshard-refillfx,17291,2138,15,20,223,238,213,233,20726,0,0,0,0
dragonflight-scenario-barfill,17292,2106,231,9,0,231,1,10,20727,0,0,4,0
uf-holypower-depleterune1_2x,17293,2140,312,430,327,639,423,853,20774,0,0,0,0
uf-holypower-depleterune2_2x,17294,2140,336,420,327,663,1,421,20775,0,0,0,0
uf-holypower-depleterune3_2x,17295,2140,324,430,1,325,443,873,20776,0,0,0,0
uf-holypower-depleterune4_2x,17296,2140,324,420,665,989,1,421,20777,0,0,0,0
uf-holypower-depleterune5_2x,17297,2140,324,440,1,325,1,441,20778,0,0,0,0
uf-holypower-fx-smoke-2x,17298,2140,38,67,436,474,942,1009,20779,0,0,0,0
uf-holypower-rune1-2x,17299,2140,36,36,943,979,471,507,20786,0,0,0,0
uf-holypower-rune1-active-2x,17300,2140,45,46,943,988,423,469,20780,0,0,0,0
uf-holypower-rune1-blur-2x,17301,2140,30,40,991,1021,1,41,20781,0,0,0,0
uf-holypower-rune1-fx-2x,17303,2140,60,52,72,132,962,1014,20783,0,0,0,0
uf-holypower-rune1-glow-2x,17304,2140,51,52,327,378,942,994,20784,0,0,0,0
uf-holypower-rune1-ready-2x,17305,2140,45,46,943,988,510,556,20785,0,0,0,0
uf-holypower-rune2-2x,17306,2140,39,32,981,1020,471,503,20793,0,0,0,0
uf-holypower-rune2-active-2x,17307,2140,47,44,943,990,597,641,20787,0,0,0,0
uf-holypower-rune2-blur-2x,17308,2140,32,37,991,1023,85,122,20788,0,0,0,0
uf-holypower-rune2-fx-2x,17310,2140,69,47,1,70,962,1009,20790,0,0,0,0
uf-holypower-rune2-glow-2x,17311,2140,54,49,380,434,942,991,20791,0,0,0,0
uf-holypower-rune2-ready-2x,17312,2140,47,44,641,688,684,728,20792,0,0,0,0
uf-holypower-rune3-2x,17313,2140,34,30,380,414,993,1023,20800,0,0,0,0
uf-holypower-rune3-active-2x,17314,2140,46,42,641,687,824,866,20794,0,0,0,0
uf-holypower-rune3-blur-2x,17315,2140,30,37,991,1021,124,161,20795,0,0,0,0
uf-holypower-rune3-fx-2x,17317,2140,56,48,246,302,962,1010,20797,0,0,0,0
uf-holypower-rune3-glow-2x,17318,2140,52,49,476,528,942,991,20798,0,0,0,0
uf-holypower-rune3-ready-2x,17319,2140,46,42,641,687,868,910,20799,0,0,0,0
uf-holypower-rune4-2x,17320,2140,30,31,991,1021,201,232,20807,0,0,0,0
uf-holypower-rune4-active-2x,17321,2140,41,43,641,682,912,955,20801,0,0,0,0
uf-holypower-rune4-blur-2x,17322,2140,26,36,991,1017,163,199,20802,0,0,0,0
uf-holypower-rune4-fx-2x,17324,2140,48,50,530,578,942,992,20804,0,0,0,0
uf-holypower-rune4-glow-2x,17325,2140,48,49,580,628,942,991,20805,0,0,0,0
uf-holypower-rune4-ready-2x,17326,2140,41,43,641,682,957,1000,20806,0,0,0,0
uf-holypower-rune5-2x,17327,2140,35,32,943,978,558,590,20814,0,0,0,0
uf-holypower-rune5-active-2x,17328,2140,44,45,641,685,730,775,20808,0,0,0,0
uf-holypower-rune5-blur-2x,17329,2140,30,40,991,1021,43,83,20809,0,0,0,0
uf-holypower-rune5-fx-2x,17331,2140,56,50,134,190,962,1012,20811,0,0,0,0
uf-holypower-rune5-glow-2x,17332,2140,52,52,192,244,962,1014,20812,0,0,0,0
uf-holypower-rune5-ready-2x,17333,2140,44,45,641,685,777,822,20813,0,0,0,0
uf-holypower-runeholder-2x,17334,2140,300,85,1,301,875,960,20819,0,0,0,0
uf-holypower-runeholder-active-2x,17335,2140,300,85,327,627,855,940,20815,0,0,0,0
uf-holypower-runeholder-glow-2x,17336,2140,300,85,641,941,423,508,20816,0,0,0,0
uf-holypower-runeholder-ready-2x,17337,2140,300,85,641,941,510,595,20817,0,0,0,0
uf-holypower-runeholder-thinglow-2x,17338,2140,300,85,641,941,597,682,20818,0,0,0,0
uf-holypower-depleterune1,17339,2141,156,215,165,321,213,428,20774,0,0,0,0
uf-holypower-depleterune2,17340,2141,168,210,165,333,1,211,20775,0,0,0,0
uf-holypower-depleterune3,17341,2141,162,215,1,163,223,438,20776,0,0,0,0
uf-holypower-depleterune4,17342,2141,162,210,335,497,1,211,20777,0,0,0,0
uf-holypower-depleterune5,17343,2141,162,220,1,163,1,221,20778,0,0,0,0
uf-holypower-fx-smoke,17344,2141,19,34,224,243,475,509,20779,0,0,0,0
uf-holypower-rune1-active,17345,2141,23,23,475,498,258,281,20780,0,0,0,0
uf-holypower-rune1-blur,17346,2141,15,20,349,364,372,392,20781,0,0,0,0
uf-holypower-rune1-fx,17348,2141,30,26,38,68,485,511,20783,0,0,0,0
uf-holypower-rune1-glow,17349,2141,26,26,100,126,485,511,20784,0,0,0,0
uf-holypower-rune1-ready,17350,2141,23,23,475,498,303,326,20785,0,0,0,0
uf-holypower-rune1,17351,2141,18,18,475,493,283,301,20786,0,0,0,0
uf-holypower-rune2-active,17352,2141,24,22,323,347,348,370,20787,0,0,0,0
uf-holypower-rune2-blur,17353,2141,16,19,323,339,491,510,20788,0,0,0,0
uf-holypower-rune2-fx,17355,2141,35,24,1,36,485,509,20790,0,0,0,0
uf-holypower-rune2-glow,17356,2141,27,25,165,192,475,500,20791,0,0,0,0
uf-holypower-rune2-ready,17357,2141,24,22,323,347,372,394,20792,0,0,0,0
uf-holypower-rune2,17358,2141,20,16,475,495,240,256,20793,0,0,0,0
uf-holypower-rune3-active,17359,2141,23,21,323,346,421,442,20794,0,0,0,0
uf-holypower-rune3-blur,17360,2141,15,19,349,364,416,435,20795,0,0,0,0
uf-holypower-rune3-fx,17362,2141,28,24,194,222,475,499,20797,0,0,0,0
uf-holypower-rune3-glow,17363,2141,26,25,245,271,475,500,20798,0,0,0,0
uf-holypower-rune3-ready,17364,2141,23,21,323,346,444,465,20799,0,0,0,0
uf-holypower-rune3,17365,2141,17,15,349,366,437,452,20800,0,0,0,0
uf-holypower-rune4-active,17366,2141,21,22,323,344,467,489,20801,0,0,0,0
uf-holypower-rune4-blur,17367,2141,13,18,495,508,328,346,20802,0,0,0,0
uf-holypower-rune4-fx,17369,2141,24,25,273,297,475,500,20804,0,0,0,0
uf-holypower-rune4-glow,17370,2141,24,25,475,499,213,238,20805,0,0,0,0
uf-holypower-rune4-ready,17371,2141,21,22,349,370,348,370,20806,0,0,0,0
uf-holypower-rune4,17372,2141,15,16,495,510,283,299,20807,0,0,0,0
uf-holypower-rune5-active,17373,2141,22,23,299,321,475,498,20808,0,0,0,0
uf-holypower-rune5-blur,17374,2141,15,20,349,364,394,414,20809,0,0,0,0
uf-holypower-rune5-fx,17376,2141,28,25,70,98,485,510,20811,0,0,0,0
uf-holypower-rune5-glow,17377,2141,26,26,128,154,485,511,20812,0,0,0,0
uf-holypower-rune5-ready,17378,2141,22,23,323,345,396,419,20813,0,0,0,0
uf-holypower-rune5,17379,2141,18,16,475,493,328,344,20814,0,0,0,0
uf-holypower-runeholder-active,17380,2141,150,43,165,315,430,473,20815,0,0,0,0
uf-holypower-runeholder-glow,17381,2141,150,43,323,473,213,256,20816,0,0,0,0
uf-holypower-runeholder-ready,17382,2141,150,43,323,473,258,301,20817,0,0,0,0
uf-holypower-runeholder-thinglow,17383,2141,150,43,323,473,303,346,20818,0,0,0,0
uf-holypower-runeholder,17384,2141,150,43,1,151,440,483,20819,0,0,0,0
transmog-background-race-dracthyr,17385,2142,294,494,1,295,1,495,20820,0,0,0,0
ui-hud-unitframe-player-portraiton-vehicle,17386,2060,202,84,1,203,1,85,20821,0,0,0,0
ui-hud-unitframe-target-portraiton-vehicle,17387,2060,198,81,608,806,1,82,20822,0,0,0,0
elementalstorm-boss-air,17389,647,128,128,1,129,1,129,20824,64,64,0,0
elementalstorm-boss-earth,17390,647,128,128,131,259,1,129,20825,64,64,0,0
elementalstorm-boss-fire,17391,647,128,128,261,389,1,129,20826,64,64,0,0
elementalstorm-boss-water,17392,647,128,128,391,519,1,129,20827,64,64,0,0
elementalstorm-lesser-air,17393,647,64,64,1,65,597,661,20828,38,38,0,0
elementalstorm-lesser-earth,17394,647,64,64,1,65,663,727,20829,38,38,0,0
elementalstorm-lesser-fire,17395,647,64,64,1,65,729,793,20830,38,38,0,0
elementalstorm-lesser-water,17396,647,64,64,1,65,795,859,20831,38,38,0,0
talents-animations-mask-full,17397,2144,1024,1024,0,1024,0,1024,20832,0,0,16,0
talents-animations-sheen,17398,2145,1612,774,1,1613,777,1551,20833,0,0,0,0
professions-specializations-background-blacksmithing,17407,2154,708,522,1,709,1,523,20842,0,0,0,0
professions-specializations-background-alchemy,17408,2155,708,522,1,709,1,523,20843,0,0,0,0
professions-specializations-background-cooking,17409,2156,708,522,1,709,1,523,20844,0,0,0,0
professions-specializations-background-enchanting,17410,2157,708,522,1,709,1,523,20845,0,0,0,0
professions-specializations-background-engineering,17411,2158,708,522,1,709,1,523,20846,0,0,0,0
professions-specializations-background-fishing,17412,2159,708,522,1,709,1,523,20847,0,0,0,0
professions-specializations-background-herbalism,17413,2160,708,522,1,709,1,523,20848,0,0,0,0
professions-specializations-background-inscription,17414,2161,708,522,1,709,1,523,20849,0,0,0,0
professions-specializations-background-jewelcrafting,17415,2162,708,522,1,709,1,523,20850,0,0,0,0
professions-specializations-background-leatherworking,17416,2163,708,522,1,709,1,523,20851,0,0,0,0
professions-specializations-background-skinning,17417,2164,708,522,1,709,1,523,20852,0,0,0,0
professions-specializations-background-tailoring,17418,2165,708,522,1,709,1,523,20853,0,0,0,0
professions-specializations-background-mining,17419,2166,708,522,1,709,1,523,20854,0,0,0,0
professions-qualitybar-barbgx2-tier1,17420,1933,372,52,1414,1786,1,53,20855,0,0,0,0
professions-qualitybar-barbgx2-tier2,17421,1933,372,52,1,373,56,108,20856,0,0,0,0
professions-qualitybar-barbgx2-tier3,17422,1933,372,52,622,994,56,108,20857,0,0,0,0
professions-qualitybar-barbgx2-tier4,17423,1933,372,52,271,643,110,162,20858,0,0,0,0
professions-qualitybar-dividerglow,17424,1933,26,52,2018,2044,1,53,20859,0,0,0,0
quality-barfill-flipbook-t1-x2,17425,2167,1497,810,1,1498,1,811,20860,0,0,0,0
gemappear_t1_flipbook,17426,2167,248,186,1,249,813,999,20861,0,0,0,0
gemdissolve_t1_flipbook,17427,2167,288,486,1500,1788,1,487,20862,0,0,0,0
gemappear_t2_flipbook,17428,2168,248,186,1,249,813,999,20863,0,0,0,0
gemdissolve_t2_flipbook,17429,2168,288,486,1500,1788,1,487,20864,0,0,0,0
quality-barfill-flipbook-t2-x2,17430,2168,1497,810,1,1498,1,811,20865,0,0,0,0
gemappear_t3_flipbook,17431,2169,248,186,1,249,813,999,20866,0,0,0,0
gemdissolve_t3_flipbook,17432,2169,288,486,1500,1788,1,487,20867,0,0,0,0
quality-barfill-flipbook-t3-x2,17433,2169,1497,810,1,1498,1,811,20868,0,0,0,0
gemappear_t4_flipbook,17434,2170,248,186,1,249,813,999,20869,0,0,0,0
gemdissolve_t4_flipbook,17435,2170,288,486,1500,1788,1,487,20870,0,0,0,0
quality-barfill-flipbook-t4-x2,17436,2170,1497,810,1,1498,1,811,20871,0,0,0,0
quality-barfill-flipbook-t5-x2,17437,2171,1497,810,1,1498,1,811,20872,0,0,0,0
dragonflight-landingpage-talentbutton-hover,17458,2133,400,476,1,401,479,955,20877,0,0,0,0
dragonflight-landingpage-talentbutton,17459,2133,400,476,1,401,1,477,20878,0,0,0,0
header-horizontal-rule,17460,2133,671,9,913,1584,649,658,20879,0,0,0,0
professions-qualitybar-dividershadow,17461,1933,3,52,2013,2016,1,53,20883,0,0,0,0
professions-qualitybar-flare,17462,1933,26,131,1,27,684,815,20884,0,0,0,0
professions-qualitywindow-background,17463,1933,322,184,271,593,164,348,20885,0,0,0,0
expeditiontalents-background,17467,2174,382,508,1,383,1,509,20889,0,0,0,0
professions-specializations-background-footer,17475,1933,1143,53,1,1144,1,54,20897,0,0,0,0
professions-specializations-divider,17476,1933,2,518,1072,1074,164,682,20898,0,0,0,0
ui-hud-unitframe-target-portraiton-boss-rare,17480,2130,26,26,83,109,120,146,20902,20,20,0,0
ui-hud-unitframe-target-portraiton-boss-rare-2x,17481,2131,52,52,163,215,235,287,20902,40,40,0,0
talents-animations-clouds,17482,2145,1612,774,1,1613,1,775,20904,0,0,0,0
professions-qualitybar-highlight-t1,17483,2167,372,52,251,623,813,865,20905,0,0,0,0
professions-qualitybar-highlight-t2,17484,2168,372,52,251,623,813,865,20906,0,0,0,0
professions-qualitybar-highlight-t3,17485,2169,372,52,251,623,813,865,20907,0,0,0,0
professions-qualitybar-highlight-t4,17486,2170,372,52,251,623,813,865,20908,0,0,0,0
professions-qualitybar-highlight-t5,17487,2171,372,52,251,623,813,865,20909,0,0,0,0
chromietime-portrait-large-shadowlands,17488,1565,489,254,404,893,513,767,20910,0,0,0,0
chromietime-portrait-small-shadowlands,17489,1565,312,173,1,313,1749,1922,20911,0,0,0,0
talents-animations-mask-filigree,17490,2178,2048,1024,0,2048,0,1024,20912,0,0,16,0
talents-animations-mask-specart,17491,2179,2048,1024,0,2048,0,1024,20913,0,0,16,0
dragonflight-majorfactions-centaur-background,17492,2180,820,578,1,821,1,579,20914,0,0,0,0
dragonflight-majorfactions-valdrakken-background,17493,2181,820,578,1,821,1,579,20915,0,0,0,0
dragonflight-majorfactions-expedition-background,17494,2182,820,578,1,821,1,579,20916,0,0,0,0
dragonflight-majorfactions-tuskarr-background,17495,2183,820,578,1,821,1,579,20917,0,0,0,0
ui-centaur-headerorb-level0,17496,2184,182,220,693,875,265,485,20893,0,0,0,0
ui-centaur-headerorb,17497,2184,182,220,803,985,1,221,20894,0,0,0,0
ui-centaur-highlight-bottom,17498,2184,798,228,1,799,567,795,20918,0,0,0,0
ui-centaur-highlight-middle,17499,2184,800,262,1,801,1,263,20919,0,0,0,0
ui-centaur-highlight-top,17500,2184,690,300,1,691,265,565,20920,0,0,0,0
ui-centaur-reward-slate,17501,2184,470,140,1,471,797,937,20895,0,0,0,0
ui-valdrakken-headerorb-level0,17502,2185,182,220,693,875,265,485,20899,0,0,0,0
ui-valdrakken-headerorb,17503,2185,182,220,803,985,1,221,20900,0,0,0,0
ui-valdrakken-highlight-bottom,17504,2185,798,228,1,799,567,795,20921,0,0,0,0
ui-valdrakken-highlight-middle,17505,2185,800,262,1,801,1,263,20922,0,0,0,0
ui-valdrakken-highlight-top,17506,2185,690,300,1,691,265,565,20923,0,0,0,0
ui-valdrakken-reward-slate,17507,2185,470,140,1,471,797,937,20901,0,0,0,0
ui-tuskarr-headerorb-level0,17508,2186,182,220,693,875,265,485,20886,0,0,0,0
ui-tuskarr-headerorb,17509,2186,182,220,803,985,1,221,20887,0,0,0,0
ui-tuskarr-highlight-bottom,17510,2186,798,228,1,799,567,795,20924,0,0,0,0
ui-tuskarr-highlight-middle,17511,2186,800,262,1,801,1,263,20925,0,0,0,0
ui-tuskarr-highlight-top,17512,2186,690,300,1,691,265,565,20926,0,0,0,0
ui-tuskarr-reward-slate,17513,2186,470,140,1,471,797,937,20888,0,0,0,0
ui-expedition-headerorb-level0,17514,2187,182,220,693,875,265,485,20890,0,0,0,0
ui-expedition-headerorb,17515,2187,182,220,803,985,1,221,20891,0,0,0,0
ui-expedition-highlight-bottom,17516,2187,798,228,1,799,567,795,20927,0,0,0,0
ui-expedition-highlight-middle,17517,2187,800,262,1,801,1,263,20928,0,0,0,0
ui-expedition-highlight-top,17518,2187,690,300,1,691,265,565,20929,0,0,0,0
ui-expedition-reward-slate,17519,2187,470,140,1,471,797,937,20892,0,0,0,0
ui-hud-unitframe-target-portraiton-incombat,17520,2060,188,67,1,189,436,503,20930,0,0,0,0
covenantsanctum-renown-doublearrow-depressed,17521,1738,48,67,825,873,206,273,20931,0,0,0,0
covenantsanctum-renown-doublearrow-disabled,17522,1738,48,67,875,923,68,135,20932,0,0,0,0
covenantsanctum-renown-doublearrow-hover,17523,1738,48,67,925,973,68,135,20933,0,0,0,0
covenantsanctum-renown-doublearrow,17524,1738,48,67,825,873,137,204,20934,0,0,0,0
professions-results-bracket,17599,1933,10,19,1241,1251,29,48,20971,0,0,0,0
talents-search-notonactionbar,17601,1970,126,126,629,755,821,947,20973,63,63,0,0
dragonriding_vigor_background-2x,17602,2188,61,71,373,434,120,191,20974,0,0,0,0
dragonriding_vigor_decor-2x,17603,2188,93,117,299,392,1,118,20975,0,0,0,0
dragonriding_vigor_fill-2x,17604,2188,72,72,394,466,1,73,20976,0,0,0,0
dragonriding_vigor_flash-2x,17605,2188,120,130,1,121,373,503,20977,0,0,0,0
dragonriding_vigor_frame-2x,17606,2188,120,130,123,243,373,503,20978,0,0,0,0
dragonriding_vigor_spark-2x,17607,2188,93,20,394,487,75,95,20979,0,0,0,0
greatvault-dragonflight-32x32,17608,647,32,32,649,681,409,441,20980,24,24,0,0
professions-recrafting-panel,17609,1933,187,81,74,261,926,1007,20981,0,0,0,0
professions-recrafting-frame-empty,17610,1933,100,100,74,174,824,924,20982,0,0,0,0
professions-recrafting-frame-item,17611,1933,100,100,131,231,684,784,20983,0,0,0,0
professions_specialization_arrowhead,17613,1933,12,12,1807,1819,29,41,20985,0,0,0,0
talents-node-square-sheenmask,17614,2190,128,128,0,128,0,128,20986,64,64,16,0
talents-node-circle-sheenmask,17615,2191,64,64,0,64,0,64,20987,0,0,16,0
talents-node-choice-sheenmask,17616,2192,128,128,0,128,0,128,20988,64,64,16,0
talents-node-choiceflyout-circle-sheenmask,17617,2193,64,64,0,64,0,64,20989,0,0,16,0
talents-node-choiceflyout-square-sheenmask,17618,2194,128,128,0,128,0,128,20990,64,64,16,0
redbutton-condense-disabled,17620,2196,18,19,1,19,22,41,20572,0,0,0,0
redbutton-condense-pressed,17621,2196,18,19,1,19,43,62,20573,0,0,0,0
redbutton-condense,17622,2196,18,19,1,19,1,20,20571,0,0,0,0
redbutton-exit-disabled,17623,2196,18,19,21,39,22,41,20575,0,0,0,0
redbutton-exit-pressed,17624,2196,18,19,21,39,43,62,20576,0,0,0,0
redbutton-exit,17625,2196,18,19,21,39,1,20,20574,0,0,0,0
redbutton-expand-disabled,17626,2196,18,19,41,59,22,41,20578,0,0,0,0
redbutton-expand-pressed,17627,2196,18,19,41,59,43,62,20579,0,0,0,0
redbutton-expand,17628,2196,18,19,41,59,1,20,20577,0,0,0,0
redbutton-highlight,17629,2196,18,19,61,79,1,20,20580,0,0,0,0
redbutton-minicondense-disabled,17630,2196,18,19,61,79,43,62,20582,0,0,0,0
redbutton-minicondense-pressed,17631,2196,18,19,81,99,1,20,20583,0,0,0,0
redbutton-minicondense,17632,2196,18,19,61,79,22,41,20581,0,0,0,0
bags-item-bankslot64-2x,17633,2197,64,64,0,64,0,64,20993,0,0,6,0
professions_tracking_fish,17634,647,32,32,615,647,477,509,20994,0,0,0,0
professions_tracking_herb,17635,647,32,32,649,681,477,509,20995,0,0,0,0
professions_tracking_ore,17636,647,32,32,683,715,477,509,20996,0,0,0,0
talents-animations-mask-specart-mid,17637,2198,2048,1024,0,2048,0,1024,20997,0,0,16,0
talents-animations-particles,17638,2199,1308,774,1,1309,777,1551,20998,0,0,0,0
talents-animations-activationgrid,17639,2199,1612,774,1,1613,1,775,20999,0,0,0,0
squaremask,17654,2200,64,64,0,64,0,64,21007,0,0,16,0
splash-1002-botleft,17658,2202,137,371,374,511,587,958,21011,0,0,0,0
splash-1002-right,17659,2202,510,584,1,511,1,585,21012,0,0,0,0
splash-1002-topleft,17660,2202,371,434,1,372,587,1021,21013,0,0,0,0
dragonriding_vigor_mask-2x,17664,2204,128,128,0,128,0,128,21017,0,0,16,0
professions-specialization-node-emptypath,17665,1933,128,128,274,402,711,839,21018,0,0,0,0
professions-specialization-node-selectedglow,17666,1933,78,78,274,352,631,709,21019,0,0,0,0
professions-currency-shadow,17707,1933,151,25,427,578,56,81,21031,0,0,0,0
tab-divider-top,17712,2215,16,16,0,16,1,17,21033,0,0,4,0
dragon-rostrum,17713,647,32,32,377,409,749,781,21034,0,0,0,0
talents-animations-mask-filigree-activate,17714,2216,2048,1024,0,2048,0,1024,21035,0,0,16,0
talents-animations-gridburst,17715,2217,1024,1024,1,1025,1,1025,21036,0,0,0,0
professions-qualitybar-marker-left,17716,1933,26,37,1,27,856,893,21037,0,0,0,0
professions-qualitybar-marker-right,17717,1933,26,37,1,27,817,854,21038,0,0,0,0
talents-animations-class-druid,17718,2217,461,461,1027,1488,464,925,21039,0,0,0,0
talents-animations-class-deathknight,17719,2217,461,461,1027,1488,1,462,21040,0,0,0,0
talents-animations-class-demonhunter,17720,2217,461,461,1490,1951,1,462,21041,0,0,0,0
talents-animations-class-hunter,17722,2217,461,461,1490,1951,464,925,21043,0,0,0,0
talents-animations-class-mage,17723,2217,461,461,1,462,1027,1488,21044,0,0,0,0
talents-animations-class-monk,17724,2217,461,461,1,462,1490,1951,21045,0,0,0,0
talents-animations-class-paladin,17725,2217,461,461,464,925,1027,1488,21046,0,0,0,0
talents-animations-class-priest,17726,2217,461,461,464,925,1490,1951,21047,0,0,0,0
talents-animations-class-rogue,17727,2217,461,461,927,1388,1027,1488,21048,0,0,0,0
talents-animations-class-shaman,17728,2217,461,461,927,1388,1490,1951,21049,0,0,0,0
talents-animations-class-warlock,17729,2217,461,461,1390,1851,1027,1488,21050,0,0,0,0
talents-animations-class-warrior,17730,2217,461,461,1390,1851,1490,1951,21051,0,0,0,0
ui-hud-unitframe-target-minusmob-portraiton-incombat,17735,2060,188,67,1,189,367,434,21056,0,0,0,0
ui-hud-unitframe-target-minusmob-portraiton-status,17736,2060,193,69,787,980,87,156,21057,0,0,0,0
ui-hud-unitframe-targetoftarget-portraiton-incombat,17737,2060,114,47,574,688,160,207,21058,0,0,0,0
ui-hud-unitframe-targetoftarget-portraiton-status,17738,2060,120,49,452,572,160,209,21059,0,0,0,0
talents-animations-class-evoker,17739,2199,461,461,1311,1772,777,1238,21042,0,0,0,0
battlenet-clienticon-pro,17740,1972,32,32,171,203,69,101,18636,0,0,0,0
battlenet-clienticon-pro-zhcn,17741,1972,32,32,205,237,69,101,21062,0,0,0,0
ui-chaticon-pro,17742,1971,32,32,171,203,69,101,18615,0,0,0,0
ui-chaticon-pro-zhcn,17743,1971,32,32,205,237,69,101,21061,0,0,0,0
ui-hud-unitframe-party-portraiton-bar-energy,17744,2087,74,7,70,144,179,186,21063,0,0,0,0
ui-hud-unitframe-party-portraiton-bar-focus,17745,2087,74,7,146,220,179,186,21064,0,0,0,0
ui-hud-unitframe-party-portraiton-bar-health-status,17746,2087,70,10,73,143,167,177,21065,0,0,0,0
ui-hud-unitframe-party-portraiton-bar-health,17747,2087,70,10,1,71,167,177,21066,0,0,0,0
ui-hud-unitframe-party-portraiton-bar-mana,17748,2087,74,7,1,75,191,198,21067,0,0,0,0
ui-hud-unitframe-party-portraiton-bar-rage,17749,2087,74,7,153,227,191,198,21068,0,0,0,0
ui-hud-unitframe-party-portraiton-bar-runicpower,17750,2087,74,7,1,75,200,207,21069,0,0,0,0
ui-hud-unitframe-party-portraiton-incombat,17751,2087,114,47,123,237,116,163,21070,0,0,0,0
ui-hud-unitframe-party-portraiton-status,17752,2087,120,49,1,121,116,165,21071,0,0,0,0
ui-hud-unitframe-party-portraiton-vehicle-bar-energy,17753,2087,70,7,77,147,200,207,21072,0,0,0,0
ui-hud-unitframe-party-portraiton-vehicle-bar-focus,17754,2087,70,7,149,219,200,207,21073,0,0,0,0
ui-hud-unitframe-party-portraiton-vehicle-bar-health,17755,2087,67,10,145,212,167,177,21074,0,0,0,0
ui-hud-unitframe-party-portraiton-vehicle-bar-mana,17756,2087,70,7,1,71,209,216,21075,0,0,0,0
ui-hud-unitframe-party-portraiton-vehicle-bar-rage,17757,2087,70,7,145,215,209,216,21076,0,0,0,0
ui-hud-unitframe-party-portraiton-vehicle-bar-runicpower,17758,2087,70,7,1,71,218,225,21077,0,0,0,0
ui-hud-unitframe-party-portraiton-vehicle-bar-status,17759,2087,67,10,1,68,179,189,21078,0,0,0,0
ui-hud-unitframe-party-portraiton-vehicle-incombat,17760,2087,120,57,1,121,57,114,21079,0,0,0,0
ui-hud-unitframe-party-portraiton-vehicle,17761,2087,121,50,133,254,1,51,21080,0,0,0,0
ui-hud-unitframe-party-portraiton,17762,2087,120,49,123,243,57,106,21081,0,0,0,0
ui-hud-unitframe-party-portraiton-bar-mana-mask,17763,2218,128,16,0,128,0,16,21082,0,0,16,0
ui-hud-unitframe-party-portraiton-bar-health-mask,17764,2219,128,16,0,128,0,16,21083,0,0,16,0
talents-animations-titans,17765,2220,972,810,245,1217,1,811,21084,0,0,0,0
talents-arrow-head-ghost,17766,1970,28,24,2012,2040,85,109,21085,14,12,0,0
charactercreate-customize-dropdown-icon-lock,17767,708,30,43,389,419,1777,1820,21086,8,12,0,0
gemappear_t5_flipbook,17769,2171,248,186,1,249,813,999,21087,0,0,0,0
ui-tuskarr-rewardframe,17771,2186,128,128,877,1005,265,393,21089,0,0,0,0
ui-expedition-rewardframe,17772,2187,128,128,877,1005,265,393,21090,0,0,0,0
ui-centaur-rewardframe,17773,2184,128,128,877,1005,265,393,21091,0,0,0,0
ui-valdrakken-rewardframe,17774,2185,128,128,877,1005,265,393,21092,0,0,0,0
majorfaction-celebration-toastbg,17814,2222,275,77,238,513,113,190,21132,0,0,0,0
majorfaction-celebration-centaur,17815,2222,235,110,1,236,1,111,21133,0,0,0,0
majorfaction-celebration-valdrakken,17816,2222,235,110,1,236,225,335,21134,0,0,0,0
majorfaction-celebration-bottomglowline,17817,2222,266,19,515,781,140,159,21135,0,0,0,0
majorfaction-celebration-expedition,17818,2222,235,110,475,710,1,111,21136,0,0,0,0
majorfaction-celebration-content-ring,17819,2222,128,128,238,366,192,320,21137,0,0,0,0
majorfaction-celebration-tuskarr,17820,2222,235,110,1,236,113,223,21138,0,0,0,0
ui-hud-unitframe-player-portraiton-vehicle-incombat,17821,2060,198,84,408,606,1,85,21139,0,0,0,0
ui-hud-unitframe-player-portraiton-vehicle-status,17822,2060,201,84,205,406,1,85,21140,0,0,0,0
ui-hud-unitframe-target-portraiton-boss-iconring,18002,2130,26,26,219,245,1,27,21229,20,20,0,0
dragonflight-landingbutton-circleglow,18092,2226,100,100,1,101,1,101,21260,0,0,0,0
dragonflight-landingbutton-circlehighlight,18093,2226,100,100,103,203,1,101,21261,0,0,0,0
dragonflight-landingbutton-down,18094,2226,100,100,1,101,103,203,21262,0,0,0,0
dragonflight-landingbutton-up,18095,2226,100,100,103,203,103,203,21263,0,0,0,0
questbg-trading-post,18096,2221,299,407,1,300,1,408,21093,0,0,0,0
ui-hud-unitframe-target-boss-small-portraitoff-bar-energy,18099,2130,84,7,171,255,108,115,21266,0,0,0,0
ui-hud-unitframe-target-boss-small-portraitoff-bar-focus,18100,2130,84,7,111,195,120,127,21267,0,0,0,0
ui-hud-unitframe-target-boss-small-portraitoff-bar-health-status,18101,2130,84,10,171,255,96,106,21268,0,0,0,0
ui-hud-unitframe-target-boss-small-portraitoff-bar-health,18102,2130,84,10,171,255,84,94,21269,0,0,0,0
ui-hud-unitframe-target-boss-small-portraitoff-bar-mana-status,18103,2130,84,7,111,195,138,145,21270,0,0,0,0
ui-hud-unitframe-target-boss-small-portraitoff-bar-mana,18104,2130,84,7,111,195,129,136,21271,0,0,0,0
ui-hud-unitframe-target-boss-small-portraitoff-bar-rage,18105,2130,84,7,111,195,147,154,21272,0,0,0,0
ui-hud-unitframe-target-boss-small-portraitoff-bar-runicpower,18106,2130,84,7,111,195,156,163,21273,0,0,0,0
ui-hud-unitframe-target-boss-small-portraitoff-type,18107,2130,85,18,102,187,59,77,21274,0,0,0,0
ui-hud-unitframe-target-boss-small-portraitoff,18108,2130,115,56,102,217,1,57,21275,0,0,0,0
professions-results-inspiredcreation,18109,1933,298,76,274,572,553,629,20972,0,0,0,0
dragonflight-landingpage-radial-expedition,18110,2133,96,96,1933,2029,163,259,22149,86,86,0,0
dragonflight-landingpage-radial-frame,18111,2133,96,96,1933,2029,325,421,21277,86,86,0,0
dragonflight-landingpage-radial-centaur,18112,2133,96,96,1933,2029,1,97,22150,86,86,0,0
dragonflight-landingpage-radial-tuskarr,18113,2133,96,96,403,499,811,907,21279,86,86,0,0
dragonflight-landingpage-radial-valdrakken,18114,2133,96,96,403,499,909,1005,21280,86,86,0,0
ui-hud-unitframe-target-boss-small-portraitoff-incombat,18115,2130,86,34,83,169,84,118,21281,0,0,0,0
ui-centaur-headerfill,18116,2184,182,220,801,983,567,787,21282,0,0,0,0
ui-expedition-headerfill,18117,2187,182,220,801,983,567,787,21283,0,0,0,0
ui-tuskarr-headerfill,18118,2186,182,220,801,983,567,787,21284,0,0,0,0
ui-valdrakken-headerfill,18119,2185,182,220,801,983,567,787,21285,0,0,0,0
ui-hud-unitframe-party-portraitoff-bar-mana-mask,18120,2095,128,16,0,128,0,16,21286,0,0,16,0
ui-hud-unitframe-party-portraitoff-bar-health-mask,18121,2096,128,16,0,128,0,16,21287,0,0,16,0
ui-hud-unitframe-party-portraiton-vehicle-status,18122,2087,130,54,1,131,1,55,21288,0,0,0,0
dragonriding_vigor_fillfull-2x,18123,2188,72,72,299,371,120,192,21407,0,0,0,0
uf-chi-bg-2x,18124,2223,50,50,447,497,82,132,21246,0,0,0,0
uf-chi-bg-active-2x,18125,2223,50,50,447,497,134,184,21245,0,0,0,0
uf-chi-fx-1-2x,18126,2223,28,28,477,505,186,214,21247,0,0,0,0
uf-chi-fx-2-2x,18127,2223,28,28,1,29,341,369,21248,0,0,0,0
uf-chi-fx-3-2x,18128,2223,28,28,31,59,341,369,21249,0,0,0,0
uf-chi-fx-bgglow-2x,18129,2223,70,70,1,71,219,289,21250,0,0,0,0
uf-chi-fx-deplete-2x,18130,2223,28,28,1,29,371,399,21251,0,0,0,0
uf-chi-fx-smoke-2x,18131,2223,39,79,447,486,1,80,21257,0,0,0,0
uf-chi-icon-2x,18132,2223,28,28,31,59,371,399,21258,0,0,0,0
uf-chi-orbgleam-2x,18133,2223,28,29,447,475,186,215,21259,0,0,0,0
uf-chi-outerglow-2x,18134,2223,48,48,1,49,291,339,21252,0,0,0,0
uf-chi-windfx-2x,18135,2223,444,216,1,445,1,217,21253,0,0,0,0
loottoast-itemborder-gray,18136,332,58,58,279,337,420,478,21290,0,0,0,0
loottoast-dragonriding,18137,332,281,115,1,282,1,116,21291,0,0,0,0
gamepad_gen_1_64,18184,2227,64,64,1,65,1,65,21293,0,0,0,0
gamepad_gen_2_64,18185,2227,64,64,67,131,1,65,21294,0,0,0,0
gamepad_gen_3_64,18186,2227,64,64,133,197,1,65,21295,0,0,0,0
gamepad_gen_4_64,18187,2227,64,64,199,263,1,65,21296,0,0,0,0
gamepad_gen_5_64,18188,2227,64,64,265,329,1,65,21297,0,0,0,0
gamepad_gen_6_64,18189,2227,64,64,331,395,1,65,21298,0,0,0,0
gamepad_gen_back_64,18190,2227,64,64,397,461,1,65,21299,0,0,0,0
gamepad_gen_down_64,18191,2227,64,64,1,65,67,131,21300,0,0,0,0
gamepad_gen_forward_64,18192,2227,64,64,1,65,133,197,21301,0,0,0,0
gamepad_gen_left_64,18193,2227,64,64,1,65,199,263,21302,0,0,0,0
gamepad_gen_lshoulder_64,18194,2227,64,64,1,65,265,329,21303,0,0,0,0
gamepad_gen_lstickdown_64,18195,2227,64,64,1,65,331,395,21304,0,0,0,0
gamepad_gen_lstickin_64,18196,2227,64,64,1,65,397,461,21305,0,0,0,0
gamepad_gen_lstickleft_64,18197,2227,64,64,67,131,67,131,21306,0,0,0,0
gamepad_gen_lstickright_64,18198,2227,64,64,133,197,67,131,21307,0,0,0,0
gamepad_gen_lstickup_64,18199,2227,64,64,199,263,67,131,21308,0,0,0,0
gamepad_gen_ltrigger_64,18200,2227,64,64,265,329,67,131,21309,0,0,0,0
gamepad_gen_paddle1_64,18201,2227,64,64,331,395,67,131,21310,0,0,0,0
gamepad_gen_paddle2_64,18202,2227,64,64,397,461,67,131,21311,0,0,0,0
gamepad_gen_paddle3_64,18203,2227,64,64,67,131,133,197,21312,0,0,0,0
gamepad_gen_paddle4_64,18204,2227,64,64,67,131,199,263,21313,0,0,0,0
gamepad_gen_right_64,18205,2227,64,64,67,131,265,329,21314,0,0,0,0
gamepad_gen_rshoulder_64,18206,2227,64,64,67,131,331,395,21315,0,0,0,0
gamepad_gen_rstickdown_64,18207,2227,64,64,67,131,397,461,21316,0,0,0,0
gamepad_gen_rstickin_64,18208,2227,64,64,133,197,133,197,21317,0,0,0,0
gamepad_gen_rstickleft_64,18209,2227,64,64,199,263,133,197,21318,0,0,0,0
gamepad_gen_rstickright_64,18210,2227,64,64,265,329,133,197,21319,0,0,0,0
gamepad_gen_rstickup_64,18211,2227,64,64,331,395,133,197,21320,0,0,0,0
gamepad_gen_rtrigger_64,18212,2227,64,64,397,461,133,197,21321,0,0,0,0
gamepad_gen_share_64,18213,2227,64,64,133,197,199,263,21322,0,0,0,0
gamepad_gen_system_64,18214,2227,64,64,133,197,265,329,21323,0,0,0,0
gamepad_gen_up_64,18215,2227,64,64,133,197,331,395,21324,0,0,0,0
gamepad_ltr_a_64,18275,2231,64,64,1,65,1,65,21325,0,0,0,0
gamepad_ltr_b_64,18276,2231,64,64,1,65,67,131,21326,0,0,0,0
gamepad_ltr_down_64,18277,2231,64,64,1,65,133,197,21327,0,0,0,0
gamepad_ltr_left_64,18278,2231,64,64,67,131,1,65,21328,0,0,0,0
gamepad_ltr_lshoulder_64,18279,2231,64,64,67,131,67,131,21329,0,0,0,0
gamepad_ltr_ltrigger_64,18280,2231,64,64,67,131,133,197,21330,0,0,0,0
gamepad_ltr_menu_64,18281,2231,64,64,133,197,1,65,21331,0,0,0,0
gamepad_ltr_right_64,18282,2231,64,64,133,197,67,131,21332,0,0,0,0
gamepad_ltr_rshoulder_64,18283,2231,64,64,133,197,133,197,21333,0,0,0,0
gamepad_ltr_rtrigger_64,18284,2231,64,64,199,263,1,65,21334,0,0,0,0
gamepad_ltr_share_64,18285,2231,64,64,199,263,67,131,21335,0,0,0,0
gamepad_ltr_system_64,18286,2231,64,64,199,263,133,197,21336,0,0,0,0
gamepad_ltr_up_64,18287,2231,64,64,265,329,1,65,21337,0,0,0,0
gamepad_ltr_view_64,18288,2231,64,64,331,395,1,65,21338,0,0,0,0
gamepad_ltr_x_64,18289,2231,64,64,397,461,1,65,21339,0,0,0,0
gamepad_ltr_y_64,18290,2231,64,64,265,329,67,131,21340,0,0,0,0
gamepad_rev_a_64,18291,2232,64,64,1,65,1,65,21361,0,0,0,0
gamepad_rev_b_64,18292,2232,64,64,1,65,67,131,21362,0,0,0,0
gamepad_rev_capture_64,18293,2232,64,64,1,65,133,197,21363,0,0,0,0
gamepad_rev_home_64,18294,2232,64,64,67,131,1,65,21364,0,0,0,0
gamepad_rev_lshoulder_64,18295,2232,64,64,67,131,67,131,21365,0,0,0,0
gamepad_rev_ltrigger_64,18296,2232,64,64,67,131,133,197,21366,0,0,0,0
gamepad_rev_minus_64,18297,2232,64,64,133,197,1,65,21367,0,0,0,0
gamepad_rev_plus_64,18298,2232,64,64,133,197,67,131,21368,0,0,0,0
gamepad_rev_rshoulder_64,18299,2232,64,64,133,197,133,197,21369,0,0,0,0
gamepad_rev_rtrigger_64,18300,2232,64,64,199,263,1,65,21370,0,0,0,0
gamepad_rev_x_64,18301,2232,64,64,199,263,67,131,21371,0,0,0,0
gamepad_rev_y_64,18302,2232,64,64,199,263,133,197,21372,0,0,0,0
gamepad_shp_circle_64,18303,2233,64,64,1,65,1,65,21341,0,0,0,0
gamepad_shp_cross_64,18304,2233,64,64,1,65,67,131,21342,0,0,0,0
gamepad_shp_down_64,18305,2233,64,64,1,65,133,197,21343,0,0,0,0
gamepad_shp_left_64,18306,2233,64,64,67,131,1,65,21344,0,0,0,0
gamepad_shp_lshoulder_64,18307,2233,64,64,67,131,67,131,21345,0,0,0,0
gamepad_shp_lstickin_64,18308,2233,64,64,67,131,133,197,21346,0,0,0,0
gamepad_shp_ltrigger_64,18309,2233,64,64,133,197,1,65,21347,0,0,0,0
gamepad_shp_menu_64,18310,2233,64,64,133,197,67,131,21348,0,0,0,0
gamepad_shp_micmute_64,18311,2233,64,64,133,197,133,197,21349,0,0,0,0
gamepad_shp_right_64,18312,2233,64,64,199,263,1,65,21350,0,0,0,0
gamepad_shp_rshoulder_64,18313,2233,64,64,199,263,67,131,21351,0,0,0,0
gamepad_shp_rstickin_64,18314,2233,64,64,199,263,133,197,21352,0,0,0,0
gamepad_shp_rtrigger_64,18315,2233,64,64,265,329,1,65,21353,0,0,0,0
gamepad_shp_share_64,18316,2233,64,64,331,395,1,65,21354,0,0,0,0
gamepad_shp_square_64,18317,2233,64,64,397,461,1,65,21355,0,0,0,0
gamepad_shp_system_64,18318,2233,64,64,265,329,67,131,21356,0,0,0,0
gamepad_shp_touchpadl_64,18319,2233,64,64,265,329,133,197,21357,0,0,0,0
gamepad_shp_touchpadr_64,18320,2233,64,64,331,395,67,131,21358,0,0,0,0
gamepad_shp_triangle_64,18321,2233,64,64,397,461,67,131,21359,0,0,0,0
gamepad_shp_up_64,18322,2233,64,64,331,395,133,197,21360,0,0,0,0
,18324,2234,188,16,0,0,0,0,21032,0,0,0,0
professions_specialization_lock,18327,1933,64,80,274,338,841,921,21030,32,40,0,0
professions_specialization_lock_glow,18328,1933,64,80,274,338,923,1003,21373,32,40,0,0
professions-specializations-background-dial,18329,1933,475,525,595,1070,164,689,20896,0,0,0,0
ui-hud-experiencebar-background-2x,18371,1988,1126,18,1,1127,21,39,20607,0,0,0,0
ui-hud-experiencebar-fill-artifactpower-2x,18372,1988,1126,18,1,1127,1,19,20627,0,0,0,0
ui-hud-experiencebar-fill-experience-2x,18373,1988,1126,18,1,1127,41,59,20628,0,0,0,0
ui-hud-experiencebar-fill-honor-2x,18374,1988,1126,18,1,1127,121,139,20629,0,0,0,0
ui-hud-experiencebar-fill-prediction-2x,18375,1988,1126,18,1,1127,81,99,20608,0,0,0,0
ui-hud-experiencebar-fill-reputation-2x,18376,1988,1126,18,1,1127,61,79,20630,0,0,0,0
ui-hud-experiencebar-fill-reputation-faction-blue-2x,18377,1988,1126,18,1,1127,181,199,20647,0,0,0,0
ui-hud-experiencebar-fill-reputation-faction-green-2x,18378,1988,1126,18,1,1127,141,159,20632,0,0,0,0
ui-hud-experiencebar-fill-reputation-faction-orange-2x,18379,1988,1126,18,1,1127,161,179,20633,0,0,0,0
ui-hud-experiencebar-fill-reputation-faction-red-2x,18380,1988,1126,18,1,1127,237,255,20634,0,0,0,0
ui-hud-experiencebar-fill-reputation-faction-yellow-2x,18381,1988,563,9,1129,1692,1,10,20635,0,0,0,0
ui-hud-experiencebar-fill-rested-2x,18382,1988,1126,18,1,1127,101,119,20631,0,0,0,0
ui-hud-experiencebar-frame-2x,18383,1988,1142,34,1,1143,201,235,20612,0,0,0,0
ui-hud-experiencebar-frame-pip-2x,18384,1988,20,28,1171,1191,201,229,20611,0,0,0,0
ui-hud-experiencebar-frame-pip-mouseover-2x,18385,1988,24,28,1145,1169,201,229,20610,0,0,0,0
shop-card-full-a32a,18388,2236,568,463,1,569,1,464,21376,0,0,0,0
shop-card-full-a32n,18389,2236,568,463,1,569,466,929,21377,0,0,0,0
flightmaster_ancientwaygate-taxi_frame_gray,18391,2237,38,38,1,39,1,39,21379,0,0,0,0
flightmaster_ancientwaygate-taxi_frame_green,18392,2237,38,38,41,79,1,39,21380,0,0,0,0
flightmaster_ancientwaygate-taxi_frame_yellow,18393,2237,38,38,81,119,1,39,21381,0,0,0,0
skillbar_fill_flipbook_defaultblue,18397,1933,880,33,1076,1956,164,197,21392,0,0,0,0
specdial_fill_flipbook_defaultblue,18398,1933,329,328,727,1056,691,1019,21393,0,0,0,0
dragonriding-talents-background,18399,2238,604,777,1,605,1,778,21394,0,0,0,0
dragonriding-talents-line,18400,2238,500,8,1,501,780,788,21395,0,0,0,0
dragonriding-talents-currencybg,18401,2238,132,26,1,133,790,816,21396,0,0,0,0
ui-hud-unitframe-player-portraiton-bar-mana-status,18402,2060,124,10,773,897,301,311,21397,0,0,0,0
ui-hud-unitframe-target-minusmob-portraiton-bar-mana-status,18403,2060,127,10,792,919,277,287,21398,0,0,0,0
ui-hud-unitframe-targetoftarget-portraiton-bar-mana-status,18404,2060,74,7,525,599,267,274,21399,0,0,0,0
ui-hud-unitframe-target-portraiton-bar-mana-status,18405,2060,134,10,661,795,255,265,21400,0,0,0,0
ui-hud-unitframe-party-portraiton-bar-mana-status,18406,2087,74,7,77,151,191,198,21401,0,0,0,0
ui-hud-unitframe-party-portraiton-vehicle-bar-mana-status,18407,2087,70,7,73,143,209,216,21402,0,0,0,0
ui-hud-minimap-guildbanner-background-bottom,18408,2239,36,37,1,37,1,38,21403,0,0,0,0
ui-hud-minimap-guildbanner-background-top,18409,2239,36,37,1,37,40,77,21404,0,0,0,0
ui-hud-minimap-guildbanner-border-bottom,18410,2239,36,37,1,37,79,116,21405,0,0,0,0
ui-hud-minimap-guildbanner-border-top,18411,2239,36,37,39,75,1,38,21406,0,0,0,0
ui-hud-minimap-guildbanner-background-bottom-2x,18412,2240,71,73,1,72,1,74,21403,0,0,0,0
ui-hud-minimap-guildbanner-background-top-2x,18413,2240,71,73,1,72,76,149,21404,0,0,0,0
ui-hud-minimap-guildbanner-border-bottom-2x,18414,2240,71,73,1,72,151,224,21405,0,0,0,0
ui-hud-minimap-guildbanner-border-top-2x,18415,2240,71,73,74,145,1,74,21406,0,0,0,0
ui-hud-unitframe-target-portraiton-boss-iconring-2x,18416,2131,52,52,433,485,1,53,21229,40,40,0,0
ui-hud-unitframe-target-boss-small-portraitoff-2x,18417,2131,230,112,201,431,1,113,21275,0,0,0,0
ui-hud-unitframe-target-boss-small-portraitoff-bar-energy-2x,18418,2131,169,15,337,506,209,224,21266,0,0,0,0
ui-hud-unitframe-target-boss-small-portraitoff-bar-focus-2x,18419,2131,169,15,217,386,235,250,21267,0,0,0,0
ui-hud-unitframe-target-boss-small-portraitoff-bar-health-2x,18420,2131,169,20,337,506,165,185,21269,0,0,0,0
ui-hud-unitframe-target-boss-small-portraitoff-bar-health-status-2x,18421,2131,169,20,337,506,187,207,21268,0,0,0,0
ui-hud-unitframe-target-boss-small-portraitoff-bar-mana-2x,18422,2131,169,15,217,386,252,267,21271,0,0,0,0
ui-hud-unitframe-target-boss-small-portraitoff-bar-mana-status-2x,18423,2131,169,15,217,386,269,284,21270,0,0,0,0
ui-hud-unitframe-target-boss-small-portraitoff-bar-rage-2x,18424,2131,169,15,217,386,286,301,21272,0,0,0,0
ui-hud-unitframe-target-boss-small-portraitoff-bar-runicpower-2x,18425,2131,169,15,217,386,303,318,21273,0,0,0,0
ui-hud-unitframe-target-boss-small-portraitoff-incombat-2x,18450,2131,172,68,163,335,165,233,21281,0,0,0,0
ui-hud-unitframe-target-boss-small-portraitoff-type-2x,18451,2131,170,36,201,371,115,151,21274,0,0,0,0
streamcinematic-dragonflight-down,18452,557,176,78,357,533,81,159,21412,0,0,0,0
streamcinematic-dragonflight-up,18453,557,176,78,1,177,81,159,21413,0,0,0,0
minimap-genericevent-hornicon,18454,647,64,64,71,135,857,921,21414,40,40,0,0
ui-hud-minimap-guildbanner-heroic-large,18455,2239,16,16,77,93,20,36,21415,0,0,0,0
ui-hud-minimap-guildbanner-heroic-mini,18456,2239,10,11,39,49,40,51,21416,0,0,0,0
ui-hud-minimap-guildbanner-mythic-large,18457,2239,16,16,95,111,1,17,21417,0,0,0,0
ui-hud-minimap-guildbanner-mythic-mini,18458,2239,10,12,113,123,19,31,21418,0,0,0,0
ui-hud-minimap-guildbanner-heroic-large-2x,18459,2240,32,32,147,179,38,70,21415,0,0,0,0
ui-hud-minimap-guildbanner-mythic-large-2x,18460,2240,32,32,184,216,1,33,21417,0,0,0,0
recruitafriend_claimpane_parchment,18544,2248,325,94,371,696,1,95,11564,0,0,0,0
recruitafriend_rewardpane_parchment,18545,2248,368,454,1,369,1,455,11570,0,0,0,0
recruitafriend_splash_parchment,18546,2248,335,335,371,706,97,432,11588,0,0,0,0
recruitafriend_splash_picture,18547,2248,274,154,708,982,194,348,11586,0,0,0,0
recruitafriend_toast_fancy,18548,2248,274,95,708,982,97,192,11552,0,0,0,0
recruitafriend_toast_standard,18549,2248,276,92,698,974,1,93,11569,0,0,0,0
pvpqueue-chest-dragonflight-greatvault-collect,18550,1665,312,300,1,313,1,301,21499,156,150,0,0
pvpqueue-chest-dragonflight-greatvault-complete,18551,1665,312,300,315,627,1,301,21500,156,150,0,0
pvpqueue-chest-dragonflight-greatvault-incomplete,18552,1665,312,300,629,941,1,301,21501,156,150,0,0
mythicplus-dragonflight-greatvault-collect,18553,1244,390,344,895,1285,1,345,21502,195,172,0,0
mythicplus-dragonflight-greatvault-complete,18554,1244,390,344,1287,1677,1,345,21503,195,172,0,0
mythicplus-dragonflight-greatvault-incomplete,18555,1244,390,344,895,1285,347,691,21504,195,172,0,0
covenantsanctum-renown-hexagon-border-standard,18566,1738,55,65,718,773,68,133,21515,0,0,0,0
covenantsanctum-renown-hexagon-next-border-standard,18567,1738,55,65,718,773,202,267,21516,0,0,0,0
covenantsanctum-renown-icon-border-standard,18568,1738,55,65,775,830,1,66,21517,0,0,0,0
ui-hud-unitframe-party-portraiton-vehicle-bar-mana-mask,18569,2250,128,16,0,128,0,16,21518,0,0,16,0
covenantsanctum-renown-next-border-standard,18570,1738,55,65,889,944,1,66,21519,0,0,0,0
cast-empowered-pipflare-1x,18571,1964,6,30,1001,1007,69,99,21525,0,0,0,0
cast-empowered-pipflare-2x,18572,1964,10,68,486,496,268,336,21525,0,0,0,2
ui-castingbar-pip-1x_red,18573,1964,6,30,1009,1015,69,99,21526,0,0,0,0
ui-castingbar-pip-2x_red,18574,1964,10,60,933,943,176,236,21526,0,0,0,2
splash-1001-botleft,18583,2201,137,371,374,511,587,958,21008,0,0,0,0
splash-1001-right,18584,2201,510,584,1,511,1,585,21009,0,0,0,0
splash-1001-topleft,18585,2201,371,434,1,372,587,1021,21010,0,0,0,0
recruitafriend_friendslist_v3_icon,18586,2251,44,33,192,236,157,190,21527,0,0,0,0
recruitafriend_v3_iwatermark_big,18587,2251,115,90,1,116,157,247,21528,0,0,0,0
recruitafriend_v3_tab_icon,18588,2251,32,32,238,270,157,189,21529,0,0,0,0
recruitafriend_v3_watermark_medium,18589,2251,72,56,118,190,157,213,21530,0,0,0,0
recruitafriend_v3_watermark_small,18590,2251,45,35,118,163,215,250,21531,0,0,0,0
recruitafriend_friendslist_v2_icon,18591,2248,42,32,1,43,457,489,21532,0,0,0,0
recruitafriend_v2_tab_icon,18592,2248,32,32,45,77,457,489,21533,0,0,0,0
recruitafriend_claimpane_parchment_generic,18593,1508,326,94,26,352,1,95,21534,0,0,0,0
recruitafriend_rewardpane_parchment_generic,18594,1508,368,317,363,731,97,414,21535,0,0,0,0
recruitafriend_splash_parchment_generic,18595,1508,335,335,26,361,97,432,21536,0,0,0,0
recruitafriend_toast_fancy_generic,18596,1508,274,95,363,637,416,511,21537,0,0,0,0
recruitafriend_toast_standard_generic,18597,1508,276,92,733,1009,267,359,21538,0,0,0,0
craftingorders-noteframenarrow,18600,2255,281,189,160,441,1,190,21541,0,0,0,0
professions-equipment-divider,18601,1933,4,32,1879,1883,22,54,21542,0,0,0,0
map_faction_ring,18602,103,90,90,868,958,870,960,21543,0,0,0,0
ui-frame-dragonflight-cardparchmentwider,18603,2117,515,438,169,684,448,886,21544,0,0,0,0
ui-frame-dragonflight-portraitdisable,18604,2117,205,109,169,374,888,997,21545,0,0,0,0
ui-frame-dragonflight-portrait,18605,2117,205,109,686,891,889,998,21546,0,0,0,0
ui-frame-dragonflight-portraitwiderdisable,18606,2117,390,207,169,559,239,446,21547,0,0,0,0
ui-frame-dragonflight-cardparchment,18607,2117,254,439,686,940,448,887,21548,0,0,0,0
ui-frame-dragonflight-disablesubtitle,18608,2117,207,30,759,966,152,182,21549,0,0,0,0
ui-frame-dragonflight-portraitwider,18609,2117,390,207,561,951,239,446,21550,0,0,0,0
ui-frame-dragonflight-subtitle,18610,2117,207,30,759,966,184,214,21551,0,0,0,0
ui-frame-dragonflight-ribbon,18611,2117,281,84,376,657,888,972,21552,0,0,0,0
callings-backhighlight-full,18612,1727,45,46,1,46,1,47,21553,0,0,0,0
common-loadingspinnercircle,18667,2257,290,290,1,291,1,291,21586,0,0,0,0
dragonriding_vigor_fill_flipbook-2x,18672,2188,296,370,1,297,1,371,21599,0,0,0,0
spec-animations-mask-filigree-activate,18673,2135,2048,1024,0,2048,0,1024,21591,0,0,16,0
ui-frame-cypherchoice-hidebuttonhighlight,18675,1912,203,54,1063,1266,128,182,18236,0,0,0,0
ui-frame-cypherchoice-portrait-fx-sparkles,18676,1912,82,72,502,584,576,648,21593,0,0,0,0
ui-frame-cypherchoice-portrait-fx-back-common,18677,1912,118,117,1629,1747,1,118,21594,0,0,0,0
ui-frame-cypherchoice-portrait-fx-back-epic,18678,1912,118,117,1749,1867,1,118,21595,0,0,0,0
ui-frame-cypherchoice-portrait-fx-back-legendary,18679,1912,118,117,1869,1987,1,118,21596,0,0,0,0
ui-frame-cypherchoice-portrait-fx-back-rare,18680,1912,118,117,883,1001,447,564,21597,0,0,0,0
ui-frame-cypherchoice-portrait-fx-back-uncommon,18681,1912,118,117,883,1001,566,683,21598,0,0,0,0
specdial_lastpip_borderglow,18682,1933,51,75,533,584,350,425,20186,0,0,0,0
splash-1003-botleft,18683,2203,137,371,374,511,587,958,21014,0,0,0,0
splash-1003-right,18684,2203,510,584,1,511,1,585,21015,0,0,0,0
splash-1003-topleft,18685,2203,371,434,1,372,587,1021,21016,0,0,0,0
gamepad_gen_1_32,18687,2227,32,32,463,495,1,33,21601,0,0,0,0
gamepad_gen_2_32,18688,2227,32,32,1,33,463,495,21602,0,0,0,0
gamepad_gen_3_32,18689,2227,32,32,463,495,67,99,21603,0,0,0,0
gamepad_gen_4_32,18690,2227,32,32,67,99,463,495,21604,0,0,0,0
gamepad_gen_5_32,18691,2227,32,32,463,495,133,165,21605,0,0,0,0
gamepad_gen_6_32,18692,2227,32,32,133,165,397,429,21606,0,0,0,0
gamepad_gen_back_32,18693,2227,32,32,133,165,431,463,21607,0,0,0,0
gamepad_gen_down_32,18694,2227,32,32,133,165,465,497,21608,0,0,0,0
gamepad_gen_forward_32,18695,2227,32,32,199,231,199,231,21609,0,0,0,0
gamepad_gen_left_32,18696,2227,32,32,233,265,199,231,21610,0,0,0,0
gamepad_gen_lshoulder_32,18697,2227,32,32,267,299,199,231,21611,0,0,0,0
gamepad_gen_lstickdown_32,18698,2227,32,32,301,333,199,231,21612,0,0,0,0
gamepad_gen_lstickin_32,18699,2227,32,32,335,367,199,231,21613,0,0,0,0
gamepad_gen_lstickleft_32,18700,2227,32,32,369,401,199,231,21614,0,0,0,0
gamepad_gen_lstickright_32,18701,2227,32,32,403,435,199,231,21615,0,0,0,0
gamepad_gen_lstickup_32,18702,2227,32,32,437,469,199,231,21616,0,0,0,0
gamepad_gen_ltrigger_32,18703,2227,32,32,471,503,199,231,21617,0,0,0,0
gamepad_gen_paddle1_32,18704,2227,32,32,199,231,233,265,21618,0,0,0,0
gamepad_gen_paddle2_32,18705,2227,32,32,199,231,267,299,21619,0,0,0,0
gamepad_gen_paddle3_32,18706,2227,32,32,199,231,301,333,21620,0,0,0,0
gamepad_gen_paddle4_32,18707,2227,32,32,199,231,335,367,21621,0,0,0,0
gamepad_gen_right_32,18708,2227,32,32,199,231,369,401,21622,0,0,0,0
gamepad_gen_rshoulder_32,18709,2227,32,32,199,231,403,435,21623,0,0,0,0
gamepad_gen_rstickdown_32,18710,2227,32,32,199,231,437,469,21624,0,0,0,0
gamepad_gen_rstickin_32,18711,2227,32,32,199,231,471,503,21625,0,0,0,0
gamepad_gen_rstickleft_32,18712,2227,32,32,233,265,233,265,21626,0,0,0,0
gamepad_gen_rstickright_32,18713,2227,32,32,267,299,233,265,21627,0,0,0,0
gamepad_gen_rstickup_32,18714,2227,32,32,301,333,233,265,21628,0,0,0,0
gamepad_gen_rtrigger_32,18715,2227,32,32,335,367,233,265,21629,0,0,0,0
gamepad_gen_share_32,18716,2227,32,32,369,401,233,265,21630,0,0,0,0
gamepad_gen_system_32,18717,2227,32,32,403,435,233,265,21631,0,0,0,0
gamepad_gen_up_32,18718,2227,32,32,437,469,233,265,21632,0,0,0,0
gamepad_ltr_a_32,18719,2231,32,32,1,33,199,231,21633,0,0,0,0
gamepad_ltr_b_32,18720,2231,32,32,67,99,199,231,21634,0,0,0,0
gamepad_ltr_menu_32,18721,2231,32,32,133,165,199,231,21635,0,0,0,0
gamepad_ltr_system_32,18722,2231,32,32,199,231,199,231,21636,0,0,0,0
gamepad_ltr_view_32,18723,2231,32,32,463,495,1,33,21637,0,0,0,0
gamepad_ltr_x_32,18724,2231,32,32,265,297,133,165,21638,0,0,0,0
gamepad_ltr_y_32,18725,2231,32,32,265,297,167,199,21639,0,0,0,0
gamepad_rev_a_32,18726,2232,32,32,1,33,199,231,21640,0,0,0,0
gamepad_rev_b_32,18727,2232,32,32,67,99,199,231,21641,0,0,0,0
gamepad_rev_capture_32,18728,2232,32,32,133,165,199,231,21642,0,0,0,0
gamepad_rev_lshoulder_32,18729,2232,32,32,199,231,199,231,21643,0,0,0,0
gamepad_rev_ltrigger_32,18730,2232,32,32,265,297,1,33,21644,0,0,0,0
gamepad_rev_minus_32,18731,2232,32,32,299,331,1,33,21645,0,0,0,0
gamepad_rev_plus_32,18732,2232,32,32,333,365,1,33,21646,0,0,0,0
gamepad_rev_rshoulder_32,18733,2232,32,32,367,399,1,33,21647,0,0,0,0
gamepad_rev_rtrigger_32,18734,2232,32,32,401,433,1,33,21648,0,0,0,0
gamepad_rev_x_32,18735,2232,32,32,435,467,1,33,21649,0,0,0,0
gamepad_rev_y_32,18736,2232,32,32,469,501,1,33,21650,0,0,0,0
gamepad_shp_circle_32,18737,2233,32,32,1,33,199,231,21651,0,0,0,0
gamepad_shp_cross_32,18738,2233,32,32,67,99,199,231,21652,0,0,0,0
gamepad_shp_lshoulder_32,18739,2233,32,32,133,165,199,231,21653,0,0,0,0
gamepad_shp_lstickin_32,18740,2233,32,32,199,231,199,231,21654,0,0,0,0
gamepad_shp_ltrigger_32,18741,2233,32,32,463,495,1,33,21655,0,0,0,0
gamepad_shp_menu_32,18742,2233,32,32,265,297,199,231,21656,0,0,0,0
gamepad_shp_micmute_32,18743,2233,32,32,463,495,67,99,21657,0,0,0,0
gamepad_shp_rshoulder_32,18744,2233,32,32,331,363,199,231,21658,0,0,0,0
gamepad_shp_rstickin_32,18745,2233,32,32,397,429,133,165,21659,0,0,0,0
gamepad_shp_rtrigger_32,18746,2233,32,32,431,463,133,165,21660,0,0,0,0
gamepad_shp_share_32,18747,2233,32,32,465,497,133,165,21661,0,0,0,0
gamepad_shp_square_32,18748,2233,32,32,397,429,167,199,21662,0,0,0,0
gamepad_shp_system_32,18749,2233,32,32,397,429,201,233,21663,0,0,0,0
gamepad_shp_touchpadl_32,18750,2233,32,32,431,463,167,199,21664,0,0,0,0
gamepad_shp_touchpadr_32,18751,2233,32,32,465,497,167,199,21665,0,0,0,0
gamepad_shp_triangle_32,18752,2233,32,32,431,463,201,233,21666,0,0,0,0
professions-chaticon-quality-tier3,18770,2124,36,34,49,85,1,35,20249,0,0,0,0
professions-chaticon-quality-tier4,18771,2124,34,34,87,121,1,35,20250,0,0,0,0
professions-chaticon-quality-tier5,18772,2124,34,34,1,35,37,71,20251,0,0,0,0
perks-hold-slot,18773,1918,66,66,957,1023,225,291,18180,0,0,0,0
ui-hud-unitframe-target-minusmob-portraiton-bar-health-mask,19002,2260,128,16,0,128,0,16,21895,0,0,16,0
ui-hud-unitframe-party-portraiton-vehicle-bar-health-mask,19003,2261,128,16,0,128,0,16,21896,0,0,16,0
dragonflight-majorfactions-emissary-empty,19004,2262,128,128,1,129,1,129,21897,0,0,0,0
craftingorder-divider,19005,2255,264,2,160,424,244,246,21898,0,0,0,0
ui-craftingordericon-up,19008,2255,27,26,30,57,468,494,21901,0,0,0,0
trading-post-minimap-icon,19009,1918,32,32,927,959,382,414,21902,24,24,0,0
professions-qualitybar-barbgx2-tier5,19010,1933,372,52,996,1368,56,108,21913,0,0,0,0
craftingorders-header-frame,19011,2255,503,88,443,946,1,89,21904,0,0,0,0
craftingorder-remainingorders-frame,19012,2255,215,36,160,375,192,228,21899,0,0,0,0
craftingorders-categories-background,19013,2255,157,465,1,158,1,466,21905,0,0,0,0
shop-card-full-h71,19016,2263,568,463,1,569,1,464,21908,0,0,0,0
shop-card-full-t27,19017,2264,568,463,1,569,1,464,21909,0,0,0,0
ui-hud-unitframe-target-rare-portraiton,19018,2060,192,67,1,193,298,365,20379,0,0,0,0
ui-hud-unitframe-target-portraiton-boss-rare-silver,19019,2130,80,79,1,81,165,244,21910,0,0,0,0
ui-hud-unitframe-target-portraiton-boss-rare-silver-2x,19020,2131,160,158,1,161,325,483,21910,0,0,0,0
professions-qualitybar-barbgx2-tier3cap,19021,1933,372,52,1398,1770,56,108,21912,0,0,0,0
professions-chaticon-quality-tier1,19022,2124,30,34,1,31,73,107,20247,0,0,0,0
professions-chaticon-quality-tier2,19023,2124,46,34,1,47,1,35,20248,0,0,0,0
specdial_endpip_flipbook_blacksmithing,19024,2089,540,360,1,541,1023,1383,20171,0,0,0,0
specdial_endpip_flipbook_enchanting,19025,2100,540,360,1,541,1261,1621,20275,0,0,0,0
specdial_endpip_flipbook_jewelcrafting,19026,2104,540,360,1,541,751,1111,20285,0,0,0,0
specdial_endpip_flipbook_tailoring,19027,2102,540,360,1,541,1023,1383,20280,0,0,0,0
specdial_endpip_flipbook_mining,19028,2265,540,360,1,541,1023,1383,21914,0,0,0,0
activities-bar-background,19030,1939,664,35,1,665,724,759,18482,0,0,0,0
activities-bar-end,19032,1939,16,48,564,580,428,476,18392,0,0,0,0
activities-chest-org-glow,19034,1939,109,95,582,691,428,523,21915,0,0,0,0
activities-chest-org,19035,1939,75,62,693,768,428,490,21916,0,0,0,0
activities-chest-sw-glow,19036,1939,124,93,1183,1307,1,94,21917,0,0,0,0
activities-chest-sw,19037,1939,90,56,582,672,598,654,21918,0,0,0,0
activities-clock,19038,1939,16,16,564,580,496,512,18396,0,0,0,0
activities-complete-diamond,19039,1939,34,34,582,616,656,690,18397,0,0,0,0
activities-complete-glow,19040,1939,38,38,618,656,656,694,21919,0,0,0,0
activities-complete-line,19041,1939,2,31,564,566,601,632,18398,0,0,0,0
activities-complete,19042,1939,521,78,789,1310,199,277,21920,0,0,0,0
activities-container,19043,1939,224,290,1020,1244,548,838,21921,0,0,0,0
activities-divider-vertical,19044,1939,2,295,1246,1248,548,843,21922,0,0,0,0
activities-divider,19045,1939,786,2,1,787,1014,1016,18400,0,0,0,0
activities-icon-checkmark-small-yellow,19046,1939,15,13,770,785,428,441,21923,0,0,0,0
activities-icon-checkmark-small,19047,1939,15,13,564,579,586,599,21924,0,0,0,0
activities-icon-checkmark,19048,1939,24,20,693,717,492,512,18404,0,0,0,0
activities-incomplete-active,19049,1939,528,86,1299,1827,430,516,21925,0,0,0,0
activities-incomplete-diamond,19050,1939,40,40,740,780,638,678,18405,0,0,0,0
activities-incomplete-line,19051,1939,2,31,564,566,634,665,18406,0,0,0,0
activities-incomplete,19052,1939,521,78,1299,1820,279,357,21926,0,0,0,0
activities-reward-border,19053,1939,64,64,674,738,638,702,21927,0,0,0,0
activities-ribbon,19054,1939,67,52,685,752,794,846,18407,0,0,0,0
activities-reward-mask,19055,2266,64,64,0,64,0,64,21928,0,0,16,0
specdial_endpip_flipbook_leatherworking,19056,2111,540,360,1,541,1023,1383,20354,0,0,0,0
specdial_endpip_flipbook_inscription,19058,2268,540,360,1,541,1023,1383,21930,0,0,0,0
specdial_endpip_flipbook_skinning,19059,2269,540,360,1,541,1023,1383,21931,0,0,0,0
specdial_endpip_flipbook_herbalism,19060,2270,540,360,1,541,1023,1383,21932,0,0,0,0
completiondialog-dragonflightcampaign-adventuremode-icon,19061,2271,66,66,773,839,1,67,21933,0,0,0,0
completiondialog-dragonflightcampaign-background,19062,2271,770,598,1,771,1,599,21934,0,0,0,0
completiondialog-dragonflightcampaign-divider,19063,2271,670,111,1,671,601,712,21935,0,0,0,0
completiondialog-dragonflightcampaign-majorfactions-icon,19064,2271,66,66,841,907,1,67,21936,0,0,0,0
completiondialog-dragonflightcampaign-worldquests-icon,19065,2271,66,66,909,975,1,67,21937,0,0,0,0
groupfinder-background-raids-dragonflight,19066,236,333,96,331,664,197,293,21938,0,0,0,0
groupfinder-button-raids-dragonflight,19067,236,290,36,1,291,893,929,21939,0,0,0,0
uf-dkrunes-bgactive-2x,19068,2272,54,54,1,55,291,345,21984,0,0,0,0
uf-dkrunes-bgdis-2x,19069,2272,54,54,1,55,347,401,21985,0,0,0,0
uf-dkrunes-bgshadow-2x,19070,2272,50,50,1,51,459,509,21986,0,0,0,0
uf-dkrunes-blood-deplete-2x,19071,2272,33,55,299,332,403,458,21987,0,0,0,0
uf-dkrunes-blood-eyeglw-2x,19072,2272,35,21,617,652,291,312,21988,0,0,0,0
uf-dkrunes-blood-eyes-2x,19073,2272,35,21,654,689,291,312,21989,0,0,0,0
uf-dkrunes-blood-filledglwa-2x,19074,2272,54,54,1,55,403,457,21990,0,0,0,0
uf-dkrunes-blood-filledglwb-2x,19075,2272,54,54,57,111,291,345,21991,0,0,0,0
uf-dkrunes-blood-levelbar-2x,19076,2272,54,54,113,167,291,345,21992,0,0,0,0
uf-dkrunes-blood-skullactive-2x,19077,2272,31,33,355,386,461,494,21993,0,0,0,0
uf-dkrunes-blood-skullgrad-2x,19078,2272,31,33,425,456,347,380,21994,0,0,0,0
uf-dkrunes-blood-skulllines-2x,19079,2272,31,31,485,516,466,497,21995,0,0,0,0
uf-dkrunes-blood-skullmid-2x,19080,2272,31,33,390,421,404,437,21996,0,0,0,0
uf-dkrunes-blood-spintrail-2x,19081,2272,54,54,169,223,291,345,21997,0,0,0,0
uf-dkrunes-blooddeplete-2x,19082,2272,240,288,1,241,1,289,21998,0,0,0,0
uf-dkrunes-frost-deplete-2x,19083,2272,33,55,355,388,404,459,21999,0,0,0,0
uf-dkrunes-frost-eyeglw-2x,19084,2272,35,21,592,627,324,345,22000,0,0,0,0
uf-dkrunes-frost-eyes-2x,19085,2272,35,21,629,664,324,345,22001,0,0,0,0
uf-dkrunes-frost-filledglwa-2x,19086,2272,54,54,113,167,403,457,22002,0,0,0,0
uf-dkrunes-frost-filledglwb-2x,19087,2272,54,54,169,223,403,457,22003,0,0,0,0
uf-dkrunes-frost-levelbar-2x,19088,2272,54,54,243,297,291,345,22004,0,0,0,0
uf-dkrunes-frost-skullactive-2x,19089,2272,31,33,423,454,439,472,22005,0,0,0,0
uf-dkrunes-frost-skullgrad-2x,19090,2272,31,33,423,454,474,507,22006,0,0,0,0
uf-dkrunes-frost-skulllines-2x,19091,2272,31,31,551,582,291,322,22007,0,0,0,0
uf-dkrunes-frost-skullmid-2x,19092,2272,31,33,485,516,291,324,22008,0,0,0,0
uf-dkrunes-frost-smoke-2x,19093,2272,53,46,169,222,459,505,22009,0,0,0,0
uf-dkrunes-frost-spintrail-2x,19094,2272,54,54,243,297,347,401,22010,0,0,0,0
uf-dkrunes-frostdeplete-2x,19095,2272,240,288,485,725,1,289,22011,0,0,0,0
uf-dkrunes-skulldis-2x,19096,2272,31,33,485,516,326,359,22012,0,0,0,0
uf-dkrunes-skulloverlay-2x,19097,2272,38,38,299,337,460,498,22013,0,0,0,0
uf-dkrunes-spinner-2x,19098,2272,54,54,243,297,403,457,22014,0,0,0,0
uf-dkrunes-unholy-deplete-2x,19099,2272,33,55,390,423,347,402,22015,0,0,0,0
uf-dkrunes-unholy-eyeglw-2x,19100,2272,35,21,666,701,324,345,22016,0,0,0,0
uf-dkrunes-unholy-eyes-2x,19101,2272,35,21,518,553,347,368,22017,0,0,0,0
uf-dkrunes-unholy-filledglwa-2x,19102,2272,54,54,299,353,291,345,22018,0,0,0,0
uf-dkrunes-unholy-filledglwb-2x,19103,2272,54,54,355,409,291,345,22019,0,0,0,0
uf-dkrunes-unholy-levelbar-2x,19104,2272,54,54,411,465,291,345,22020,0,0,0,0
uf-dkrunes-unholy-skullactive-2x,19105,2272,31,33,485,516,361,394,22021,0,0,0,0
uf-dkrunes-unholy-skullgrad-2x,19106,2272,31,33,485,516,396,429,22022,0,0,0,0
uf-dkrunes-unholy-skulllines-2x,19107,2272,31,31,584,615,291,322,22023,0,0,0,0
uf-dkrunes-unholy-skullmid-2x,19108,2272,31,33,485,516,431,464,22024,0,0,0,0
uf-dkrunes-unholy-smoke-2x,19109,2272,53,46,243,296,459,505,22025,0,0,0,0
uf-dkrunes-unholy-spintrail-2x,19110,2272,54,54,299,353,347,401,22026,0,0,0,0
uf-dkrunes-unholydeplete-2x,19111,2272,240,288,727,967,1,289,22027,0,0,0,0
uf-dkrunes-bgactive,19112,2273,27,27,1,28,147,174,21984,0,0,0,0
uf-dkrunes-bgdis,19113,2273,27,27,1,28,176,203,21985,0,0,0,0
uf-dkrunes-bgshadow,19114,2273,25,25,152,177,176,201,21986,0,0,0,0
uf-dkrunes-blood-deplete,19115,2273,17,28,208,225,201,229,21987,0,0,0,0
uf-dkrunes-blood-eyeglw,19116,2273,18,11,282,300,166,177,21988,0,0,0,0
uf-dkrunes-blood-eyes,19117,2273,18,11,302,320,166,177,21989,0,0,0,0
uf-dkrunes-blood-filledglwa,19118,2273,27,27,1,28,205,232,21990,0,0,0,0
uf-dkrunes-blood-filledglwb,19119,2273,27,27,30,57,147,174,21991,0,0,0,0
uf-dkrunes-blood-levelbar,19120,2273,27,27,59,86,147,174,21992,0,0,0,0
uf-dkrunes-blood-skullactive,19121,2273,16,17,30,46,234,251,21993,0,0,0,0
uf-dkrunes-blood-skullgrad,19122,2273,16,17,59,75,234,251,21994,0,0,0,0
uf-dkrunes-blood-skulllines,19123,2273,16,16,227,243,239,255,21995,0,0,0,0
uf-dkrunes-blood-skullmid,19124,2273,16,17,88,104,234,251,21996,0,0,0,0
uf-dkrunes-blood-spintrail,19125,2273,27,27,88,115,147,174,21997,0,0,0,0
uf-dkrunes-blooddeplete,19126,2273,120,144,1,121,1,145,21998,0,0,0,0
uf-dkrunes-frost-deplete,19127,2273,17,28,245,262,177,205,21999,0,0,0,0
uf-dkrunes-frost-eyeglw,19128,2273,18,11,282,300,179,190,22000,0,0,0,0
uf-dkrunes-frost-eyes,19129,2273,18,11,302,320,179,190,22001,0,0,0,0
uf-dkrunes-frost-filledglwa,19130,2273,27,27,88,115,176,203,22002,0,0,0,0
uf-dkrunes-frost-filledglwb,19131,2273,27,27,59,86,205,232,22003,0,0,0,0
uf-dkrunes-frost-levelbar,19132,2273,27,27,88,115,205,232,22004,0,0,0,0
uf-dkrunes-frost-skullactive,19133,2273,16,17,227,243,201,218,22005,0,0,0,0
uf-dkrunes-frost-skullgrad,19134,2273,16,17,227,243,220,237,22006,0,0,0,0
uf-dkrunes-frost-skulllines,19135,2273,16,16,264,280,166,182,22007,0,0,0,0
uf-dkrunes-frost-skullmid,19136,2273,16,17,245,261,237,254,22008,0,0,0,0
uf-dkrunes-frost-smoke,19137,2273,27,23,179,206,201,224,22009,0,0,0,0
uf-dkrunes-frost-spintrail,19138,2273,27,27,123,150,147,174,22010,0,0,0,0
uf-dkrunes-frostdeplete,19139,2273,120,144,245,365,1,145,22011,0,0,0,0
uf-dkrunes-skulldis,19140,2273,16,17,264,280,147,164,22012,0,0,0,0
uf-dkrunes-skulloverlay,19141,2273,19,19,1,20,234,253,22013,0,0,0,0
uf-dkrunes-spinner,19142,2273,27,27,123,150,176,203,22014,0,0,0,0
uf-dkrunes-unholy-deplete,19143,2273,17,28,245,262,207,235,22015,0,0,0,0
uf-dkrunes-unholy-eyeglw,19144,2273,18,11,322,340,179,190,22016,0,0,0,0
uf-dkrunes-unholy-eyes,19145,2273,18,11,342,360,179,190,22017,0,0,0,0
uf-dkrunes-unholy-filledglwa,19146,2273,27,27,123,150,205,232,22018,0,0,0,0
uf-dkrunes-unholy-filledglwb,19147,2273,27,27,152,179,147,174,22019,0,0,0,0
uf-dkrunes-unholy-levelbar,19148,2273,27,27,181,208,147,174,22020,0,0,0,0
uf-dkrunes-unholy-skullactive,19149,2273,16,17,282,298,147,164,22021,0,0,0,0
uf-dkrunes-unholy-skullgrad,19150,2273,16,17,300,316,147,164,22022,0,0,0,0
uf-dkrunes-unholy-skulllines,19151,2273,16,16,264,280,184,200,22023,0,0,0,0
uf-dkrunes-unholy-skullmid,19152,2273,16,17,318,334,147,164,22024,0,0,0,0
uf-dkrunes-unholy-smoke,19153,2273,27,23,179,206,226,249,22025,0,0,0,0
uf-dkrunes-unholy-spintrail,19154,2273,27,27,210,237,147,174,22026,0,0,0,0
uf-dkrunes-unholydeplete,19155,2273,120,144,367,487,1,145,22027,0,0,0,0
activities-container-shadow-left,19157,1939,229,294,789,1018,548,842,22028,0,0,0,0
activities-container-shadow-right,19158,1939,561,294,1,562,428,722,22029,0,0,0,0
streamcinematic-dragonflight2-down,19159,557,176,78,179,355,321,399,22030,0,0,0,0
streamcinematic-dragonflight2-up,19160,557,176,78,179,355,401,479,22031,0,0,0,0
professions_icon_firsttimecraft,19161,1933,17,23,1788,1805,1,24,22032,0,0,0,0
ui-craftingordericon-down,19212,2255,27,26,1,28,468,494,21900,0,0,0,0
splash-1004-botleft,19213,2258,137,371,374,511,587,958,21587,0,0,0,0
splash-1004-right,19214,2258,510,584,1,511,1,585,21588,0,0,0,0
splash-1004-topleft,19215,2258,371,434,1,372,587,1021,21589,0,0,0,0
air-extrabutton,19216,2274,256,128,1,257,1,129,22083,0,0,0,0
fire-extrabutton,19217,2275,256,128,1,257,1,129,22084,0,0,0,0
water-extrabutton,19218,2276,256,128,1,257,1,129,22085,0,0,0,0
castbar_shadow_embedded,19219,1942,215,17,213,428,1,18,22086,0,0,0,0
fishing-hole,19220,647,32,32,377,409,919,951,22087,0,0,0,0
professions-specialization-node-tailoring,19222,2205,128,128,0,128,0,128,21029,0,0,16,0
professions-specialization-node-skinning,19223,2214,128,128,0,128,0,128,21028,0,0,16,0
professions-specialization-node-mining,19224,2213,128,128,0,128,0,128,21027,0,0,16,0
professions-specialization-node-leatherworking,19225,2209,128,128,0,128,0,128,21026,0,0,16,0
professions-specialization-node-jewelcrafting,19226,2211,128,128,0,128,0,128,21025,0,0,16,0
professions-specialization-node-inscription,19227,2207,128,128,0,128,0,128,21024,0,0,16,0
professions-specialization-node-engineering,19229,2235,128,128,0,128,0,128,21374,0,0,16,0
skillbar_fill_flipbook_cooking,19233,2267,1712,1020,1,1713,1,1021,22088,0,0,0,0
skillbar_fill_flipbook_engineering,19234,2277,1712,1020,1,1713,1,1021,22089,0,0,0,0
specdial_dividerglow_engineering,19235,2277,344,344,543,887,1023,1367,22090,0,0,0,0
specdial_endpip_flipbook_engineering,19236,2277,540,360,1,541,1023,1383,22091,0,0,0,0
specdial_pip_flipbook_engineering,19237,2277,360,360,1,361,1385,1745,22092,0,0,0,0
specdial_fill_flipbook_engineering,19238,2278,1980,1980,1,1981,1,1981,22093,0,0,0,0
skillbar_fill_flipbook_herbalism,19239,2270,1712,1020,1,1713,1,1021,22094,0,0,0,0
specdial_dividerglow_herbalism,19240,2270,344,344,543,887,1023,1367,22095,0,0,0,0
specdial_pip_flipbook_herbalism,19241,2270,360,360,1,361,1385,1745,22096,0,0,0,0
specdial_fill_flipbook_herbalism,19242,2279,1980,1980,1,1981,1,1981,22097,0,0,0,0
skillbar_fill_flipbook_fishing,19243,2280,1712,1020,1,1713,1,1021,22098,0,0,0,0
skillbar_fill_flipbook_inscription,19244,2268,1712,1020,1,1713,1,1021,22099,0,0,0,0
specdial_dividerglow_inscription,19245,2268,344,344,543,887,1023,1367,22100,0,0,0,0
specdial_pip_flipbook_inscription,19246,2268,360,360,1,361,1385,1745,22101,0,0,0,0
specdial_fill_flipbook_inscription,19247,2281,1980,1980,1,1981,1,1981,22102,0,0,0,0
skillbar_fill_flipbook_mining,19248,2265,1712,1020,1,1713,1,1021,22103,0,0,0,0
specdial_dividerglow_mining,19249,2265,344,344,543,887,1023,1367,22104,0,0,0,0
specdial_pip_flipbook_mining,19250,2265,360,360,1,361,1385,1745,22105,0,0,0,0
specdial_fill_flipbook_mining,19251,2282,1980,1980,1,1981,1,1981,22106,0,0,0,0
skillbar_fill_flipbook_skinning,19252,2269,1712,1020,1,1713,1,1021,22107,0,0,0,0
specdial_dividerglow_skinning,19253,2269,344,344,543,887,1023,1367,22108,0,0,0,0
specdial_pip_flipbook_skinning,19254,2269,360,360,1,361,1385,1745,22109,0,0,0,0
specdial_fill_flipbook_skinning,19255,2283,1980,1980,1,1981,1,1981,22110,0,0,0,0
uf-dkrunes-blood-smoke,19256,2273,27,23,179,206,176,199,22111,0,0,0,0
uf-dkrunes-blood-smoke-2x,19283,2272,53,46,57,110,459,505,22111,0,0,0,0
skillbar_flare_alchemy,19284,2109,53,33,1715,1768,1,34,22113,0,0,0,0
skillbar_flare_blacksmithing,19285,2089,53,33,1715,1768,1,34,22114,0,0,0,0
skillbar_flare_cooking,19286,2267,53,33,1715,1768,1,34,22115,0,0,0,0
skillbar_flare_enchanting,19287,2100,53,33,1715,1768,1,34,22116,0,0,0,0
skillbar_flare_engineering,19288,2277,53,33,1715,1768,1,34,22117,0,0,0,0
skillbar_flare_fishing,19289,2280,53,33,1715,1768,1,34,22118,0,0,0,0
skillbar_flare_herbalism,19290,2270,53,33,1715,1768,1,34,22119,0,0,0,0
skillbar_flare_inscription,19291,2268,53,33,1715,1768,1,34,22120,0,0,0,0
skillbar_flare_jewelcrafting,19292,2104,53,33,1715,1768,1,34,22121,0,0,0,0
skillbar_flare_leatherworking,19293,2111,53,33,1715,1768,1,34,22122,0,0,0,0
skillbar_flare_mining,19294,2265,53,33,1715,1768,1,34,22123,0,0,0,0
skillbar_flare_skinning,19295,2269,53,33,1715,1768,1,34,22124,0,0,0,0
skillbar_flare_tailoring,19296,2102,53,33,1715,1768,1,34,22125,0,0,0,0
professions-specialization-node-herbalism,19510,2212,128,128,0,128,0,128,21023,0,0,16,0
professions-specialization-node-blacksmithing,19511,2206,128,128,0,128,0,128,21021,0,0,16,0
professions_specialization_arrowline,19512,2189,16,16,0,16,1,17,20984,8,8,4,0
professions-specialization-node-enchanting,19513,2210,128,128,0,128,0,128,21022,0,0,16,0
professions-specialization-node-alchemy,19514,2208,128,128,0,128,0,128,21020,0,0,16,0
uf-druidcp-bg-active-2x,19515,2284,40,40,419,459,173,213,22136,0,0,0,0
uf-druidcp-bg-dis-2x,19516,2284,40,40,464,504,123,163,22137,0,0,0,0
uf-druidcp-bg-glow-2x,19517,2284,72,72,419,491,1,73,22138,0,0,0,0
uf-druidcp-bg-shadow-2x,19518,2284,50,50,1,51,249,299,22139,0,0,0,0
uf-druidcp-deplete-2x,19519,2284,31,30,419,450,215,245,22140,0,0,0,0
uf-druidcp-icon-2x,19520,2284,28,28,464,492,196,224,22141,0,0,0,0
uf-druidcp-orbgleam-2x,19521,2284,28,29,464,492,165,194,22142,0,0,0,0
uf-druidcp-ring-glow-2x,19522,2284,46,46,464,510,75,121,22143,0,0,0,0
uf-druidcp-slash-2x,19523,2284,416,246,1,417,1,247,22144,0,0,0,0
uf-druidcp-smoke-2x,19524,2284,43,96,419,462,75,171,22145,0,0,0,0
uf-druidcp-bg-active,19525,2285,22,22,211,233,89,111,22136,0,0,0,0
uf-druidcp-bg-dis,19526,2285,22,22,1,23,178,200,22137,0,0,0,0
uf-druidcp-bg-glow,19527,2285,36,36,211,247,1,37,22138,0,0,0,0
uf-druidcp-bg-shadow,19528,2285,25,25,1,26,126,151,22139,0,0,0,0
uf-druidcp-deplete,19529,2285,16,15,235,251,39,54,22140,0,0,0,0
uf-druidcp-icon,19530,2285,14,14,235,249,73,87,22141,0,0,0,0
uf-druidcp-orbgleam,19531,2285,14,15,235,249,56,71,22142,0,0,0,0
uf-druidcp-ring-glow,19532,2285,23,23,1,24,153,176,22143,0,0,0,0
uf-druidcp-slash,19533,2285,208,123,1,209,1,124,22144,0,0,0,0
uf-druidcp-smoke,19534,2285,22,48,211,233,39,87,22145,0,0,0,0
professions-chaticon-quality-tier5-cap,19535,2171,63,61,251,314,867,928,22146,0,0,0,0
professions-icon-quality-tier3-cap,19536,2169,52,43,625,677,813,856,22147,0,0,0,0
professions-recipe-header-expand,19541,1933,22,16,538,560,83,99,20155,11,8,0,0
professions-recipe-header-collapse,19542,1933,22,16,1959,1981,56,72,20154,11,8,0,0
shop-bundles-915-ate2,19543,1909,566,225,1137,1703,682,907,22151,0,0,0,0
shop-bundles-915-ath2,19544,1909,566,225,1,567,909,1134,22152,0,0,0,0
shop-bundles-915-tb2,19545,1909,277,224,280,557,1136,1360,22153,0,0,0,0
shop-bundles-915-tbe2,19546,1909,566,225,569,1135,909,1134,22154,0,0,0,0
shop-bundles-915-te2,19547,1909,566,225,1137,1703,909,1134,22155,0,0,0,0
shop-bundles-915-th2,19548,1909,277,224,280,557,1362,1586,22156,0,0,0,0
professions-specialization-node-choiceglow,19549,1933,78,78,176,254,824,902,22157,0,0,0,0
cursor_unableinteract_48,19581,2289,48,48,443,491,1,49,22189,0,0,0,0
cursor_interact_128,19582,2289,128,128,131,259,1,129,22190,0,0,0,0
cursor_interact_48,19583,2289,48,48,393,441,1,49,22191,0,0,0,0
cursor_unableinteract_128,19584,2289,128,128,1,129,1,129,22192,0,0,0,0
cursor_interact_64,19585,2289,64,64,261,325,1,65,22193,0,0,0,0
cursor_unableinteract_96,19586,2289,96,96,1,97,131,227,22194,0,0,0,0
cursor_unableinteract_32,19587,2289,32,32,261,293,67,99,22195,0,0,0,0
cursor_interact_96,19588,2289,96,96,131,227,131,227,22196,0,0,0,0
cursor_unableinteract_64,19589,2289,64,64,327,391,1,65,22197,0,0,0,0
cursor_interact_32,19591,2289,32,32,261,293,101,133,22199,0,0,0,0
perks-frozen-icon,19658,1918,22,25,997,1019,424,449,22211,0,0,0,0
ui-hud-unitframe-totemframe,19659,2060,30,30,195,225,380,410,22212,0,0,0,0
ui-hud-unitframe-totemframe-2x,19660,2074,60,60,1953,2013,237,297,22212,0,0,0,0
talents-icon-learnableplus,19661,1970,38,36,1980,2018,115,151,22214,19,18,0,0
activities-bar-background-glow,19662,1939,682,52,1,683,794,846,22215,0,0,0,0
activities-checkmark_flipbook-large,19665,1939,392,196,789,1181,1,197,22218,0,0,0,0
activities-checkmark_flipbook-small,19666,1939,235,118,1309,1544,1,119,22219,0,0,0,0
activities-coindrawing,19667,1939,174,71,582,756,525,596,22247,0,0,0,0
activities-complete-diamond-glow,19668,1939,38,38,674,712,598,636,22221,0,0,0,0
activities-complete-diamond-sparkles,19669,1939,490,140,1546,2036,1,141,22222,0,0,0,0
activities-coindrawing-mask,19670,2290,256,256,0,256,0,256,22223,0,0,16,0
perks-crack-1,19671,2291,70,70,209,279,440,510,22224,0,0,0,0
perks-crack-2,19672,2291,70,70,281,351,440,510,22225,0,0,0,0
perks-crack-3,19673,2291,70,70,849,919,153,223,22226,0,0,0,0
perks-frost-1,19674,2291,70,70,921,991,153,223,22227,0,0,0,0
perks-frost-2,19675,2291,70,70,603,673,275,345,22228,0,0,0,0
perks-frost-3,19676,2291,70,70,603,673,347,417,22229,0,0,0,0
perks-frost-4,19677,2291,70,70,603,673,419,489,22230,0,0,0,0
perks-frost-bg-fade,19678,2291,190,123,209,399,315,438,22231,0,0,0,0
perks-frost-bg,19679,2291,154,120,732,886,1,121,22232,0,0,0,0
perks-frost-frame-1,19680,2291,64,64,888,952,275,339,22233,0,0,0,0
perks-frost-frame-2,19681,2291,64,64,954,1018,275,339,22234,0,0,0,0
perks-frost-frame-glow-1,19682,2291,88,88,759,847,153,241,22235,0,0,0,0
perks-frost-frame-glow-2,19683,2291,134,134,888,1022,1,135,22236,0,0,0,0
perks-frost-shine-1,19684,2291,70,70,675,745,275,345,22237,0,0,0,0
perks-frost-shine-2,19685,2291,70,70,675,745,347,417,22238,0,0,0,0
perks-frost-shine-3,19686,2291,70,70,675,745,419,489,22239,0,0,0,0
perks-frost-shine-4,19687,2291,70,70,747,817,275,345,22240,0,0,0,0
perks-slot-empty,19688,2291,70,70,747,817,347,417,22241,0,0,0,0
perks-slot-glow,19689,2291,70,70,747,817,419,489,22242,0,0,0,0
perks-snow-1,19690,2291,155,150,401,556,315,465,22243,0,0,0,0
perks-snow-2,19691,2291,206,146,1,207,315,461,22244,0,0,0,0
perks-snow-3,19692,2291,127,150,603,730,1,151,22245,0,0,0,0
perks-frost-bg-2,19693,2291,154,120,603,757,153,273,22246,0,0,0,0
perks-buybutton-greenglow,19694,1918,266,88,533,799,334,422,22248,0,0,0,0
perks-list-borderlines,19695,1918,516,48,1,517,1307,1355,22249,0,0,0,0
perks-list-edgeflare,19696,1918,28,17,851,879,472,489,22250,0,0,0,0
perks-list-iconglow,19697,1918,52,52,533,585,740,792,22251,0,0,0,0
talents-search-notonactionbarhidden,19700,1970,126,126,759,885,175,301,22254,63,63,0,0
furblan-w-1,19701,2293,32,32,1,33,1,33,22255,0,0,0,0
furblan-w-10,19702,2293,32,32,35,67,1,33,22256,0,0,0,0
furblan-w-11,19703,2293,32,32,69,101,1,33,22257,0,0,0,0
furblan-w-12,19704,2293,32,32,103,135,1,33,22258,0,0,0,0
furblan-w-13,19705,2293,32,32,137,169,1,33,22259,0,0,0,0
furblan-w-14,19706,2293,32,32,171,203,1,33,22260,0,0,0,0
furblan-w-15,19707,2293,32,32,205,237,1,33,22261,0,0,0,0
furblan-w-16,19708,2293,32,32,1,33,35,67,22262,0,0,0,0
furblan-w-17,19709,2293,32,32,1,33,69,101,22263,0,0,0,0
furblan-w-18,19710,2293,32,32,1,33,103,135,22264,0,0,0,0
furblan-w-19,19711,2293,32,32,1,33,137,169,22265,0,0,0,0
furblan-w-2,19712,2293,32,32,1,33,171,203,22266,0,0,0,0
furblan-w-20,19713,2293,32,32,1,33,205,237,22267,0,0,0,0
furblan-w-21,19714,2293,32,32,35,67,35,67,22268,0,0,0,0
furblan-w-22,19715,2293,32,32,69,101,35,67,22269,0,0,0,0
furblan-w-23,19716,2293,32,32,103,135,35,67,22270,0,0,0,0
furblan-w-24,19717,2293,32,32,137,169,35,67,22271,0,0,0,0
furblan-w-25,19718,2293,32,32,171,203,35,67,22272,0,0,0,0
furblan-w-26,19719,2293,32,32,205,237,35,67,22273,0,0,0,0
furblan-w-27,19720,2293,32,32,35,67,69,101,22274,0,0,0,0
furblan-w-28,19721,2293,32,32,35,67,103,135,22275,0,0,0,0
furblan-w-29,19722,2293,32,32,35,67,137,169,22276,0,0,0,0
furblan-w-3,19723,2293,32,32,35,67,171,203,22277,0,0,0,0
furblan-w-30,19724,2293,32,32,35,67,205,237,22278,0,0,0,0
furblan-w-31,19725,2293,32,32,69,101,69,101,22279,0,0,0,0
furblan-w-32,19726,2293,32,32,103,135,69,101,22280,0,0,0,0
furblan-w-33,19727,2293,32,32,137,169,69,101,22281,0,0,0,0
furblan-w-34,19728,2293,32,32,171,203,69,101,22282,0,0,0,0
furblan-w-35,19729,2293,32,32,205,237,69,101,22283,0,0,0,0
furblan-w-36,19730,2293,32,32,69,101,103,135,22284,0,0,0,0
furblan-w-4,19731,2293,32,32,69,101,137,169,22285,0,0,0,0
furblan-w-5,19732,2293,32,32,69,101,171,203,22286,0,0,0,0
furblan-w-6,19733,2293,32,32,69,101,205,237,22287,0,0,0,0
furblan-w-7,19734,2293,32,32,103,135,103,135,22288,0,0,0,0
furblan-w-8,19735,2293,32,32,137,169,103,135,22289,0,0,0,0
furblan-w-9,19736,2293,32,32,171,203,103,135,22290,0,0,0,0
furblan-d-1,19773,2294,32,32,1,33,1,33,22326,0,0,0,0
furblan-d-10,19774,2294,32,32,35,67,1,33,22291,0,0,0,0
furblan-d-11,19775,2294,32,32,69,101,1,33,22292,0,0,0,0
furblan-d-12,19776,2294,32,32,103,135,1,33,22293,0,0,0,0
furblan-d-13,19777,2294,32,32,137,169,1,33,22294,0,0,0,0
furblan-d-14,19778,2294,32,32,171,203,1,33,22295,0,0,0,0
furblan-d-15,19779,2294,32,32,205,237,1,33,22296,0,0,0,0
furblan-d-16,19780,2294,32,32,1,33,35,67,22297,0,0,0,0
furblan-d-17,19781,2294,32,32,1,33,69,101,22298,0,0,0,0
furblan-d-18,19782,2294,32,32,1,33,103,135,22299,0,0,0,0
furblan-d-19,19783,2294,32,32,1,33,137,169,22300,0,0,0,0
furblan-d-2,19784,2294,32,32,1,33,171,203,22301,0,0,0,0
furblan-d-20,19785,2294,32,32,1,33,205,237,22302,0,0,0,0
furblan-d-21,19786,2294,32,32,35,67,35,67,22303,0,0,0,0
furblan-d-22,19787,2294,32,32,69,101,35,67,22304,0,0,0,0
furblan-d-23,19788,2294,32,32,103,135,35,67,22305,0,0,0,0
furblan-d-24,19789,2294,32,32,137,169,35,67,22306,0,0,0,0
furblan-d-25,19790,2294,32,32,171,203,35,67,22307,0,0,0,0
furblan-d-26,19791,2294,32,32,205,237,35,67,22308,0,0,0,0
furblan-d-27,19792,2294,32,32,35,67,69,101,22309,0,0,0,0
furblan-d-28,19793,2294,32,32,35,67,103,135,22310,0,0,0,0
furblan-d-29,19794,2294,32,32,35,67,137,169,22311,0,0,0,0
furblan-d-3,19795,2294,32,32,35,67,171,203,22312,0,0,0,0
furblan-d-30,19796,2294,32,32,35,67,205,237,22313,0,0,0,0
furblan-d-31,19797,2294,32,32,69,101,69,101,22314,0,0,0,0
furblan-d-32,19798,2294,32,32,103,135,69,101,22315,0,0,0,0
furblan-d-33,19799,2294,32,32,137,169,69,101,22316,0,0,0,0
furblan-d-34,19800,2294,32,32,171,203,69,101,22317,0,0,0,0
furblan-d-35,19801,2294,32,32,205,237,69,101,22318,0,0,0,0
furblan-d-36,19802,2294,32,32,69,101,103,135,22319,0,0,0,0
furblan-d-4,19803,2294,32,32,69,101,137,169,22320,0,0,0,0
furblan-d-5,19804,2294,32,32,69,101,171,203,22321,0,0,0,0
furblan-d-6,19805,2294,32,32,69,101,205,237,22322,0,0,0,0
furblan-d-7,19806,2294,32,32,103,135,103,135,22323,0,0,0,0
furblan-d-8,19807,2294,32,32,137,169,103,135,22324,0,0,0,0
furblan-d-9,19808,2294,32,32,171,203,103,135,22325,0,0,0,0
furblan-b-1,19809,2295,32,32,1,33,1,33,22327,0,0,0,0
furblan-b-10,19810,2295,32,32,35,67,1,33,22328,0,0,0,0
furblan-b-11,19811,2295,32,32,69,101,1,33,22329,0,0,0,0
furblan-b-12,19812,2295,32,32,103,135,1,33,22330,0,0,0,0
furblan-b-13,19813,2295,32,32,137,169,1,33,22331,0,0,0,0
furblan-b-14,19814,2295,32,32,171,203,1,33,22332,0,0,0,0
furblan-b-15,19815,2295,32,32,205,237,1,33,22333,0,0,0,0
furblan-b-16,19816,2295,32,32,1,33,35,67,22334,0,0,0,0
furblan-b-17,19817,2295,32,32,1,33,69,101,22335,0,0,0,0
furblan-b-18,19818,2295,32,32,1,33,103,135,22336,0,0,0,0
furblan-b-19,19819,2295,32,32,1,33,137,169,22337,0,0,0,0
furblan-b-2,19820,2295,32,32,1,33,171,203,22338,0,0,0,0
furblan-b-20,19821,2295,32,32,1,33,205,237,22339,0,0,0,0
furblan-b-21,19822,2295,32,32,35,67,35,67,22340,0,0,0,0
furblan-b-22,19823,2295,32,32,69,101,35,67,22341,0,0,0,0
furblan-b-23,19824,2295,32,32,103,135,35,67,22342,0,0,0,0
furblan-b-24,19825,2295,32,32,137,169,35,67,22343,0,0,0,0
furblan-b-25,19826,2295,32,32,171,203,35,67,22344,0,0,0,0
furblan-b-26,19827,2295,32,32,205,237,35,67,22345,0,0,0,0
furblan-b-27,19828,2295,32,32,35,67,69,101,22346,0,0,0,0
furblan-b-28,19829,2295,32,32,35,67,103,135,22347,0,0,0,0
furblan-b-29,19830,2295,32,32,35,67,137,169,22348,0,0,0,0
furblan-b-3,19831,2295,32,32,35,67,171,203,22349,0,0,0,0
furblan-b-30,19832,2295,32,32,35,67,205,237,22350,0,0,0,0
furblan-b-31,19833,2295,32,32,69,101,69,101,22351,0,0,0,0
furblan-b-32,19834,2295,32,32,103,135,69,101,22352,0,0,0,0
furblan-b-33,19835,2295,32,32,137,169,69,101,22353,0,0,0,0
furblan-b-34,19836,2295,32,32,171,203,69,101,22354,0,0,0,0
furblan-b-35,19837,2295,32,32,205,237,69,101,22355,0,0,0,0
furblan-b-36,19838,2295,32,32,69,101,103,135,22356,0,0,0,0
furblan-b-4,19839,2295,32,32,69,101,137,169,22357,0,0,0,0
furblan-b-5,19840,2295,32,32,69,101,171,203,22358,0,0,0,0
furblan-b-6,19841,2295,32,32,69,101,205,237,22359,0,0,0,0
furblan-b-7,19842,2295,32,32,103,135,103,135,22360,0,0,0,0
furblan-b-8,19843,2295,32,32,137,169,103,135,22361,0,0,0,0
furblan-b-9,19844,2295,32,32,171,203,103,135,22362,0,0,0,0
activities-background,19954,1939,786,425,1,787,1,426,18481,0,0,0,0
currency-frame-glow,19955,2299,77,76,80,157,363,439,22472,0,0,0,0
currency-frame-shimmer,19956,2299,77,82,1,78,363,445,22473,0,0,0,0
currency-glow-fx,19957,2299,504,252,459,963,1,253,22474,0,0,0,0
currency-particle-fx,19958,2299,456,360,1,457,1,361,22475,0,0,0,0
ph-currency-icon,19959,2299,31,30,36,67,447,477,22476,0,0,0,0
currency-star-shine,19960,2299,33,39,1,34,447,486,22477,0,0,0,0
perks-frost-fx,19961,2291,600,312,1,601,1,313,22478,0,0,0,0
perks-list-titanlines,19962,1918,280,48,533,813,550,598,22479,0,0,0,0
perks-list-titanlinesglow,19963,1918,421,48,533,954,500,548,22480,0,0,0,0
perks-list-titanlines-mask,19964,2300,512,512,0,512,0,512,22252,0,0,16,0
perks-list-mask,19965,2292,512,512,0,512,0,512,22481,0,0,16,0
uf-roguecp-bg-2x,19966,2301,40,40,593,633,1,41,22497,0,0,0,0
uf-roguecp-bg-anima-2x,19967,2301,40,40,593,633,43,83,22493,0,0,0,0
uf-roguecp-bg-anima-dis-2x,19968,2301,40,40,593,633,85,125,22492,0,0,0,0
uf-roguecp-bg-animaglow-2x,19969,2301,48,48,519,567,127,175,22494,0,0,0,0
uf-roguecp-bg-dis-2x,19970,2301,40,40,593,633,127,167,22495,0,0,0,0
uf-roguecp-bg-shadow-2x,19971,2301,50,50,519,569,75,125,22496,0,0,0,0
uf-roguecp-icon-blue-2x,19972,2301,28,29,519,547,225,254,22498,0,0,0,0
uf-roguecp-icon-red-2x,19973,2301,28,29,549,577,225,254,22499,0,0,0,0
uf-roguecp-slash-blue-2x,19974,2301,516,258,1,517,1,259,22500,0,0,0,0
uf-roguecp-slash-red-2x,19975,2301,516,258,1,517,261,519,22501,0,0,0,0
uf-roguecp-bg-anima-dis,19986,2302,20,20,299,319,45,65,22492,0,0,0,0
uf-roguecp-bg-anima,19987,2302,20,20,299,319,23,43,22493,0,0,0,0
uf-roguecp-bg-animaglow,19988,2302,24,24,261,285,66,90,22494,0,0,0,0
uf-roguecp-bg-dis,19989,2302,20,20,299,319,67,87,22495,0,0,0,0
uf-roguecp-bg-shadow,19990,2302,25,25,261,286,39,64,22496,0,0,0,0
uf-roguecp-bg,19991,2302,20,20,299,319,1,21,22497,0,0,0,0
uf-roguecp-icon-blue,19992,2302,14,15,299,313,89,104,22498,0,0,0,0
uf-roguecp-icon-red,19993,2302,14,15,299,313,106,121,22499,0,0,0,0
uf-roguecp-slash-blue,19994,2302,258,129,1,259,1,130,22500,0,0,0,0
uf-roguecp-slash-red,19995,2302,258,129,1,259,132,261,22501,0,0,0,0
activities-icon-lock,19996,1939,17,22,770,787,443,465,22502,0,0,0,0
perks-clock-large,19997,1918,30,30,603,633,820,850,22503,0,0,0,0
uf-roguecp-bg-glow-2x,20000,2301,72,72,519,591,1,73,22508,0,0,0,0
uf-roguecp-frame-glow-2x,20001,2301,46,46,519,565,177,223,22509,0,0,0,0
uf-roguecp-fx-blue-2x,20002,2301,28,28,593,621,169,197,22510,0,0,0,0
uf-roguecp-fx-red-2x,20003,2301,28,28,593,621,199,227,22511,0,0,0,0
uf-roguecp-bg-glow,20004,2302,36,36,261,297,1,37,22508,0,0,0,0
uf-roguecp-frame-glow,20005,2302,23,23,261,284,92,115,22509,0,0,0,0
uf-roguecp-fx-blue,20006,2302,14,14,321,335,1,15,22510,0,0,0,0
uf-roguecp-fx-red,20007,2302,14,14,321,335,17,31,22511,0,0,0,0
perks-dropdownbox-hover,20008,1918,180,46,815,995,424,470,18172,0,0,0,0
perks-dropdownbox-open,20009,1918,180,46,815,995,550,596,18173,0,0,0,0
perks-dropdownbox,20010,1918,180,46,801,981,334,380,18174,0,0,0,0
ui-hud-minimap-craftingorder-down,20018,1990,17,16,479,496,161,177,22519,0,0,0,0
ui-hud-minimap-craftingorder-over,20019,1990,17,16,441,458,180,196,22520,0,0,0,0
ui-hud-minimap-craftingorder-up,20020,1990,17,16,460,477,180,196,22521,0,0,0,0
ui-hud-minimap-craftingorder-down-2x,20021,1995,34,32,1,35,660,692,22522,0,0,0,0
ui-hud-minimap-craftingorder-over-2x,20022,1995,34,32,1,35,694,726,22523,0,0,0,0
ui-hud-minimap-craftingorder-up-2x,20023,1995,34,32,1,35,728,760,22524,0,0,0,0
activities-toast-icon,20040,1939,50,50,1183,1233,96,146,22538,0,0,0,0
motion-sickness-darkening-circle,20164,2303,1080,1080,1,1081,1,1081,22662,0,0,0,0
motion-sickness-reticle,20168,2303,720,720,1083,1803,1,721,22666,0,0,0,0
perks-tick-glow,20337,2291,67,67,819,886,275,342,22779,0,0,0,0
perks-tick,20338,2291,35,31,1,36,463,494,22780,0,0,0,0
motion-sickness-darkening-circle-black,20352,2305,1080,1080,1,1081,1,1081,22667,0,0,0,0
shop-card-full-p27a,20380,2308,568,463,289,857,466,929,22794,0,0,0,0
shop-card-full-p74,20381,2308,568,463,289,857,1,464,22795,0,0,0,0
shop-card-half-p27a,20382,2308,286,471,1,287,474,945,22796,0,0,0,0
shop-card-half-p74,20383,2308,286,471,1,287,1,472,22797,0,0,0,0
activities-bar-fill-glow,20390,1939,660,31,1,661,945,976,22217,0,0,0,0
activities-bar-fill,20391,1939,660,31,1,661,761,792,18393,0,0,0,0
activities-bar-border,20392,1939,676,47,1,677,848,895,18483,0,0,0,0
activities-bar-border-glow,20393,1939,676,46,1,677,897,943,22216,0,0,0,0
!buttongreenglow-nineslice-edgeleft,20403,2310,42,1,1,43,0,1,22810,0,0,2,0
!buttongreenglow-nineslice-edgeright,20404,2310,42,1,45,87,0,1,22811,0,0,2,0
buttongreenglow-nineslice-corner,20405,2310,42,42,89,131,1,43,22812,0,0,0,0
_buttongreenglow-nineslice-edgebottom,20406,2311,1,42,0,1,1,43,22806,0,0,4,0
_buttongreenglow-nineslice-edgetop,20407,2311,1,42,0,1,45,87,22809,0,0,4,0
buttongreenglow-nineslice-center,20409,2311,10,10,1,11,89,99,22813,0,0,0,0
cursor_lock_128,20410,2312,128,128,1,129,1,129,22814,0,0,0,0
cursor_lock_32,20411,2312,32,32,261,293,67,99,22815,0,0,0,0
cursor_lock_48,20412,2312,48,48,393,441,1,49,22816,0,0,0,0
cursor_lock_64,20413,2312,64,64,261,325,1,65,22817,0,0,0,0
cursor_lock_96,20414,2312,96,96,1,97,131,227,22818,0,0,0,0
cursor_unablelock_128,20415,2312,128,128,131,259,1,129,22819,0,0,0,0
cursor_unablelock_32,20416,2312,32,32,261,293,101,133,22820,0,0,0,0
cursor_unablelock_48,20417,2312,48,48,443,491,1,49,22821,0,0,0,0
cursor_unablelock_64,20418,2312,64,64,327,391,1,65,22822,0,0,0,0
cursor_unablelock_96,20419,2312,96,96,131,227,131,227,22823,0,0,0,0
stormcapture-arrow-air,20441,2313,7,14,242,249,109,123,22845,0,0,0,0
stormcapture-arrow-earth,20442,2313,7,14,212,219,138,152,22846,0,0,0,0
stormcapture-arrow-water,20443,2313,7,14,221,228,138,152,22847,0,0,0,0
stormcapture-divider-air,20444,2313,4,10,251,255,109,119,22848,0,0,0,0
stormcapture-divider-earth,20445,2313,4,10,242,246,125,135,22849,0,0,0,0
stormcapture-divider-water,20446,2313,4,10,248,252,125,135,22850,0,0,0,0
stormcapture-frame-air,20447,2313,179,27,1,180,109,136,22851,0,0,0,0
stormcapture-frame-earth,20448,2313,179,27,1,180,138,165,22852,0,0,0,0
stormcapture-frame-water,20449,2313,179,27,1,180,167,194,22853,0,0,0,0
stormcapture-leftfill-air,20450,2313,4,10,0,4,1,11,22854,0,0,4,0
stormcapture-leftfill-earth,20451,2313,4,10,0,4,13,23,22855,0,0,4,0
stormcapture-leftfill-water,20452,2313,4,10,0,4,25,35,22856,0,0,4,0
stormcapture-leftglow-air,20453,2313,28,27,182,210,109,136,22857,0,0,0,0
stormcapture-leftglow-earth,20454,2313,28,27,212,240,109,136,22858,0,0,0,0
stormcapture-leftglow-water,20455,2313,28,27,182,210,138,165,22859,0,0,0,0
stormcapture-neutralfill-air,20456,2313,4,10,0,4,37,47,22860,0,0,4,0
stormcapture-neutralfill-earth,20457,2313,4,10,0,4,49,59,22861,0,0,4,0
stormcapture-neutralfill-water,20458,2313,4,10,0,4,61,71,22862,0,0,4,0
stormcapture-rightfill-air,20459,2313,4,10,0,4,73,83,22863,0,0,4,0
stormcapture-rightfill-earth,20460,2313,4,10,0,4,85,95,22864,0,0,4,0
stormcapture-rightfill-water,20461,2313,4,10,0,4,97,107,22865,0,0,4,0
stormcapture-rightglow-air,20462,2313,30,35,1,31,196,231,22866,0,0,0,0
stormcapture-rightglow-earth,20463,2313,30,35,33,63,196,231,22867,0,0,0,0
stormcapture-rightglow-water,20464,2313,30,35,65,95,196,231,22868,0,0,0,0
stormcapture-spark-air,20465,2313,4,18,230,234,138,156,22869,0,0,0,0
stormcapture-spark-earth,20466,2313,4,18,236,240,138,156,22870,0,0,0,0
stormcapture-spark-water,20467,2313,4,18,242,246,138,156,22871,0,0,0,0
section_expand_glowing_left,20484,1974,64,25,61,125,56,81,22873,0,0,0,0
section_expand_glowing_middle,20485,1974,1,25,0,1,1,26,22874,0,0,4,0
section_expand_glowing_right,20486,1974,64,25,61,125,83,108,22875,0,0,0,0
ui-dialog-new-background,20495,2316,718,183,1,719,1,184,22878,0,0,0,0
ui-dialog-new-button-default,20496,2316,354,58,343,697,186,244,22879,0,0,0,0
dialognew-backarrow,20498,2316,12,16,721,733,1,17,22881,0,0,0,0
dialognew-forwardarrow,20499,2316,12,16,721,733,19,35,22882,0,0,0,0
ui-dialog-new-button-down,20500,2316,346,42,343,689,306,348,22883,0,0,0,0
ui-dialog-new-button-hover,20501,2316,354,58,343,697,246,304,22884,0,0,0,0
ui-dialog-new-questdetails-footer,20506,2316,339,36,1,340,540,576,22889,0,0,0,0
ui-dialog-new-questdetails-background,20507,2316,340,352,1,341,186,538,22880,0,0,0,0
splash-1005-botleft,20517,2321,137,371,374,511,587,958,22898,0,0,0,0
splash-1005-right,20518,2321,510,584,1,511,1,585,22899,0,0,0,0
splash-1005-topleft,20519,2321,371,434,1,372,587,1021,22900,0,0,0,0
professions-specializations-preview-art-alchemy,20522,2324,1140,520,1,1141,1,521,22914,0,0,0,0
professions-specializations-preview-art-enchanting,20523,2325,1140,520,1,1141,1,521,22915,0,0,0,0
professions-specializations-preview-art-engineering,20524,2326,1140,520,1,1141,1,521,22916,0,0,0,0
professions-specializations-preview-art-herbalism,20525,2327,1140,520,1,1141,1,521,22917,0,0,0,0
professions-specializations-preview-art-inscription,20526,2328,1140,520,1,1141,1,521,22918,0,0,0,0
professions-specializations-preview-art-jewelcrafting,20527,2329,1140,520,1,1141,1,521,22919,0,0,0,0
professions-specializations-preview-art-leatherworking,20528,2330,1140,520,1,1141,1,521,22920,0,0,0,0
professions-specializations-preview-art-mining,20529,2331,1140,520,1,1141,1,521,22921,0,0,0,0
professions-specializations-preview-art-skinning,20530,2332,1140,520,1,1141,1,521,22922,0,0,0,0
professions_specialization_pip_preview_alchemy,20563,2338,23,30,1,24,1,31,22954,0,0,0,0
professions_specialization_pip_preview_blacksmithing,20564,2338,22,30,26,48,65,95,22955,0,0,0,0
professions_specialization_pip_preview_enchanting,20565,2338,22,30,26,48,97,127,22956,0,0,0,0
professions_specialization_pip_preview_engineering,20566,2338,23,30,1,24,33,63,22957,0,0,0,0
professions_specialization_pip_preview_herbalism,20567,2338,23,30,1,24,65,95,22958,0,0,0,0
professions_specialization_pip_preview_inscription,20568,2338,23,30,1,24,97,127,22959,0,0,0,0
professions_specialization_pip_preview_jewelcrafting,20569,2338,22,30,51,73,1,31,22960,0,0,0,0
professions_specialization_pip_preview_leatherworking,20570,2338,22,30,75,97,1,31,22961,0,0,0,0
professions_specialization_pip_preview_mining,20571,2338,23,30,26,49,1,31,22962,0,0,0,0
professions_specialization_pip_preview_skinning,20572,2338,23,30,26,49,33,63,22963,0,0,0,0
professions_specialization_pip_preview_tailoring,20573,2338,22,30,99,121,1,31,22964,0,0,0,0
cursor_buy_128,20604,2344,128,128,1,129,1,129,22990,0,0,0,0
cursor_buy_32,20605,2344,32,32,261,293,67,99,22991,0,0,0,0
cursor_buy_48,20606,2344,48,48,393,441,1,49,22992,0,0,0,0
cursor_buy_64,20607,2344,64,64,261,325,1,65,22993,0,0,0,0
cursor_buy_96,20608,2344,96,96,1,97,131,227,22994,0,0,0,0
cursor_unablebuy_128,20609,2344,128,128,131,259,1,129,22995,0,0,0,0
cursor_unablebuy_32,20610,2344,32,32,261,293,101,133,22996,0,0,0,0
cursor_unablebuy_48,20611,2344,48,48,443,491,1,49,22997,0,0,0,0
cursor_unablebuy_64,20612,2344,64,64,327,391,1,65,22998,0,0,0,0
cursor_unablebuy_96,20613,2344,96,96,131,227,131,227,22999,0,0,0,0
cursor_cast_128,20614,2345,128,128,1,129,1,129,23000,0,0,0,0
cursor_cast_32,20615,2345,32,32,261,293,67,99,23001,0,0,0,0
cursor_cast_48,20616,2345,48,48,393,441,1,49,23002,0,0,0,0
cursor_cast_64,20617,2345,64,64,261,325,1,65,23003,0,0,0,0
cursor_cast_96,20618,2345,96,96,1,97,131,227,23004,0,0,0,0
cursor_unablecast_128,20619,2345,128,128,131,259,1,129,23005,0,0,0,0
cursor_unablecast_32,20620,2345,32,32,261,293,101,133,23006,0,0,0,0
cursor_unablecast_48,20621,2345,48,48,443,491,1,49,23007,0,0,0,0
cursor_unablecast_64,20622,2345,64,64,327,391,1,65,23008,0,0,0,0
cursor_unablecast_96,20623,2345,96,96,131,227,131,227,23009,0,0,0,0
cursor_lootall_128,20624,2346,128,128,1,129,1,129,23010,0,0,0,0
cursor_lootall_32,20625,2346,32,32,261,293,67,99,23011,0,0,0,0
cursor_lootall_48,20626,2346,48,48,393,441,1,49,23012,0,0,0,0
cursor_lootall_64,20627,2346,64,64,261,325,1,65,23013,0,0,0,0
cursor_lootall_96,20628,2346,96,96,1,97,131,227,23014,0,0,0,0
cursor_unablelootall_128,20629,2346,128,128,131,259,1,129,23015,0,0,0,0
cursor_unablelootall_32,20630,2346,32,32,261,293,101,133,23016,0,0,0,0
cursor_unablelootall_48,20631,2346,48,48,443,491,1,49,23017,0,0,0,0
cursor_unablelootall_64,20632,2346,64,64,327,391,1,65,23018,0,0,0,0
cursor_unablelootall_96,20633,2346,96,96,131,227,131,227,23019,0,0,0,0
cursor_mail_128,20634,2347,128,128,1,129,1,129,23020,0,0,0,0
cursor_mail_32,20635,2347,32,32,261,293,67,99,23021,0,0,0,0
cursor_mail_48,20636,2347,48,48,393,441,1,49,23022,0,0,0,0
cursor_mail_64,20637,2347,64,64,261,325,1,65,23023,0,0,0,0
cursor_mail_96,20638,2347,96,96,1,97,131,227,23024,0,0,0,0
cursor_unablemail_128,20639,2347,128,128,131,259,1,129,23025,0,0,0,0
cursor_unablemail_32,20640,2347,32,32,261,293,101,133,23026,0,0,0,0
cursor_unablemail_48,20641,2347,48,48,443,491,1,49,23027,0,0,0,0
cursor_unablemail_64,20642,2347,64,64,327,391,1,65,23028,0,0,0,0
cursor_unablemail_96,20643,2347,96,96,131,227,131,227,23029,0,0,0,0
cursor_trainer_128,20644,2348,128,128,1,129,1,129,23030,0,0,0,0
cursor_trainer_32,20645,2348,32,32,261,293,67,99,23031,0,0,0,0
cursor_trainer_48,20646,2348,48,48,393,441,1,49,23032,0,0,0,0
cursor_trainer_64,20647,2348,64,64,261,325,1,65,23033,0,0,0,0
cursor_trainer_96,20648,2348,96,96,1,97,131,227,23034,0,0,0,0
cursor_unabletrainer_128,20649,2348,128,128,131,259,1,129,23035,0,0,0,0
cursor_unabletrainer_32,20650,2348,32,32,261,293,101,133,23036,0,0,0,0
cursor_unabletrainer_48,20651,2348,48,48,443,491,1,49,23037,0,0,0,0
cursor_unabletrainer_64,20652,2348,64,64,327,391,1,65,23038,0,0,0,0
cursor_unabletrainer_96,20653,2348,96,96,131,227,131,227,23039,0,0,0,0
recipelist-divider,20783,2255,272,12,160,432,230,242,21600,0,0,0,0
optionsframe-nineslice-cornerbottomleft,20791,2363,32,32,1,33,69,101,23173,0,0,0,0
optionsframe-nineslice-cornerbottomright,20792,2363,32,32,1,33,103,135,23174,0,0,0,0
optionsframe-nineslice-cornertopleft,20793,2363,32,32,1,33,137,169,23175,0,0,0,0
optionsframe-nineslice-cornertopright,20794,2363,32,32,1,33,171,203,23176,0,0,0,0
_optionsframe-nineslice-edgebottom,20795,2363,32,32,0,32,1,33,23177,0,0,4,0
_optionsframe-nineslice-edgetop,20796,2363,32,32,0,32,35,67,23178,0,0,4,0
!optionsframe-nineslice-edgeleft,20797,2364,32,32,1,33,0,32,23171,0,0,2,0
!optionsframe-nineslice-edgeright,20798,2364,32,32,35,67,0,32,23172,0,0,2,0
minimal-scrollbar-arrow-returntobottom-down,20805,1921,17,15,31,48,1,16,23179,0,0,0,0
minimal-scrollbar-arrow-returntobottom-over,20806,1921,17,15,31,48,18,33,23180,0,0,0,0
minimal-scrollbar-arrow-returntobottom,20807,1921,17,15,31,48,35,50,23181,0,0,0,0
ui-hud-experiencebar-fill-mask,20836,2366,1024,1024,1,1025,1,1025,23190,0,0,0,0
ui-hud-experiencebar-flare-rested-2x-flipbook,20879,2369,456,140,1,457,633,773,23135,0,0,0,0
ui-hud-experiencebar-fill-rested-2x-flipbook,20880,2369,1128,630,1,1129,1,631,23134,0,0,0,0
ui-hud-experiencebar-fill-reputation-2x-flipbook,20881,2370,1128,630,1,1129,1,631,23139,0,0,0,0
ui-hud-experiencebar-flare-reputation-2x-flipbook,20882,2370,456,140,1,457,633,773,23143,0,0,0,0
ui-hud-experiencebar-fill-experience-2x-flipbook,20883,2371,1128,630,1,1129,1,631,23133,0,0,0,0
ui-hud-experiencebar-flare-xp-2x-flipbook,20884,2371,456,140,1,457,633,773,23136,0,0,0,0
ui-hud-experiencebar-fill-honor-2x-flipbook,20885,2372,1128,630,1,1129,1,631,23144,0,0,0,0
ui-hud-experiencebar-flare-faction-orange-2x-flipbook,20886,2372,456,140,1,457,633,773,23142,0,0,0,0
ui-hud-experiencebar-fill-artifactpower-2x-flipbook,20887,2373,1128,630,1,1129,1,631,23137,0,0,0,0
ui-hud-experiencebar-flare-artifactpower-2x-flipbook,20888,2373,456,140,1,457,633,773,23138,0,0,0,0
charactercreate-customize-stopbutton-down,20964,708,76,76,1859,1935,497,573,23237,38,38,0,0
charactercreate-customize-stopbutton,20965,708,76,76,1937,2013,497,573,23238,38,38,0,0
uf-arcane-bg-2x,21032,2375,42,42,167,209,453,495,23274,0,0,0,0
uf-arcane-bgshadow-2x,21033,2375,54,54,61,115,453,507,23275,0,0,0,0
uf-arcane-flare-2x,21034,2375,70,66,831,901,1,67,23276,0,0,0,0
uf-arcane-frameglow-2x,21035,2375,58,58,1,59,453,511,23277,0,0,0,0
uf-arcane-icon-2x,21036,2375,38,38,211,249,453,491,23278,0,0,0,0
uf-arcane-magiccirc-2x,21037,2375,74,74,681,755,1,75,23279,0,0,0,0
uf-arcane-magicdiamond-2x,21038,2375,72,72,757,829,1,73,23280,0,0,0,0
uf-arcane-magicsquare-2x,21039,2375,48,48,117,165,453,501,23281,0,0,0,0
uf-arcane-magictriangle-2x,21040,2375,76,76,603,679,1,77,23282,0,0,0,0
uf-arcane-orb-2x,21041,2375,36,36,251,287,453,489,23283,0,0,0,0
uf-arcane-outerfx-2x,21042,2375,36,36,289,325,453,489,23284,0,0,0,0
uf-arcane-shockfx-2x,21043,2375,600,450,1,601,1,451,23285,0,0,0,0
uf-arcane-bg,21047,2378,21,21,56,77,228,249,23274,0,0,0,0
uf-arcane-bgshadow,21048,2378,27,27,1,28,228,255,23275,0,0,0,0
uf-arcane-flare,21049,2378,35,33,420,455,1,34,23276,0,0,0,0
uf-arcane-frameglow,21050,2378,29,29,457,486,1,30,23277,0,0,0,0
uf-arcane-icon,21051,2378,19,19,79,98,228,247,23278,0,0,0,0
uf-arcane-magiccirc,21052,2378,37,37,343,380,1,38,23279,0,0,0,0
uf-arcane-magicdiamond,21053,2378,36,36,382,418,1,37,23280,0,0,0,0
uf-arcane-magicsquare,21054,2378,24,24,30,54,228,252,23281,0,0,0,0
uf-arcane-magictriangle,21055,2378,38,38,303,341,1,39,23282,0,0,0,0
uf-arcane-orb,21056,2378,18,18,100,118,228,246,23283,0,0,0,0
uf-arcane-outerfx,21057,2378,18,18,120,138,228,246,23284,0,0,0,0
uf-arcane-shockfx,21058,2378,300,225,1,301,1,226,23285,0,0,0,0
shop-card-full-b06,21064,2380,568,463,1,569,1,464,23291,0,0,0,0
recruitafriend_v3_splash_picture,21078,2251,274,154,1,275,1,155,23307,0,0,0,0
campaign_zaralekcavern,21079,2063,608,138,1221,1829,281,419,23308,0,0,0,2
questbg-zaralekcavern,21081,2383,299,407,1,300,1,408,23309,0,0,0,0
splash-1007-botleft,21082,2384,137,371,374,511,587,958,23310,0,0,0,0
splash-1007-right,21083,2384,510,584,1,511,1,585,23311,0,0,0,0
splash-1007-topleft,21084,2384,371,434,1,372,587,1021,23312,0,0,0,0
worldquest-icon-race,21102,743,20,17,489,509,112,129,23323,0,0,0,0
uf-chi-bg-active,21138,2224,25,25,225,250,70,95,21245,0,0,0,0
uf-chi-bg,21139,2224,25,25,225,250,43,68,21246,0,0,0,0
uf-chi-fx-1,21140,2224,14,14,1,15,191,205,21247,0,0,0,0
uf-chi-fx-2,21141,2224,14,14,17,31,191,205,21248,0,0,0,0
uf-chi-fx-3,21142,2224,14,14,1,15,207,221,21249,0,0,0,0
uf-chi-fx-bgglow,21143,2224,35,35,1,36,111,146,21250,0,0,0,0
uf-chi-fx-deplete,21144,2224,14,14,17,31,207,221,21251,0,0,0,0
uf-chi-fx-smoke,21145,2224,20,40,225,245,1,41,21257,0,0,0,0
uf-chi-icon,21146,2224,14,15,1,15,174,189,21258,0,0,0,0
uf-chi-orbgleam,21147,2224,14,15,17,31,174,189,21259,0,0,0,0
uf-chi-outerglow,21148,2224,24,24,1,25,148,172,21252,0,0,0,0
uf-chi-windfx,21149,2224,222,108,1,223,1,109,21253,0,0,0,0
talents-arrow-head-red,21156,1970,28,24,417,445,939,963,23350,14,12,0,0
talents-gate-open,21157,1970,168,28,1842,2010,85,113,23351,84,14,0,0
talents-node-choice-red,21158,1970,116,104,759,875,749,853,23352,58,52,0,0
talents-node-choiceflyout-circle-red,21159,1970,64,64,1005,1069,387,451,23353,0,0,0,0
talents-node-choiceflyout-square-red,21160,1970,128,128,629,757,305,433,23354,64,64,0,0
talents-node-circle-red,21161,1970,50,50,219,269,725,775,23355,40,40,0,0
talents-node-square-red,21162,1970,80,80,191,271,869,949,23356,40,40,0,0
professions-minimizedview-background,21163,2394,402,589,1,403,1,590,23358,0,0,0,0
professions-minimizedview-qualitypane-bg,21164,2394,315,105,1,316,592,697,23359,0,0,0,0
caveunderground-down,21186,647,96,96,627,723,1,97,23445,28,28,0,0
caveunderground-up,21187,647,96,96,725,821,1,97,23446,28,28,0,0
professions-recipe-background-engineering,21205,2143,675,548,1,676,1,549,20823,0,0,0,0
professions-recipe-background,21206,2076,675,548,1,676,1,549,20110,0,0,0,0
professions-recipe-background-alchemy,21207,2025,675,548,1,676,1,549,19291,0,0,0,0
professions-recipe-background-blacksmithing,21208,2024,675,548,1,676,1,549,19290,0,0,0,0
professions-recipe-background-cooking,21209,2077,675,548,1,676,1,549,20112,0,0,0,0
professions-recipe-background-enchanting,21210,2153,675,548,1,676,1,549,20841,0,0,0,0
professions-recipe-background-fishing,21211,2152,675,548,1,676,1,549,20840,0,0,0,0
professions-recipe-background-herbalism,21212,2149,675,548,1,676,1,549,20837,0,0,0,0
professions-recipe-background-inscription,21213,2147,675,548,1,676,1,549,20835,0,0,0,0
professions-recipe-background-jewelcrafting,21214,2146,675,548,1,676,1,549,20834,0,0,0,0
professions-recipe-background-leatherworking,21215,2148,675,548,1,676,1,549,20836,0,0,0,0
professions-recipe-background-mining,21216,2150,675,548,1,676,1,549,20838,0,0,0,0
professions-recipe-background-skinning,21217,2151,675,548,1,676,1,549,20839,0,0,0,0
professions-recipe-background-tailoring,21218,2031,675,548,1,676,1,549,19754,0,0,0,0
professions-background-summarylist,21219,1933,268,572,1,269,110,682,19257,0,0,0,0
professions-specializations-preview-art-tailoring,21231,2323,1140,520,1,1141,1,521,22913,0,0,0,0
majorfaction-celebration-niffen,21245,2222,235,110,712,947,1,111,23454,0,0,0,0
dragonflight-majorfactions-niffen-background,21246,2399,820,578,1,821,1,579,23455,0,0,0,0
majorfactions_icons_niffen512,21248,2079,512,512,1,513,515,1027,23456,0,0,0,0
ui-niffen-headerfill,21254,2400,182,220,803,985,1,221,23458,0,0,0,0
ui-niffen-headerorb-level0,21255,2400,182,220,693,875,265,485,23459,0,0,0,0
ui-niffen-headerorb,21256,2400,182,220,801,983,567,787,23460,0,0,0,0
ui-niffen-highlight-bottom,21257,2400,798,228,1,799,567,795,23461,0,0,0,0
ui-niffen-highlight-middle,21258,2400,800,262,1,801,1,263,23462,0,0,0,0
ui-niffen-highlight-top,21259,2400,690,300,1,691,265,565,23463,0,0,0,0
ui-niffen-reward-slate,21260,2400,470,140,1,471,797,937,23464,0,0,0,0
ui-niffen-rewardframe,21261,2400,128,128,877,1005,265,393,23465,0,0,0,0
majorfactions_mapicons_niffen64,21262,647,64,64,71,135,593,657,23457,42,42,0,0
dragonflight-landingpage-radial-niffen,21263,2133,96,96,1933,2029,487,583,23466,86,86,0,0
professionspecializationpreviewartblacksmithing,21268,2322,1142,522,1,1143,1,523,22907,0,0,0,0
professions-choicereagent-frame,21269,1933,100,100,29,129,684,784,23470,0,0,0,0
flightmaster_cave-taxi_frame_gray,21270,2398,64,64,1,65,1,65,23471,32,32,0,0
!minimal-scrollbar-small-track-middle,21282,2403,8,1,1,9,0,1,23483,0,0,2,0
minimal-scrollbar-small-thumb-middle-down,21283,2403,8,715,11,19,1,716,23484,0,0,0,0
minimal-scrollbar-small-thumb-middle-over,21284,2403,8,715,21,29,1,716,23485,0,0,0,0
minimal-scrollbar-small-thumb-middle,21285,2403,8,715,31,39,1,716,23486,0,0,0,0
minimal-scrollbar-small-arrow-bottom-down,21286,2404,17,11,20,37,18,29,23487,0,0,0,0
minimal-scrollbar-small-arrow-bottom-over,21287,2404,17,11,39,56,18,29,23488,0,0,0,0
minimal-scrollbar-small-arrow-bottom,21288,2404,17,11,1,18,18,29,23489,0,0,0,0
minimal-scrollbar-small-arrow-returntobottom-down,21289,2404,17,15,20,37,1,16,23490,0,0,0,0
minimal-scrollbar-small-arrow-returntobottom-over,21290,2404,17,15,39,56,1,16,23491,0,0,0,0
minimal-scrollbar-small-arrow-returntobottom,21291,2404,17,15,1,18,1,16,23492,0,0,0,0
minimal-scrollbar-small-arrow-top-down,21292,2404,17,11,1,18,44,55,23493,0,0,0,0
minimal-scrollbar-small-arrow-top-over,21293,2404,17,11,20,37,31,42,23494,0,0,0,0
minimal-scrollbar-small-arrow-top,21294,2404,17,11,1,18,31,42,23495,0,0,0,0
minimal-scrollbar-small-thumb-bottom-down,21295,2404,8,8,49,57,31,39,23496,0,0,0,0
minimal-scrollbar-small-thumb-bottom-over,21296,2404,8,8,20,28,44,52,23497,0,0,0,0
minimal-scrollbar-small-thumb-bottom,21297,2404,8,8,39,47,31,39,23498,0,0,0,0
minimal-scrollbar-small-thumb-top-down,21298,2404,8,8,30,38,44,52,23499,0,0,0,0
minimal-scrollbar-small-thumb-top-over,21299,2404,8,8,30,38,54,62,23500,0,0,0,0
minimal-scrollbar-small-thumb-top,21300,2404,8,8,20,28,54,62,23501,0,0,0,0
minimal-scrollbar-small-track-bottom,21301,2404,8,8,40,48,44,52,23502,0,0,0,0
minimal-scrollbar-small-track-top,21302,2404,8,8,40,48,54,62,23503,0,0,0,0
uf-dkrunes-default-deplete-2x,21303,2272,33,55,355,388,347,402,23517,0,0,0,0
uf-dkrunes-default-eyeglw-2x,21304,2272,35,21,518,553,324,345,23518,0,0,0,0
uf-dkrunes-default-eyes-2x,21305,2272,35,21,555,590,324,345,23519,0,0,0,0
uf-dkrunes-default-filledglwa-2x,21306,2272,54,54,57,111,347,401,23520,0,0,0,0
uf-dkrunes-default-filledglwb-2x,21307,2272,54,54,57,111,403,457,23521,0,0,0,0
uf-dkrunes-default-levelbar-2x,21308,2272,54,54,113,167,347,401,23522,0,0,0,0
uf-dkrunes-default-skullactive-2x,21309,2272,31,33,423,454,404,437,23523,0,0,0,0
uf-dkrunes-default-skullgrad-2x,21310,2272,31,33,390,421,439,472,23524,0,0,0,0
uf-dkrunes-default-skulllines-2x,21311,2272,31,31,518,549,291,322,23525,0,0,0,0
uf-dkrunes-default-skullmid-2x,21312,2272,31,33,390,421,474,507,23526,0,0,0,0
uf-dkrunes-default-smoke-2x,21313,2272,53,46,113,166,459,505,23527,0,0,0,0
uf-dkrunes-default-spintrail-2x,21314,2272,54,54,169,223,347,401,23528,0,0,0,0
uf-dkrunes-defaultdeplete-2x,21315,2272,240,288,243,483,1,289,23529,0,0,0,0
uf-dkrunes-default-deplete,21316,2273,17,28,245,262,147,175,23517,0,0,0,0
uf-dkrunes-default-eyeglw,21317,2273,18,11,322,340,166,177,23518,0,0,0,0
uf-dkrunes-default-eyes,21318,2273,18,11,342,360,166,177,23519,0,0,0,0
uf-dkrunes-default-filledglwa,21319,2273,27,27,30,57,176,203,23520,0,0,0,0
uf-dkrunes-default-filledglwb,21320,2273,27,27,30,57,205,232,23521,0,0,0,0
uf-dkrunes-default-levelbar,21321,2273,23,23,152,175,203,226,23522,0,0,0,0
uf-dkrunes-default-skullactive,21322,2273,16,17,123,139,234,251,23523,0,0,0,0
uf-dkrunes-default-skullgrad,21323,2273,16,17,152,168,228,245,23524,0,0,0,0
uf-dkrunes-default-skulllines,21324,2273,16,16,336,352,147,163,23525,0,0,0,0
uf-dkrunes-default-skullmid,21325,2273,16,17,208,224,231,248,23526,0,0,0,0
uf-dkrunes-default-smoke,21326,2273,27,23,208,235,176,199,23527,0,0,0,0
uf-dkrunes-default-spintrail,21327,2273,27,27,59,86,176,203,23528,0,0,0,0
uf-dkrunes-defaultdeplete,21328,2273,120,144,123,243,1,145,23529,0,0,0,0
ui-hud-unitframe-player-groupindicatorleft,21342,2060,5,13,1018,1023,19,32,23538,0,0,0,0
ui-hud-unitframe-player-groupindicatorright,21343,2060,5,16,1018,1023,1,17,23539,0,0,0,0
_ui-hud-unitframe-player-groupindicatormid,21344,2405,16,13,0,16,1,14,23540,0,0,4,0
niffen-myrrit,21345,647,36,36,261,297,947,983,23541,0,0,0,0
fyrakk-flying-flame,21346,2406,103,104,1,104,675,779,23542,0,0,0,0
fyrakk_flame_fx,21347,2406,300,672,1,301,1,673,23543,0,0,0,0
fyrakk_flame_trail,21348,2406,52,161,1,53,781,942,23544,0,0,0,0
fyrakk_exolode_fx,21349,2406,65,71,109,174,781,852,23545,0,0,0,0
fyrakk_head_glow,21350,2406,80,80,212,292,675,755,23546,0,0,0,0
fyrakk-flying-icon,21358,647,104,104,521,625,1,105,23547,64,64,0,0
fyrakk-head-icon,21359,647,80,80,823,903,1,81,23548,64,64,0,0
actionbar_icon_mask,21414,2022,64,64,1,65,1,65,23571,0,0,0,0
transmog-icon-unsupported,21453,610,120,112,1,121,1,113,23631,60,56,0,0
common-opacity-background-nineslice-cornerbottomleft,21456,2416,12,13,17,29,29,42,23633,0,0,0,0
common-opacity-background-nineslice-cornerbottomright,21457,2416,14,13,1,15,29,42,23634,0,0,0,0
common-opacity-background-nineslice-cornertopleft,21458,2416,12,11,17,29,44,55,23635,0,0,0,0
common-opacity-background-nineslice-cornertopright,21459,2416,14,11,1,15,44,55,23636,0,0,0,0
_common-opacity-background-nineslice-edgebottom,21460,2416,32,13,0,32,1,14,23637,0,0,4,0
_common-opacity-background-nineslice-edgetop,21461,2416,32,11,0,32,16,27,23638,0,0,4,0
!common-opacity-background-nineslice-edgeleft,21462,2417,12,32,17,29,0,32,23639,0,0,2,0
!common-opacity-background-nineslice-edgeright,21463,2417,14,32,1,15,0,32,23640,0,0,2,0
common-opacity-background-nineslice-center,21464,2418,32,32,0,32,0,32,23641,0,0,6,0
lootroll-icon-checkmark,21473,2421,15,13,35,50,363,376,23650,0,0,0,0
lootroll-itementry-background,21474,2421,436,116,1,437,1,117,23651,218,58,0,0
lootroll-pendingdot,21475,2421,8,8,503,511,1,9,23652,4,4,0,0
lootroll-rollicon-yourolled-greed,21476,2421,62,56,439,501,1,57,23653,37,33,0,0
lootroll-rollicon-yourolled-need,21477,2421,62,56,439,501,59,115,23654,37,33,0,0
lootroll-rollicon-yourolled-transmog,21478,2421,62,56,1,63,203,259,23655,37,33,0,0
lootroll-timer-background,21479,2421,476,26,1,477,119,145,23656,238,13,0,0
lootroll-timer-border,21480,2421,476,26,1,477,147,173,23657,238,13,0,0
lootroll-timer-fill,21481,2421,468,26,1,469,175,201,23658,234,13,0,0
cursor_legendaryquestturnin_128,21482,2422,128,128,1,129,1,129,23659,0,0,0,0
cursor_legendaryquestturnin_32,21483,2422,32,32,131,163,329,361,23660,0,0,0,0
cursor_legendaryquestturnin_48,21484,2422,48,48,1,49,457,505,23661,0,0,0,0
cursor_legendaryquestturnin_64,21485,2422,64,64,229,293,131,195,23662,0,0,0,0
cursor_legendaryquestturnin_96,21486,2422,96,96,391,487,1,97,23663,0,0,0,0
cursor_legendaryquest_128,21487,2422,128,128,131,259,1,129,23664,0,0,0,0
cursor_legendaryquest_32,21488,2422,32,32,131,163,363,395,23665,0,0,0,0
cursor_legendaryquest_48,21489,2422,48,48,51,99,457,505,23666,0,0,0,0
cursor_legendaryquest_64,21490,2422,64,64,295,359,131,195,23667,0,0,0,0
cursor_legendaryquest_96,21491,2422,96,96,1,97,261,357,23668,0,0,0,0
cursor_unablelegendaryquestturnin_128,21492,2422,128,128,261,389,1,129,23669,0,0,0,0
cursor_unablelegendaryquestturnin_32,21493,2422,32,32,131,163,397,429,23670,0,0,0,0
cursor_unablelegendaryquestturnin_48,21494,2422,48,48,131,179,229,277,23671,0,0,0,0
cursor_unablelegendaryquestturnin_64,21495,2422,64,64,361,425,131,195,23672,0,0,0,0
cursor_unablelegendaryquestturnin_96,21496,2422,96,96,1,97,359,455,23673,0,0,0,0
cursor_unablelegendaryquest_128,21497,2422,128,128,1,129,131,259,23674,0,0,0,0
cursor_unablelegendaryquest_32,21498,2422,32,32,131,163,431,463,23675,0,0,0,0
cursor_unablelegendaryquest_48,21499,2422,48,48,131,179,279,327,23676,0,0,0,0
cursor_unablelegendaryquest_64,21500,2422,64,64,427,491,131,195,23677,0,0,0,0
cursor_unablelegendaryquest_96,21501,2422,96,96,131,227,131,227,23678,0,0,0,0
quest-legendary-available-trivial,21502,647,32,32,479,511,579,611,23679,0,0,0,0
quest-legendary-available,21503,647,32,32,479,511,545,577,23680,0,0,0,0
quest-legendary-turnin,21504,647,32,32,479,511,613,645,23681,0,0,0,0
ui-questpoilegendary-questbang,21505,2423,32,32,67,99,1,33,23682,0,0,0,0
ui-questpoilegendary-questnumber-pressed-supertracked,21507,2423,32,32,101,133,69,101,23684,0,0,0,0
ui-questpoilegendary-questnumber-pressed,21508,2423,32,32,101,133,35,67,23685,0,0,0,0
ui-questpoilegendary-questnumber-supertracked,21509,2423,32,32,135,167,1,33,23686,0,0,0,0
ui-questpoilegendary-questnumber,21510,2423,32,32,101,133,1,33,23687,0,0,0,0
legendaryactivequesticon,21511,2424,24,24,1,25,1,25,23688,16,16,0,0
legendaryavailablequesticon,21512,2424,24,24,27,51,1,25,23689,16,16,0,0
legendaryincompletequesticon,21513,2424,24,24,1,25,27,51,23690,16,16,0,0
ui-questpoilegendary-innerglow,21608,2423,32,32,1,33,67,99,23779,0,0,0,0
ui-questpoilegendary-outerglow,21609,2423,64,64,1,65,1,65,23780,0,0,0,0
questlog-questtypeicon-account,21610,2429,18,18,73,91,1,19,23781,0,0,0,0
questlog-questtypeicon-alliance,21611,2429,18,18,93,111,1,19,23782,0,0,0,0
questlog-questtypeicon-class,21612,2429,18,18,1,19,25,43,23783,0,0,0,0
questlog-questtypeicon-daily,21613,2429,18,18,1,19,45,63,23784,0,0,0,0
questlog-questtypeicon-dungeon,21614,2429,18,18,1,19,85,103,23785,0,0,0,0
questlog-questtypeicon-group,21615,2429,18,18,1,19,105,123,23786,0,0,0,0
questlog-questtypeicon-heroic,21616,2429,18,18,21,39,25,43,23787,0,0,0,0
questlog-questtypeicon-horde,21617,2429,18,18,21,39,45,63,23788,0,0,0,0
questlog-questtypeicon-legendary,21618,2429,18,18,21,39,105,123,23789,0,0,0,0
questlog-questtypeicon-legendaryturnin,21619,2429,18,18,41,59,25,43,23790,0,0,0,0
questlog-questtypeicon-lock,21620,2429,18,18,61,79,25,43,23791,0,0,0,0
questlog-questtypeicon-monthly,21621,2429,18,18,81,99,25,43,23792,0,0,0,0
questlog-questtypeicon-pvp,21622,2429,18,18,101,119,25,43,23793,0,0,0,0
questlog-questtypeicon-quest,21623,2429,18,18,41,59,45,63,23794,0,0,0,0
questlog-questtypeicon-questfailed,21624,2429,18,18,41,59,65,83,23795,0,0,0,0
questlog-questtypeicon-raid,21625,2429,18,18,41,59,85,103,23796,0,0,0,0
questlog-questtypeicon-scenario,21626,2429,18,18,81,99,45,63,23797,0,0,0,0
questlog-questtypeicon-story,21627,2429,18,18,101,119,45,63,23798,0,0,0,0
questlog-questtypeicon-weekly,21628,2429,18,18,61,79,65,83,23799,0,0,0,0
dragonriding-barbershop-icon-slitherdrake,21740,2070,128,128,447,575,261,389,23901,0,0,0,0
lootroll-resizehandle,21741,2421,36,12,471,507,175,187,23902,0,0,0,0
campaign_exilesreach,21742,2438,608,138,1,609,1,139,23903,0,0,0,2
questbg-exilesreach,21743,2439,299,407,1,300,1,408,23904,0,0,0,0
questlog_line_scrollbar,21744,103,27,506,1157,1184,421,927,23905,0,0,0,0
ui-hud-unitframe-highcontrast-target-portraiton-type,21904,2445,139,18,343,482,371,389,24008,0,0,0,0
ui-hud-unitframe-highcontrast-target-minusmob-portraiton,21905,2445,192,67,201,393,298,365,24009,0,0,0,0
ui-hud-unitframe-player-portraiton-vehicle-outerglow,21906,2445,228,108,239,467,1,109,24010,0,0,0,0
ui-hud-unitframe-highcontrast-targetoftarget-portraiton,21907,2445,120,49,195,315,447,496,24011,0,0,0,0
ui-hud-unitframe-player-portraiton-outerglow,21908,2445,223,99,1,224,111,210,24012,0,0,0,0
ui-hud-unitframe-highcontrast-target-portraiton-vehicle,21909,2445,198,81,205,403,212,293,24013,0,0,0,0
ui-hud-unitframe-target-portraiton-outerglow,21910,2445,236,108,1,237,1,109,24014,0,0,0,0
ui-hud-unitframe-highcontrast-targetoftarget-portraiton-type,21911,2445,96,16,405,501,212,228,24015,0,0,0,0
ui-hud-unitframe-targetoftarget-portraiton-outerglow,21912,2445,146,74,195,341,371,445,24016,0,0,0,0
ui-hud-unitframe-target-minusmob-portraiton-outerglow,21913,2445,219,93,226,445,111,204,24017,0,0,0,0
ui-hud-unitframe-highcontrast-player-portraiton,21914,2445,198,71,1,199,298,369,24018,0,0,0,0
ui-hud-unitframe-highcontrast-target-portraiton,21915,2445,192,67,1,193,371,438,24019,0,0,0,0
ui-hud-unitframe-highcontrast-player-portraiton-vehicle,21916,2445,202,84,1,203,212,296,24020,0,0,0,0
ui-hud-unitframe-highcontrast-target-rare-portraiton,21917,2445,192,67,1,193,440,507,24021,0,0,0,0
,21918,2445,9,5,0,0,0,0,24022,0,0,0,0
,21919,2445,11,9,0,0,0,0,24023,0,0,0,0
,21920,2445,11,11,0,0,0,0,24024,0,0,0,0
,21921,2445,11,12,0,0,0,0,24025,0,0,0,0
fyrakk_bounds1,21922,2406,43,31,1,44,944,975,24026,0,0,0,0
fyrakk_bounds2,21923,2406,60,47,176,236,781,828,24027,0,0,0,0
auctionhouse-ui-row-highlightinverse,21924,1495,116,18,431,547,491,509,24028,0,0,0,0
shop-card-full-y46,21925,2446,568,463,1,569,1,464,24029,0,0,0,0
shop-card-full-y47,21926,2447,568,463,1,569,1,464,24030,0,0,0,0
minimap-genericevent-hornicon-small,21927,647,37,35,641,678,263,298,24031,25,24,0,0
lootroll-icon-disenchant,21949,2421,20,20,479,499,119,139,24053,0,0,0,0
lootroll-icon-greed,21950,2421,20,20,479,499,147,167,24054,0,0,0,0
lootroll-icon-need,21951,2421,20,20,35,55,261,281,24055,0,0,0,0
lootroll-icon-pass,21952,2421,20,20,35,55,295,315,24056,0,0,0,0
lootroll-icon-transmog,21953,2421,20,20,35,55,329,349,24057,0,0,0,0
fyrakk-head-icon-grey,21961,647,80,80,905,985,1,81,24058,54,54,0,0
fyrakk_flame_trail2,21969,2406,52,135,55,107,781,916,24059,0,0,0,0
fyrakk_shadow,21970,2406,104,81,106,210,675,756,24060,0,0,0,0
lootroll-toast-icon-disenchant-down,22015,2421,32,32,1,33,261,293,24105,0,0,0,0
lootroll-toast-icon-disenchant-highlight,22016,2421,32,32,1,33,295,327,24106,0,0,0,0
lootroll-toast-icon-disenchant-up,22017,2421,32,32,1,33,329,361,24107,0,0,0,0
lootroll-toast-icon-greed-down,22018,2421,32,32,1,33,363,395,24108,0,0,0,0
lootroll-toast-icon-greed-highlight,22019,2421,32,32,1,33,397,429,24109,0,0,0,0
lootroll-toast-icon-greed-up,22020,2421,32,32,1,33,431,463,24110,0,0,0,0
lootroll-toast-icon-need-down,22021,2421,32,32,1,33,465,497,24111,0,0,0,0
lootroll-toast-icon-need-highlight,22022,2421,32,32,65,97,203,235,24112,0,0,0,0
lootroll-toast-icon-need-up,22023,2421,32,32,65,97,237,269,24113,0,0,0,0
lootroll-toast-icon-pass-down,22024,2421,32,32,65,97,271,303,24114,0,0,0,0
lootroll-toast-icon-pass-highlight,22025,2421,32,32,65,97,305,337,24115,0,0,0,0
lootroll-toast-icon-pass-up,22026,2421,32,32,65,97,339,371,24116,0,0,0,0
lootroll-toast-icon-transmog-down,22027,2421,32,32,65,97,373,405,24117,0,0,0,0
lootroll-toast-icon-transmog-highlight,22028,2421,32,32,65,97,407,439,24118,0,0,0,0
lootroll-toast-icon-transmog-up,22029,2421,32,32,65,97,441,473,24119,0,0,0,0
cursor_pickup_128,22030,2455,128,128,1,129,1,129,24120,0,0,0,0
cursor_pickup_32,22031,2455,32,32,261,293,67,99,24121,0,0,0,0
cursor_pickup_48,22032,2455,48,48,393,441,1,49,24122,0,0,0,0
cursor_pickup_64,22033,2455,64,64,261,325,1,65,24123,0,0,0,0
cursor_pickup_96,22034,2455,96,96,1,97,131,227,24124,0,0,0,0
cursor_unablepickup_128,22035,2455,128,128,131,259,1,129,24125,0,0,0,0
cursor_unablepickup_32,22036,2455,32,32,261,293,101,133,24126,0,0,0,0
cursor_unablepickup_48,22037,2455,48,48,443,491,1,49,24127,0,0,0,0
cursor_unablepickup_64,22038,2455,64,64,327,391,1,65,24128,0,0,0,0
cursor_unablepickup_96,22039,2455,96,96,131,227,131,227,24129,0,0,0,0
splash-10102-botleft,22043,2457,137,371,374,511,587,958,24133,0,0,0,0
splash-10102-right,22044,2457,510,584,1,511,1,585,24134,0,0,0,0
splash-10102-topleft,22045,2457,371,434,1,372,587,1021,24135,0,0,0,0
splash-1010-botleft,22046,2456,137,371,374,511,587,958,24136,0,0,0,0
splash-1010-right,22047,2456,510,584,1,511,1,585,24137,0,0,0,0
splash-1010-topleft,22048,2456,371,434,1,372,587,1021,24138,0,0,0,0
professions-icon-crafter,22049,1933,21,19,1938,1959,1,20,24139,0,0,0,0
professions-icon-customer,22050,1933,21,19,1863,1884,1,20,24140,0,0,0,0
professions_icon_warning,22054,1933,24,21,1282,1306,29,50,24141,0,0,0,0
lootroll-animreveal-a,22057,2460,768,228,1137,1905,1,229,24144,0,0,0,0
lootroll-animreveal-b,22058,2460,540,300,1137,1677,231,531,24145,0,0,0,0
lootroll-animdice,22059,2460,290,666,845,1135,1,667,24146,0,0,0,0
lootroll-animdiceglow,22064,2460,350,760,493,843,1,761,24151,0,0,0,0
lootroll-animrevealfade,22065,2460,490,660,1,491,1,661,24152,0,0,0,0
ui-lfg-declinemark,22084,2462,200,200,1801,2001,1,201,24171,40,40,0,0
ui-lfg-dividerline,22085,2462,368,4,517,885,773,777,24172,0,0,0,0
ui-lfg-pendingmark,22086,2462,200,200,1543,1743,259,459,24173,40,40,0,0
ui-lfg-readymark,22087,2462,200,200,1745,1945,259,459,24174,40,40,0,0
ui-lfg-roleicon-decline,22088,2462,256,256,1543,1799,1,257,24175,70,70,0,0
ui-lfg-roleicon-dps-background,22089,2462,512,512,1,513,1,513,24176,100,100,0,0
ui-lfg-roleicon-dps-disabled,22090,2462,256,256,1,257,773,1029,24177,70,70,0,0
ui-lfg-roleicon-dps-micro,22091,2462,61,61,1,62,1805,1866,24178,0,0,0,0
ui-lfg-roleicon-dps,22092,2462,256,256,1,257,515,771,24179,70,70,0,0
ui-lfg-roleicon-generic-disabled,22093,2462,256,256,1,257,1289,1545,24180,70,70,0,0
ui-lfg-roleicon-generic-micro,22094,2462,61,61,1,62,1868,1929,24181,0,0,0,0
ui-lfg-roleicon-generic,22095,2462,256,256,1,257,1031,1287,24182,70,70,0,0
ui-lfg-roleicon-healer-background,22096,2462,512,512,515,1027,1,513,24183,100,100,0,0
ui-lfg-roleicon-healer-disabled,22097,2462,256,256,259,515,515,771,24184,70,70,0,0
ui-lfg-roleicon-healer-micro,22098,2462,61,61,1,62,1931,1992,24185,0,0,0,0
ui-lfg-roleicon-healer,22099,2462,256,256,1,257,1547,1803,24186,70,70,0,0
ui-lfg-roleicon-incentive,22100,2462,256,256,259,515,773,1029,24187,70,70,0,0
ui-lfg-roleicon-leader-disabled,22101,2462,256,256,259,515,1289,1545,24188,70,70,0,0
ui-lfg-roleicon-leader-micro,22102,2462,61,61,64,125,1805,1866,24189,0,0,0,0
ui-lfg-roleicon-leader,22103,2462,256,256,259,515,1031,1287,24190,70,70,0,0
ui-lfg-roleicon-pending,22104,2462,256,256,259,515,1547,1803,24191,70,70,0,0
ui-lfg-roleicon-rangeddps-disabled,22105,2462,256,256,775,1031,515,771,24192,70,70,0,0
ui-lfg-roleicon-rangeddps-micro,22106,2462,61,61,127,188,1805,1866,24193,0,0,0,0
ui-lfg-roleicon-rangeddps,22107,2462,256,256,517,773,515,771,24194,70,70,0,0
ui-lfg-roleicon-ready,22108,2462,256,256,1033,1289,515,771,24195,70,70,0,0
ui-lfg-roleicon-tank-background,22109,2462,512,512,1029,1541,1,513,24196,100,100,0,0
ui-lfg-roleicon-tank-disabled,22110,2462,256,256,1549,1805,515,771,24197,70,70,0,0
ui-lfg-roleicon-tank-micro,22111,2462,61,61,190,251,1805,1866,24198,0,0,0,0
ui-lfg-roleicon-tank,22112,2462,256,256,1291,1547,515,771,24199,70,70,0,0
ui-hud-unitframe-player-portraiton-classresource,22125,2060,198,74,808,1006,1,75,24213,0,0,0,0
unit_evoker_ebonmight_endcap_1x,22141,2469,10,19,1,11,26,45,24263,0,0,0,0
unit_evoker_ebonmight_fill_1x,22142,2469,126,10,1,127,1,11,24264,0,0,0,0
unit_evoker_ebonmight_highlight_1x,22143,2469,76,11,1,77,13,24,24265,0,0,0,0
unit_evoker_ebonmight_endcap_2x,22144,2470,20,35,1,21,24,59,24263,0,0,0,0
unit_evoker_ebonmight_fill_2x,22145,2470,250,21,1,251,1,22,24264,0,0,0,0
unit_evoker_ebonmight_highlight_2x,22146,2470,156,21,23,179,24,45,24265,0,0,0,0
talents-background-evoker-augmentation,22147,2471,1612,774,1,1613,1,775,24235,0,0,0,0
spec-thumbnail-evoker-augmentation,22148,2027,306,186,1233,1539,941,1127,24236,0,0,0,0
ui-hud-unitframe-player-portraiton-classresource-bar-mana,22149,2060,124,10,521,645,313,323,24237,0,0,0,0
shop-card-full-gs1,22150,2472,568,463,1,569,1,464,24238,0,0,0,0
cursor_openhand_128,22182,2474,128,128,1,129,1,129,24241,0,0,0,0
cursor_openhand_32,22183,2474,32,32,261,293,67,99,24242,0,0,0,0
cursor_openhand_48,22184,2474,48,48,393,441,1,49,24243,0,0,0,0
cursor_openhand_64,22185,2474,64,64,261,325,1,65,24244,0,0,0,0
cursor_openhand_96,22186,2474,96,96,1,97,131,227,24245,0,0,0,0
cursor_unableopenhand_128,22187,2474,128,128,131,259,1,129,24246,0,0,0,0
cursor_unableopenhand_32,22188,2474,32,32,261,293,101,133,24247,0,0,0,0
cursor_unableopenhand_48,22189,2474,48,48,443,491,1,49,24248,0,0,0,0
cursor_unableopenhand_64,22190,2474,64,64,327,391,1,65,24249,0,0,0,0
cursor_unableopenhand_96,22191,2474,96,96,131,227,131,227,24250,0,0,0,0
cursor_questinteract_128,22192,2475,128,128,1,129,1,129,24251,0,0,0,0
cursor_questinteract_32,22193,2475,32,32,261,293,67,99,24252,0,0,0,0
cursor_questinteract_48,22194,2475,48,48,393,441,1,49,24253,0,0,0,0
cursor_questinteract_64,22195,2475,64,64,261,325,1,65,24254,0,0,0,0
cursor_questinteract_96,22196,2475,96,96,1,97,131,227,24255,0,0,0,0
cursor_unablequestinteract_128,22197,2475,128,128,131,259,1,129,24256,0,0,0,0
cursor_unablequestinteract_32,22198,2475,32,32,261,293,101,133,24257,0,0,0,0
cursor_unablequestinteract_48,22199,2475,48,48,443,491,1,49,24258,0,0,0,0
cursor_unablequestinteract_64,22200,2475,64,64,327,391,1,65,24259,0,0,0,0
cursor_unablequestinteract_96,22201,2475,96,96,131,227,131,227,24260,0,0,0,0
ui-hud-unitframe-player-portraiton-classresource-bar-energy,22202,2060,124,10,395,519,313,323,24261,0,0,0,0
ui-hud-unitframe-player-portraiton-classresource-incombat,22203,2060,192,71,399,591,87,158,24262,0,0,0,0
ui-hud-actionbar-cast-fill,22204,2476,49,46,1115,1164,403,449,24267,0,0,0,0
ui-hud-actionbar-casting-complete-glow,22205,2476,93,93,845,938,922,1015,24268,0,0,0,0
ui-hud-actionbar-casting-innerglow,22206,2476,43,43,1107,1150,498,541,24269,0,0,0,0
ui-hud-actionbar-channel-complete-glow,22207,2476,93,93,941,1034,403,496,24270,0,0,0,0
ui-hud-actionbar-channel-fill,22208,2476,49,46,1008,1057,498,544,24271,0,0,0,0
ui-hud-actionbar-channel-innerglow,22209,2476,43,43,941,984,565,608,24272,0,0,0,0
ui-hud-actionbar-gcd-flipbook,22210,2476,94,517,845,939,403,920,24273,0,0,0,0
ui-hud-actionbar-interrupt-highlight,22214,2476,47,41,1115,1162,451,492,24277,0,0,0,0
ui-hud-actionbar-interrupt,22215,2476,43,43,986,1029,565,608,24278,0,0,0,0
ui-hud-actionbar-target-highlight,22218,2476,65,65,941,1006,498,563,24281,0,0,0,0
ui-hud-actionbar-target,22219,2476,43,43,1031,1074,565,608,24282,0,0,0,0
ui-hud-actionbar-interrupt-mask,22221,2478,64,64,0,64,0,64,24284,0,0,16,0
ui-hud-actionbar-target-mask,22222,2479,64,64,0,64,0,64,24285,0,0,16,0
ui-hud-actionbar-cast-fill-2x,22223,2015,98,92,189,287,1647,1739,24267,0,0,0,2
ui-hud-actionbar-casting-complete-glow-2x,22224,2015,186,186,1,187,1533,1719,24268,0,0,0,2
ui-hud-actionbar-casting-innerglow-2x,22225,2015,86,86,189,275,1919,2005,24269,0,0,0,2
ui-hud-actionbar-channel-complete-glow-2x,22226,2015,186,186,1,187,1721,1907,24270,0,0,0,2
ui-hud-actionbar-channel-fill-2x,22227,2015,98,92,189,287,1741,1833,24271,0,0,0,2
ui-hud-actionbar-channel-innerglow-2x,22228,2015,86,86,303,389,1533,1619,24272,0,0,0,2
ui-hud-actionbar-gcd-flipbook-2x,22229,2015,140,770,1278,1418,609,1379,24273,0,0,0,0
ui-hud-actionbar-interrupt-2x,22230,2015,86,86,303,389,1621,1707,24278,0,0,0,2
ui-hud-actionbar-interrupt-highlight-2x,22231,2015,94,82,189,283,1835,1917,24277,0,0,0,2
ui-hud-actionbar-proc-loop-flipbook-2x,22232,2015,505,606,1278,1783,1,607,24279,0,0,0,0
ui-hud-actionbar-proc-start-flipbook-2x,22233,2015,1275,1530,1,1276,1,1531,24280,0,0,0,0
ui-hud-actionbar-target-2x,22234,2015,86,86,303,389,1709,1795,24282,0,0,0,2
ui-hud-actionbar-target-highlight-2x,22235,2015,130,130,1,131,1909,2039,24281,0,0,0,2
ui-hud-actionbar-interrupt-mask-2x,22237,2413,128,128,0,128,0,128,24300,0,0,16,2
ui-hud-actionbar-target-mask-2x,22238,2411,64,64,0,64,0,64,24301,0,0,16,2
cursor_importantturnin_128,22262,2483,128,128,1,129,1,129,24321,0,0,0,0
cursor_importantturnin_32,22263,2483,32,32,131,163,329,361,24322,0,0,0,0
cursor_importantturnin_48,22264,2483,48,48,1,49,457,505,24323,0,0,0,0
cursor_importantturnin_64,22265,2483,64,64,229,293,131,195,24324,0,0,0,0
cursor_importantturnin_96,22266,2483,96,96,391,487,1,97,24325,0,0,0,0
cursor_important_128,22267,2483,128,128,131,259,1,129,24326,0,0,0,0
cursor_important_32,22268,2483,32,32,131,163,363,395,24327,0,0,0,0
cursor_important_48,22269,2483,48,48,51,99,457,505,24328,0,0,0,0
cursor_important_64,22270,2483,64,64,295,359,131,195,24329,0,0,0,0
cursor_important_96,22271,2483,96,96,1,97,261,357,24330,0,0,0,0
cursor_unableimportantturnin_128,22272,2483,128,128,261,389,1,129,24331,0,0,0,0
cursor_unableimportantturnin_32,22273,2483,32,32,131,163,397,429,24332,0,0,0,0
cursor_unableimportantturnin_48,22274,2483,48,48,131,179,229,277,24333,0,0,0,0
cursor_unableimportantturnin_64,22275,2483,64,64,361,425,131,195,24334,0,0,0,0
cursor_unableimportantturnin_96,22276,2483,96,96,1,97,359,455,24335,0,0,0,0
cursor_unableimportant_128,22277,2483,128,128,1,129,131,259,24336,0,0,0,0
cursor_unableimportant_32,22278,2483,32,32,131,163,431,463,24337,0,0,0,0
cursor_unableimportant_48,22279,2483,48,48,131,179,279,327,24338,0,0,0,0
cursor_unableimportant_64,22280,2483,64,64,427,491,131,195,24339,0,0,0,0
cursor_unableimportant_96,22281,2483,96,96,131,227,131,227,24340,0,0,0,0
questlog-questtypeicon-clockorange,22282,2429,22,22,1,23,1,23,24341,0,0,0,0
questlog-questtypeicon-clockyellow,22283,2429,22,22,25,47,1,23,24342,0,0,0,0
questlog-questtypeicon-important,22284,2429,18,18,21,39,65,83,24343,0,0,0,0
questlog-questtypeicon-importantturnin,22285,2429,18,18,21,39,85,103,24344,0,0,0,0
ui-questpoiimportant-innerglow,22286,2484,32,36,1,33,67,103,24345,0,0,0,0
ui-questpoiimportant-outerglow,22287,2484,64,64,1,65,1,65,24346,0,0,0,0
ui-questpoiimportant-questbang,22288,2484,32,36,67,99,1,37,24347,0,0,0,0
ui-questpoiimportant-questbangturnin,22289,2484,32,36,67,99,77,113,24348,0,0,0,0
ui-questpoiimportant-questnumber-pressed-supertracked,22290,2484,32,36,101,133,77,113,24349,0,0,0,0
ui-questpoiimportant-questnumber-pressed,22291,2484,32,36,101,133,39,75,24350,0,0,0,0
ui-questpoiimportant-questnumber-supertracked,22292,2484,32,36,135,167,1,37,24351,0,0,0,0
ui-questpoiimportant-questnumber,22293,2484,32,36,101,133,1,37,24352,0,0,0,0
quest-important-available-trivial,22306,647,32,32,989,1021,477,509,24353,0,0,0,0
quest-important-available,22307,647,32,32,955,987,477,509,24354,0,0,0,0
quest-important-turnin,22308,647,32,32,479,511,511,543,24355,0,0,0,0
importantactivequesticon,22331,2485,24,24,1,25,1,25,24371,16,16,0,0
importantavailablequesticon,22332,2485,24,24,27,51,1,25,24372,16,16,0,0
importantincompletequesticon,22333,2485,24,24,1,25,27,51,24373,16,16,0,0
characterupdate_arrow-bullet-point,22385,2490,74,74,803,877,1,75,24402,37,37,0,0
characterupdate_background,22386,2490,422,708,1,423,293,1001,24403,0,0,0,0
characterupdate_clock-icon,22387,2490,38,38,879,917,1,39,24404,19,19,0,0
characterupdate_green-glow-and-filigree,22388,2490,800,290,1,801,1,291,24405,400,145,0,0
characterupdate_header,22389,2490,422,46,425,847,293,339,24406,0,0,0,0
characterupdate_line-item-bg,22390,2490,339,52,425,764,341,393,24407,0,0,0,0
characterupdate_main-icon,22392,2490,238,228,425,663,489,717,24409,119,114,0,0
characterupdate-9slice-bottomleftcorner,22393,2491,44,44,1,45,21,65,24410,0,0,0,0
characterupdate-9slice-bottomrightcorner,22394,2491,44,44,1,45,67,111,24411,0,0,0,0
characterupdate-9slice-topleftcorner,22395,2491,44,44,1,45,113,157,24412,0,0,0,0
characterupdate-9slice-toprightcorner,22396,2491,44,44,1,45,159,203,24413,0,0,0,0
_characterupdate-9slice-bottomedge,22397,2491,8,8,0,8,1,9,24414,0,0,4,0
_characterupdate-9slice-topedge,22398,2491,8,8,0,8,11,19,24415,0,0,4,0
!characterupdate-9slice-leftedge,22399,2492,8,16,1,9,0,16,24416,0,0,2,0
!characterupdate-9slice-rightedge,22400,2492,8,16,11,19,0,16,24417,0,0,2,0
!characterupdate-9slice-leftedge-selected,22401,2493,8,16,1,9,0,16,24418,0,0,2,0
!characterupdate-9slice-rightedge-selected,22402,2493,8,16,11,19,0,16,24419,0,0,2,0
characterupdate-9slice-bottomleftcorner-selected,22403,2494,44,44,1,45,21,65,24420,0,0,0,0
characterupdate-9slice-bottomrightcorner-selected,22404,2494,44,44,1,45,67,111,24421,0,0,0,0
characterupdate-9slice-topleftcorner-selected,22405,2494,44,44,1,45,113,157,24422,0,0,0,0
characterupdate-9slice-toprightcorner-selected,22406,2494,44,44,1,45,159,203,24423,0,0,0,0
_characterupdate-9slice-bottomedge-selected,22407,2494,8,8,0,8,1,9,24424,0,0,4,0
_characterupdate-9slice-topedge-selected,22408,2494,8,8,0,8,11,19,24425,0,0,4,0
cursor_track_128,22424,2497,128,128,1,129,1,129,24436,0,0,0,0
cursor_track_32,22425,2497,32,32,261,293,67,99,24437,0,0,0,0
cursor_track_48,22426,2497,48,48,393,441,1,49,24438,0,0,0,0
cursor_track_64,22427,2497,64,64,261,325,1,65,24439,0,0,0,0
cursor_track_96,22428,2497,96,96,1,97,131,227,24440,0,0,0,0
cursor_unabletrack_128,22429,2497,128,128,131,259,1,129,24441,0,0,0,0
cursor_unabletrack_32,22430,2497,32,32,261,293,101,133,24442,0,0,0,0
cursor_unabletrack_48,22431,2497,48,48,443,491,1,49,24443,0,0,0,0
cursor_unabletrack_64,22432,2497,64,64,327,391,1,65,24444,0,0,0,0
cursor_unabletrack_96,22433,2497,96,96,131,227,131,227,24445,0,0,0,0
ui-hud-minimap-mail-new-flipbook,22443,2482,210,263,1,211,1,264,24453,0,0,0,0
ui-hud-minimap-mail-reminder-flipbook,22444,2482,210,158,1,211,266,424,24454,0,0,0,0
ui-hud-minimap-mail-new-flipbook-2x,22445,2498,420,525,1,421,1,526,24455,0,0,0,0
ui-hud-minimap-mail-reminder-flipbook-2x,22446,2498,420,315,1,421,528,843,24456,0,0,0,0
activities-complete-background,22447,1939,508,267,789,1297,279,546,24457,0,0,0,0
activities-complete-threeslice-edgebottom,22448,1939,521,16,1,522,978,994,24475,0,0,0,0
activities-complete-threeslice-center,22449,1939,521,46,1312,1833,199,245,24476,0,0,0,0
activities-complete-threeslice-edgetop,22450,1939,521,16,1,522,996,1012,24477,0,0,0,0
activities-incomplete-active-threeslice-edgebottom,22451,1939,528,17,1299,1827,411,428,24478,0,0,0,0
activities-incomplete-active-threeslice-center,22452,1939,528,50,1299,1827,359,409,24479,0,0,0,0
activities-incomplete-active-threeslice-edgetop,22453,1939,528,18,1312,1840,247,265,24480,0,0,0,0
activities-incomplete-background,22454,1939,508,267,1250,1758,596,863,24464,0,0,0,0
activities-incomplete-border-threeslice-edgebottom,22455,1939,521,16,1299,1820,518,534,24481,0,0,0,0
activities-incomplete-border-threeslice-center,22456,1939,521,46,1250,1771,548,594,24466,0,0,0,0
activities-incomplete-border-threeslice-edgetop,22457,1939,521,16,1250,1771,898,914,24482,0,0,0,0
activities-ribbon-stacked,22458,1939,84,54,1309,1393,121,175,24468,0,0,0,0
campaign_headericon_closed,22459,1939,22,22,758,780,549,571,11839,0,0,0,0
campaign_headericon_closedpressed,22460,1939,22,22,719,741,492,514,11840,0,0,0,0
campaign_headericon_closedpressed_alt,22461,1939,22,22,758,780,525,547,24469,0,0,0,0
campaign_headericon_closed_alt,22462,1939,22,22,743,765,492,514,24470,0,0,0,0
campaign_headericon_open,22463,1939,22,22,582,604,692,714,11841,0,0,0,0
campaign_headericon_openpressed,22464,1939,22,22,618,640,696,718,11842,0,0,0,0
campaign_headericon_openpressed_alt,22465,1939,22,22,642,664,696,718,24471,0,0,0,0
campaign_headericon_open_alt,22466,1939,22,22,758,780,573,595,24472,0,0,0,0
ui-hud-actionbar-castingchannel-complete-mask-2x,22467,2023,128,128,0,128,0,128,24474,0,0,16,2
ui-hud-actionbar-castingchannel-complete-mask,22468,2477,64,64,0,64,0,64,24283,0,0,16,0
characterupdate_minimized_background,22474,2490,422,92,425,847,395,487,24487,0,0,0,0
glue-characterselect-drag,22531,2503,256,64,1,257,1,65,24543,0,0,0,0
challenges-medal-bronze,22532,2504,220,220,1,221,1,221,24544,0,0,0,0
challenges-medal-gold,22533,2504,220,220,223,443,1,221,24545,0,0,0,0
challenges-medal-silver,22534,2504,220,220,1,221,223,443,24546,0,0,0,0
challenges-medal-small-bronze,22535,2504,40,40,445,485,1,41,24547,20,20,0,0
challenges-medal-small-gold,22536,2504,40,40,445,485,43,83,24548,20,20,0,0
challenges-medal-small-silver,22537,2504,40,40,445,485,85,125,24549,20,20,0,0
shop-card-full-j95,22544,2505,568,463,1,569,1,464,24556,0,0,0,0
charactercreate-warlockpet-felguard,22557,897,64,64,1951,2015,1,65,24569,0,0,0,0
charactercreate-warlockpet-felhunter,22558,897,64,64,1041,1105,651,715,24570,0,0,0,0
charactercreate-warlockpet-imp,22559,897,64,64,1041,1105,717,781,24571,0,0,0,0
charactercreate-warlockpet-sayaad-incubus,22560,897,64,64,1041,1105,849,913,24572,0,0,0,0
charactercreate-warlockpet-sayaad-succubus,22561,897,64,64,1041,1105,915,979,24573,0,0,0,0
charactercreate-warlockpet-sayaad-succubusincubus,22562,897,64,64,1171,1235,131,195,24574,0,0,0,0
charactercreate-warlockpet-voidwalker,22563,897,64,64,1303,1367,131,195,24575,0,0,0,0
ui-frame-genericplayerchoice-button,22754,2249,250,50,1,251,1944,1994,24636,0,0,0,0
ui-frame-genericplayerchoice-cardframe-bottomglow,22755,2249,279,259,1,280,1683,1942,24637,0,0,0,0
ui-frame-genericplayerchoice-cardframe-gold-glow,22756,2249,202,201,282,484,1683,1884,24638,0,0,0,0
ui-frame-genericplayerchoice-cardframe,22758,2249,286,578,1698,1984,607,1185,24640,0,0,0,0
ui-frame-genericplayerchoice-cardparchment,22759,2249,298,590,1398,1696,607,1197,21505,0,0,0,0
ui-frame-genericplayerchoice-goldflakefx-flipbook,22760,2249,1395,1680,1,1396,1,1681,24641,0,0,0,0
ui-frame-genericplayerchoice-portrait-back,22761,2249,73,73,628,701,1967,2040,24642,0,0,0,0
ui-frame-genericplayerchoice-portrait-border-glow,22762,2249,95,95,1196,1291,1683,1778,24643,0,0,0,0
ui-frame-genericplayerchoice-portrait-border,22763,2249,79,79,486,565,1967,2046,21506,64,64,0,0
ui-frame-genericplayerchoice-portrait-qualityepic-01,22764,2249,140,140,282,422,1886,2026,24644,0,0,0,0
ui-frame-genericplayerchoice-portrait-qualityepic-02,22765,2249,140,140,486,626,1683,1823,24645,0,0,0,0
ui-frame-genericplayerchoice-portrait-qualitygeneric-01,22766,2249,140,140,486,626,1825,1965,24646,0,0,0,0
ui-frame-genericplayerchoice-portrait-qualitygeneric-02,22767,2249,140,140,628,768,1683,1823,24647,0,0,0,0
ui-frame-genericplayerchoice-portrait-qualitylegendary-01,22768,2249,140,140,628,768,1825,1965,24648,0,0,0,0
ui-frame-genericplayerchoice-portrait-qualitylegendary-02,22769,2249,140,140,770,910,1683,1823,24649,0,0,0,0
ui-frame-genericplayerchoice-portrait-qualityrare-01,22770,2249,140,140,770,910,1825,1965,24650,0,0,0,0
ui-frame-genericplayerchoice-portrait-qualityrare-02,22771,2249,140,140,912,1052,1683,1823,24651,0,0,0,0
ui-frame-genericplayerchoice-portrait-qualityuncommon-01,22772,2249,140,140,912,1052,1825,1965,24652,0,0,0,0
ui-frame-genericplayerchoice-portrait-qualityuncommon-02,22773,2249,140,140,1054,1194,1683,1823,24653,0,0,0,0
cursor_openhandglow_128,22776,2509,128,128,1,129,1,129,24655,0,0,0,0
cursor_openhandglow_32,22777,2509,32,32,261,293,67,99,24656,0,0,0,0
cursor_openhandglow_48,22778,2509,48,48,393,441,1,49,24657,0,0,0,0
cursor_openhandglow_64,22779,2509,64,64,261,325,1,65,24658,0,0,0,0
cursor_openhandglow_96,22780,2509,96,96,1,97,131,227,24659,0,0,0,0
ui-merchant-botframe,22781,2506,332,61,1,333,1,62,24561,0,0,0,0
ui-frame-genericplayerchoice-cardframe-gold-mask,22782,2510,1024,1024,0,1024,0,1024,24660,0,0,16,0
ui-frame-genericplayerchoice-cardframe-silver-mask,22783,2511,1024,1024,0,1024,0,1024,24661,0,0,16,0
ui-frame-genericplayerchoice-portrait-border-mask,22784,2512,128,128,0,128,0,128,24662,0,0,16,0
ui-frame-genericplayerchoice-titanlines-mask,22785,2513,256,256,0,256,0,256,24663,0,0,16,0
ui-frame-genericplayerchoice-titanlines-glow,22786,2514,295,512,1,296,0,512,24654,0,0,2,0
radial_wheel_barbg_cooldown-2x,22867,2508,580,580,595,1175,759,1339,24525,0,0,0,0
radial_wheel_barbg_cooldown_small-2x,22868,2508,290,290,1469,1759,1139,1429,24526,0,0,0,0
radial_wheel_bar_cooldown-2x,22869,2508,580,580,1,581,1353,1933,24527,0,0,0,0
radial_wheel_bar_cooldown_small-2x,22870,2508,290,290,1177,1467,1139,1429,24528,0,0,0,0
radial_wheel_bg-2x,22871,2508,756,756,1,757,1,757,24529,0,0,0,0
radial_wheel_bg_small-2x,22872,2508,378,378,595,973,1341,1719,24530,0,0,0,0
radial_wheel_frame_cooldown_count_4-2x,22873,2508,376,376,1557,1933,759,1135,24531,0,0,0,0
radial_wheel_frame_cooldown_count_4_small-2x,22874,2508,188,188,975,1163,1341,1529,24532,0,0,0,0
radial_wheel_frame_count_4-2x,22875,2508,756,756,759,1515,1,757,24533,0,0,0,0
radial_wheel_frame_count_4_small-2x,22876,2508,378,378,1177,1555,759,1137,24534,0,0,0,0
radial_wheel_icon_close-2x,22877,2508,48,48,1785,1833,579,627,24535,0,0,0,0
radial_wheel_icon_close_small-2x,22878,2508,24,24,1835,1859,579,603,24536,0,0,0,0
radial_wheel_select_close-2x,22879,2508,96,96,1687,1783,579,675,24537,0,0,0,0
radial_wheel_select_close_small-2x,22880,2508,48,48,1687,1735,677,725,24538,0,0,0,0
radial_wheel_select_pointer-2x,22881,2508,168,168,1517,1685,579,747,24539,0,0,0,0
radial_wheel_select_pointer_small-2x,22882,2508,84,84,1863,1947,291,375,24540,0,0,0,0
radial_wheel_select_wedge_count_4-2x,22883,2508,344,576,1517,1861,1,577,24542,0,0,0,0
radial_wheel_select_wedge_count_4_small-2x,22884,2508,172,288,1863,2035,1,289,24634,0,0,0,0
radial_wheel_barbg_cooldown,22885,2502,290,290,299,589,381,671,24525,0,0,0,0
radial_wheel_barbg_cooldown_small,22886,2502,145,145,738,883,572,717,24526,0,0,0,0
radial_wheel_bar_cooldown,22887,2502,290,290,1,291,679,969,24527,0,0,0,0
radial_wheel_bar_cooldown_small,22888,2502,145,145,591,736,572,717,24528,0,0,0,0
radial_wheel_bg,22889,2502,378,378,1,379,1,379,24529,0,0,0,0
radial_wheel_bg_small,22890,2502,189,189,299,488,673,862,24530,0,0,0,0
radial_wheel_frame_cooldown_count_4,22891,2502,188,188,782,970,381,569,24531,0,0,0,0
radial_wheel_frame_cooldown_count_4_small,22892,2502,94,94,490,584,673,767,24532,0,0,0,0
radial_wheel_frame_count_4,22893,2502,378,378,381,759,1,379,24533,0,0,0,0
radial_wheel_frame_count_4_small,22894,2502,189,189,591,780,381,570,24534,0,0,0,0
radial_wheel_icon_close,22895,2502,24,24,897,921,291,315,24535,0,0,0,0
radial_wheel_icon_close_small,22896,2502,12,12,897,909,317,329,24536,0,0,0,0
radial_wheel_select_close,22897,2502,48,48,847,895,291,339,24537,0,0,0,0
radial_wheel_select_close_small,22898,2502,24,24,847,871,341,365,24538,0,0,0,0
radial_wheel_select_pointer,22899,2502,84,84,761,845,291,375,24539,0,0,0,0
radial_wheel_select_pointer_small,22900,2502,42,42,935,977,147,189,24540,0,0,0,0
radial_wheel_select_wedge_count_4,22901,2502,172,288,761,933,1,289,24542,0,0,0,0
radial_wheel_select_wedge_count_4_small,22902,2502,86,144,935,1021,1,145,24634,0,0,0,0
ui-frame-genericplayerchoice-cardframe-silver-glow,22937,2249,602,604,1398,2000,1,605,24639,0,0,0,0
ui-frame-genericplayerchoice-button-highlight-mask,23027,2515,256,256,0,256,0,256,24674,0,0,16,0
ui-hud-micromenu-buttonbg-down-2x,23029,2136,64,82,67,131,169,251,24677,32,41,0,0
ui-hud-micromenu-buttonbg-up-2x,23030,2136,64,82,67,131,253,335,24678,32,41,0,0
ui-hud-micromenu-portrait-mask-2x,23033,2519,64,128,0,64,0,128,24681,32,64,16,0
ui-hud-micromenu-portrait-shadow-2x,23035,2136,64,82,331,395,169,251,24682,32,41,0,0
spellicon-256x256-selljunk,23039,2506,72,72,1,73,64,136,24560,0,0,0,0
secretsofazeroth-tuskarrmonument,23040,2520,241,265,1,242,1,266,24683,0,0,0,0
charactercreate-warlockpet-doomguard,23041,897,64,64,911,975,911,975,24684,0,0,0,0
charactercreate-warlockpet-infernal,23042,897,64,64,1041,1105,783,847,24685,0,0,0,0
ui-hud-micromenu-portrait-down-2x,23043,2136,64,82,331,395,85,167,24686,32,41,0,0
ui-hud-micromenu-guildcommunities-guildcolor-disabled-2x,23047,2136,64,82,265,329,1,83,24884,32,41,0,0
ui-hud-micromenu-guildcommunities-guildcolor-down-2x,23048,2136,64,82,265,329,85,167,24885,32,41,0,0
ui-hud-micromenu-guildcommunities-guildcolor-mouseover-2x,23049,2136,64,82,265,329,169,251,24886,32,41,0,0
ui-hud-micromenu-guildcommunities-guildcolor-up-2x,23050,2136,64,82,265,329,253,335,24887,32,41,0,0
ui-hud-actionbar-proc-loop-flipbook,23052,2476,333,400,845,1178,1,401,24279,0,0,0,0
ui-hud-actionbar-proc-start-flipbook,23053,2476,842,1010,1,843,1,1011,24280,0,0,0,0
ui-hud-unitframe-player-portrait-classicon-deathknight-2x,23062,2522,120,120,1,121,1,121,24703,60,60,0,0
ui-hud-unitframe-player-portrait-classicon-demonhunter-2x,23063,2522,120,120,123,243,1,121,24704,60,60,0,0
ui-hud-unitframe-player-portrait-classicon-druid-2x,23064,2522,120,120,245,365,1,121,24705,60,60,0,0
ui-hud-unitframe-player-portrait-classicon-evoker-2x,23065,2522,120,120,367,487,1,121,24706,60,60,0,0
ui-hud-unitframe-player-portrait-classicon-hunter-2x,23066,2522,120,120,1,121,123,243,24707,60,60,0,0
ui-hud-unitframe-player-portrait-classicon-mage-2x,23067,2522,120,120,1,121,245,365,24708,60,60,0,0
ui-hud-unitframe-player-portrait-classicon-monk-2x,23068,2522,120,120,1,121,367,487,24709,60,60,0,0
ui-hud-unitframe-player-portrait-classicon-paladin-2x,23069,2522,120,120,123,243,123,243,24710,60,60,0,0
ui-hud-unitframe-player-portrait-classicon-priest-2x,23070,2522,120,120,245,365,123,243,24711,60,60,0,0
ui-hud-unitframe-player-portrait-classicon-rogue-2x,23071,2522,120,120,367,487,123,243,24712,60,60,0,0
ui-hud-unitframe-player-portrait-classicon-shaman-2x,23072,2522,120,120,123,243,245,365,24713,60,60,0,0
ui-hud-unitframe-player-portrait-classicon-warlock-2x,23073,2522,120,120,123,243,367,487,24714,60,60,0,0
ui-hud-unitframe-player-portrait-classicon-warrior-2x,23074,2522,120,120,245,365,245,365,24715,60,60,0,0
ui-hud-actionbar-stackcooldown,23126,2516,128,128,1,129,1,129,24486,0,0,0,0
shop-vc2,23129,2525,292,225,1,293,1,226,24769,0,0,0,0
shop-vc3,23130,2526,292,225,1,293,1,226,24770,0,0,0,0
shop-vc4,23131,2527,292,225,1,293,1,226,24771,0,0,0,0
shop-vc5,23132,2528,377,242,1,378,1,243,24772,0,0,0,0
shop-vc6,23133,2529,377,242,1,378,1,243,24773,0,0,0,0
shop-vc7,23148,2530,377,242,1,378,1,243,24782,0,0,0,0
shop-vc8,23151,2531,377,242,1,378,1,243,24783,0,0,0,0
shop-vc9,23152,2532,377,242,1,378,1,243,24784,0,0,0,0
shop-vc10,23153,2533,377,242,1,378,1,243,24774,0,0,0,0
shop-vc11,23154,2534,377,242,1,378,1,243,24775,0,0,0,0
shop-vc12,23155,2535,439,327,1,440,1,328,24776,0,0,0,0
shop-vc13,23156,2536,439,327,1,440,1,328,24777,0,0,0,0
shop-vc14,23157,2537,439,327,1,440,1,328,24778,0,0,0,0
shop-vc15,23158,2538,439,327,1,440,1,328,24779,0,0,0,0
shop-vc16,23159,2539,439,327,1,440,1,328,24780,0,0,0,0
shop-vc17,23160,2540,439,327,1,440,1,328,24781,0,0,0,0
perks-hold-nineslice-cornerbottomleft,23161,1918,40,40,983,1023,334,374,18585,0,0,0,0
cursor_unableopenhandglow_128,23282,2509,128,128,131,259,1,129,24811,0,0,0,0
cursor_unableopenhandglow_32,23283,2509,32,32,261,293,101,133,24812,0,0,0,0
cursor_unableopenhandglow_48,23284,2509,48,48,443,491,1,49,24813,0,0,0,0
cursor_unableopenhandglow_64,23285,2509,64,64,327,391,1,65,24814,0,0,0,0
cursor_unableopenhandglow_96,23286,2509,96,96,131,227,131,227,24815,0,0,0,0
ping_groundmarker_bg_assist,23287,2501,58,58,785,843,235,293,24488,0,0,0,0
ping_groundmarker_bg_attack,23288,2501,58,58,863,921,235,293,24489,0,0,0,0
ping_groundmarker_bg_onmyway,23289,2501,58,58,799,857,380,438,24490,0,0,0,0
ping_groundmarker_bg_warning,23290,2501,58,58,876,934,303,361,24491,0,0,0,0
ping_groundmarker_pin_assist,23291,2501,4,114,409,413,771,885,24496,0,0,0,0
ping_groundmarker_pin_attack,23292,2501,4,114,409,413,887,1001,24497,0,0,0,0
ping_groundmarker_pin_onmyway,23293,2501,4,114,415,419,887,1001,24498,0,0,0,0
ping_groundmarker_pin_warning,23294,2501,4,114,421,425,771,885,24499,0,0,0,0
ping_groundmarker_stroke_assist,23295,2501,58,58,936,994,303,361,24785,0,0,0,0
ping_groundmarker_stroke_attack,23296,2501,58,58,876,934,363,421,24786,0,0,0,0
ping_groundmarker_stroke_onmyway,23297,2501,58,58,936,994,363,421,24787,0,0,0,0
ping_groundmarker_stroke_warning,23298,2501,58,58,936,994,423,481,24788,0,0,0,0
ping_mappin_assist,23299,2501,16,20,845,861,235,255,24816,0,0,0,0
ping_mappin_attack,23300,2501,16,20,845,861,257,277,24817,0,0,0,0
ping_mappin_glw,23301,2501,16,20,845,861,279,299,24818,0,0,0,0
ping_mappin_nonthreat,23302,2501,16,20,923,939,235,255,24819,0,0,0,0
ping_mappin_onmyway,23303,2501,16,20,923,939,257,277,24820,0,0,0,0
ping_mappin_warning,23304,2501,16,20,1001,1017,235,255,24821,0,0,0,0
ping_map_assist,23305,2501,23,23,996,1019,303,326,24822,0,0,0,0
ping_map_assistglw,23306,2501,23,23,996,1019,328,351,24823,0,0,0,0
ping_map_attack,23307,2501,23,23,996,1019,363,386,24824,0,0,0,0
ping_map_attackglw,23308,2501,23,23,996,1019,388,411,24825,0,0,0,0
ping_map_nonthreat,23309,2501,23,23,996,1019,423,446,24826,0,0,0,0
ping_map_nonthreatglw,23310,2501,23,23,996,1019,448,471,24827,0,0,0,0
ping_map_onmyway,23311,2501,23,23,305,328,839,862,24828,0,0,0,0
ping_map_onmywayglw,23312,2501,23,23,333,356,999,1022,24829,0,0,0,0
ping_map_warning,23313,2501,23,23,477,500,771,794,24830,0,0,0,0
ping_map_warningglw,23314,2501,15,15,1001,1016,257,272,24831,0,0,0,0
ping_marker_flipbook_assist,23315,2501,486,192,1,487,303,495,24695,0,0,0,0
ping_marker_flipbook_attack,23316,2501,330,280,1,331,497,777,24696,0,0,0,0
ping_marker_flipbook_onmyway,23317,2501,300,272,333,633,497,769,24697,0,0,0,0
ping_marker_flipbook_warning,23318,2501,192,322,635,827,497,819,24698,0,0,0,0
ping_marker_icon_assist,23319,2501,35,35,685,720,457,492,24550,0,0,0,0
ping_marker_icon_attack,23320,2501,35,35,762,797,457,492,24551,0,0,0,0
ping_marker_icon_nonthreat,23321,2501,35,35,296,331,888,923,24552,0,0,0,0
ping_marker_icon_onmyway,23322,2501,35,35,333,368,925,960,24553,0,0,0,0
ping_marker_icon_threat,23323,2501,35,35,333,368,962,997,24554,0,0,0,0
ping_marker_icon_warning,23324,2501,35,35,372,407,771,806,24555,0,0,0,0
ping_ovmarker_pointer_assist,23325,2501,75,75,567,642,381,456,24500,0,0,0,0
ping_ovmarker_pointer_attack,23326,2501,75,75,645,720,303,378,24501,0,0,0,0
ping_ovmarker_pointer_bg,23327,2501,47,47,176,223,839,886,24502,0,0,0,0
ping_ovmarker_pointer_nonthreat,23328,2501,75,75,645,720,380,455,24666,0,0,0,0
ping_ovmarker_pointer_onmyway,23329,2501,75,75,722,797,303,378,24503,0,0,0,0
ping_ovmarker_pointer_threat,23330,2501,75,75,722,797,380,455,24667,0,0,0,0
ping_ovmarker_pointer_warning,23331,2501,75,75,799,874,303,378,24504,0,0,0,0
ping_spotglw_assist_in,23332,2501,37,37,567,604,458,495,24789,0,0,0,0
ping_spotglw_assist_out,23333,2501,53,53,799,852,440,493,24790,0,0,0,0
ping_spotglw_attack_in,23334,2501,37,37,606,643,458,495,24791,0,0,0,0
ping_spotglw_attack_out,23335,2501,53,53,181,234,779,832,24792,0,0,0,0
ping_spotglw_nonthreat_in,23336,2501,37,37,256,293,928,965,24832,0,0,0,0
ping_spotglw_nonthreat_out,23337,2501,53,53,236,289,779,832,24833,0,0,0,0
ping_spotglw_onmyway_in,23338,2501,37,37,256,293,967,1004,24793,0,0,0,0
ping_spotglw_onmyway_out,23339,2501,53,53,121,174,839,892,24794,0,0,0,0
ping_spotglw_threat_in,23340,2501,37,37,333,370,771,808,24834,0,0,0,0
ping_spotglw_threat_out,23341,2501,53,53,121,174,894,947,24835,0,0,0,0
ping_spotglw_warning_in,23342,2501,37,37,333,370,810,847,24795,0,0,0,0
ping_spotglw_warning_out,23343,2501,53,53,121,174,949,1002,24796,0,0,0,0
ping_unitmarker_bg,23344,2501,58,58,1,59,779,837,24797,0,0,0,0
ping_unitmarker_bg_assist,23345,2501,58,58,1,59,839,897,24505,0,0,0,0
ping_unitmarker_bg_attack,23346,2501,58,58,1,59,899,957,24506,0,0,0,0
ping_unitmarker_bg_nonthreat,23347,2501,58,58,1,59,959,1017,24668,0,0,0,0
ping_unitmarker_bg_onmyway,23348,2501,58,58,61,119,779,837,24507,0,0,0,0
ping_unitmarker_bg_threat,23349,2501,58,58,61,119,839,897,24669,0,0,0,0
ping_unitmarker_bg_warning,23350,2501,58,58,61,119,899,957,24508,0,0,0,0
ping_wheel_icon_assist,23351,2501,76,76,785,861,1,77,24509,0,0,0,0
ping_wheel_icon_assist_disabled,23352,2501,76,76,863,939,1,77,24510,0,0,0,0
ping_wheel_icon_assist_disabled_small,23353,2501,38,38,645,683,457,495,24511,0,0,0,0
ping_wheel_icon_assist_small,23354,2501,38,38,291,329,779,817,24512,0,0,0,0
ping_wheel_icon_attack,23355,2501,76,76,785,861,79,155,24513,0,0,0,0
ping_wheel_icon_attack_disabled,23356,2501,76,76,785,861,157,233,24514,0,0,0,0
ping_wheel_icon_attack_disabled_small,23357,2501,38,38,225,263,839,877,24515,0,0,0,0
ping_wheel_icon_attack_small,23358,2501,38,38,176,214,888,926,24516,0,0,0,0
ping_wheel_icon_onmyway,23359,2501,76,76,941,1017,79,155,24517,0,0,0,0
ping_wheel_icon_onmyway_disabled,23360,2501,76,76,863,939,157,233,24518,0,0,0,0
ping_wheel_icon_onmyway_disabled_small,23361,2501,38,38,176,214,928,966,24519,0,0,0,0
ping_wheel_icon_onmyway_small,23362,2501,38,38,216,254,888,926,24520,0,0,0,0
ping_wheel_icon_warning,23363,2501,76,76,489,565,303,379,24521,0,0,0,0
ping_wheel_icon_warning_disabled,23364,2501,76,76,489,565,381,457,24523,0,0,0,0
ping_wheel_icon_warning_disabled_small,23365,2501,38,38,256,294,888,926,24665,0,0,0,0
ping_wheel_icon_warning_small,23366,2501,38,38,216,254,968,1006,24524,0,0,0,0
ping_groundmarker_bg_assist-2x,23367,2507,116,116,1565,1681,463,579,24488,0,0,0,0
ping_groundmarker_bg_attack-2x,23368,2507,116,116,1719,1835,463,579,24489,0,0,0,0
ping_groundmarker_bg_onmyway-2x,23369,2507,116,116,1587,1703,755,871,24490,0,0,0,0
ping_groundmarker_bg_warning-2x,23370,2507,116,116,1739,1855,603,719,24491,0,0,0,0
ping_groundmarker_pin_assist-2x,23371,2507,8,228,735,743,1745,1973,24496,0,0,0,0
ping_groundmarker_pin_attack-2x,23372,2507,8,228,745,753,1745,1973,24497,0,0,0,0
ping_groundmarker_pin_onmyway-2x,23373,2507,8,228,765,773,1745,1973,24498,0,0,0,0
ping_groundmarker_pin_warning-2x,23374,2507,8,228,775,783,1745,1973,24499,0,0,0,0
ping_groundmarker_stroke_assist-2x,23375,2507,116,116,1857,1973,603,719,24785,0,0,0,0
ping_groundmarker_stroke_attack-2x,23376,2507,116,116,1739,1855,721,837,24786,0,0,0,0
ping_groundmarker_stroke_onmyway-2x,23377,2507,116,116,1857,1973,721,837,24787,0,0,0,0
ping_groundmarker_stroke_warning-2x,23378,2507,116,116,1857,1973,839,955,24788,0,0,0,0
ping_mappin_assist-2x,23379,2507,32,40,1683,1715,463,503,24816,0,0,0,0
ping_mappin_attack-2x,23380,2507,32,40,1683,1715,505,545,24817,0,0,0,0
ping_mappin_glw-2x,23381,2507,32,40,1683,1715,547,587,24818,0,0,0,0
ping_mappin_nonthreat-2x,23382,2507,32,40,1837,1869,463,503,24819,0,0,0,0
ping_mappin_onmyway-2x,23383,2507,32,40,1837,1869,505,545,24820,0,0,0,0
ping_mappin_warning-2x,23384,2507,32,40,1991,2023,559,599,24821,0,0,0,0
ping_map_assist-2x,23385,2507,46,46,1991,2037,463,509,24822,0,0,0,0
ping_map_assistglw-2x,23386,2507,46,46,1991,2037,511,557,24823,0,0,0,0
ping_map_attack-2x,23387,2507,46,46,237,283,1993,2039,24824,0,0,0,0
ping_map_attackglw-2x,23388,2507,46,46,285,331,1993,2039,24825,0,0,0,0
ping_map_nonthreat-2x,23389,2507,46,46,345,391,1999,2045,24826,0,0,0,0
ping_map_nonthreatglw-2x,23390,2507,46,46,423,469,1995,2041,24827,0,0,0,0
ping_map_onmyway-2x,23391,2507,46,46,499,545,1991,2037,24828,0,0,0,0
ping_map_onmywayglw-2x,23392,2507,46,46,571,617,1991,2037,24829,0,0,0,0
ping_map_warning-2x,23393,2507,46,46,735,781,1697,1743,24830,0,0,0,0
ping_map_warningglw-2x,23394,2507,30,30,1705,1735,755,785,24831,0,0,0,0
ping_marker_flipbook_assist-2x,23395,2507,972,384,1,973,603,987,24695,0,0,0,0
ping_marker_flipbook_attack-2x,23396,2507,660,560,1,661,989,1549,24696,0,0,0,0
ping_marker_flipbook_onmyway-2x,23397,2507,600,544,663,1263,989,1533,24697,0,0,0,0
ping_marker_flipbook_warning-2x,23398,2507,384,644,1265,1649,989,1633,24698,0,0,0,0
ping_marker_icon_assist-2x,23399,2507,70,70,575,645,1843,1913,24550,0,0,0,0
ping_marker_icon_attack-2x,23400,2507,70,70,499,569,1919,1989,24551,0,0,0,0
ping_marker_icon_nonthreat-2x,23401,2507,70,70,571,641,1919,1989,24552,0,0,0,0
ping_marker_icon_onmyway-2x,23402,2507,70,70,663,733,1535,1605,24553,0,0,0,0
ping_marker_icon_threat-2x,23403,2507,70,70,663,733,1607,1677,24554,0,0,0,0
ping_marker_icon_warning-2x,23404,2507,70,70,663,733,1679,1749,24555,0,0,0,0
ping_ovmarker_pointer_assist-2x,23405,2507,150,150,1129,1279,757,907,24500,0,0,0,0
ping_ovmarker_pointer_attack-2x,23406,2507,150,150,1283,1433,603,753,24501,0,0,0,0
ping_ovmarker_pointer_bg-2x,23407,2507,94,94,345,439,1669,1763,24502,0,0,0,0
ping_ovmarker_pointer_nonthreat-2x,23408,2507,150,150,1283,1433,755,905,24666,0,0,0,0
ping_ovmarker_pointer_onmyway-2x,23409,2507,150,150,1435,1585,603,753,24503,0,0,0,0
ping_ovmarker_pointer_threat-2x,23410,2507,150,150,1435,1585,755,905,24667,0,0,0,0
ping_ovmarker_pointer_warning-2x,23411,2507,150,150,1587,1737,603,753,24504,0,0,0,0
ping_spotglw_assist_in-2x,23412,2507,74,74,1053,1127,911,985,24789,0,0,0,0
ping_spotglw_assist_out-2x,23413,2507,106,106,1587,1693,873,979,24790,0,0,0,0
ping_spotglw_attack_in-2x,23414,2507,74,74,1207,1281,909,983,24791,0,0,0,0
ping_spotglw_attack_out-2x,23415,2507,106,106,355,461,1551,1657,24792,0,0,0,0
ping_spotglw_nonthreat_in-2x,23416,2507,74,74,579,653,1765,1839,24832,0,0,0,0
ping_spotglw_nonthreat_out-2x,23417,2507,106,106,463,569,1551,1657,24833,0,0,0,0
ping_spotglw_onmyway_in-2x,23418,2507,74,74,423,497,1843,1917,24793,0,0,0,0
ping_spotglw_onmyway_out-2x,23419,2507,106,106,237,343,1669,1775,24794,0,0,0,0
ping_spotglw_threat_in-2x,23420,2507,74,74,423,497,1919,1993,24834,0,0,0,0
ping_spotglw_threat_out-2x,23421,2507,106,106,237,343,1777,1883,24835,0,0,0,0
ping_spotglw_warning_in-2x,23422,2507,74,74,499,573,1843,1917,24795,0,0,0,0
ping_spotglw_warning_out-2x,23423,2507,106,106,237,343,1885,1991,24796,0,0,0,0
ping_unitmarker_bg-2x,23424,2507,116,116,1,117,1551,1667,24797,0,0,0,0
ping_unitmarker_bg_assist-2x,23425,2507,116,116,1,117,1669,1785,24505,0,0,0,0
ping_unitmarker_bg_attack-2x,23426,2507,116,116,1,117,1787,1903,24506,0,0,0,0
ping_unitmarker_bg_nonthreat-2x,23427,2507,116,116,1,117,1905,2021,24668,0,0,0,0
ping_unitmarker_bg_onmyway-2x,23428,2507,116,116,119,235,1551,1667,24507,0,0,0,0
ping_unitmarker_bg_threat-2x,23429,2507,116,116,119,235,1669,1785,24669,0,0,0,0
ping_unitmarker_bg_warning-2x,23430,2507,116,116,119,235,1787,1903,24508,0,0,0,0
ping_wheel_icon_assist-2x,23431,2507,152,152,1565,1717,1,153,24509,0,0,0,0
ping_wheel_icon_assist_disabled-2x,23432,2507,152,152,1719,1871,1,153,24510,0,0,0,0
ping_wheel_icon_assist_disabled_small-2x,23433,2507,76,76,975,1051,911,987,24511,0,0,0,0
ping_wheel_icon_assist_small-2x,23434,2507,76,76,1129,1205,909,985,24512,0,0,0,0
ping_wheel_icon_attack-2x,23435,2507,152,152,1565,1717,155,307,24513,0,0,0,0
ping_wheel_icon_attack_disabled-2x,23436,2507,152,152,1565,1717,309,461,24514,0,0,0,0
ping_wheel_icon_attack_disabled_small-2x,23437,2507,76,76,1435,1511,907,983,24515,0,0,0,0
ping_wheel_icon_attack_small-2x,23438,2507,76,76,571,647,1551,1627,24516,0,0,0,0
ping_wheel_icon_onmyway-2x,23439,2507,152,152,1873,2025,155,307,24517,0,0,0,0
ping_wheel_icon_onmyway_disabled-2x,23440,2507,152,152,1719,1871,309,461,24518,0,0,0,0
ping_wheel_icon_onmyway_disabled_small-2x,23441,2507,76,76,519,595,1669,1745,24519,0,0,0,0
ping_wheel_icon_onmyway_small-2x,23442,2507,76,76,345,421,1765,1841,24520,0,0,0,0
ping_wheel_icon_warning-2x,23443,2507,152,152,975,1127,603,755,24521,0,0,0,0
ping_wheel_icon_warning_disabled-2x,23444,2507,152,152,975,1127,757,909,24523,0,0,0,0
ping_wheel_icon_warning_disabled_small-2x,23445,2507,76,76,345,421,1921,1997,24665,0,0,0,0
ping_wheel_icon_warning_small-2x,23446,2507,76,76,423,499,1765,1841,24524,0,0,0,0
radial_wheel_bar_cooldownfx,23447,2502,296,296,1,297,381,677,24856,0,0,0,0
radial_wheel_bar_cooldownfx-2x,23448,2508,592,592,1,593,759,1351,24856,0,0,0,0
splash-1015-botleft,23449,2521,137,371,374,511,587,958,24858,0,0,0,0
splash-1015-right,23450,2521,510,584,1,511,1,585,24859,0,0,0,0
splash-1015-topleft,23451,2521,371,434,1,372,587,1021,24860,0,0,0,0
perks-hold-nineslice-cornerbottomright,23456,1918,40,40,801,841,382,422,18586,0,0,0,0
ping_wheel_icon_assist_glow-2x,23459,2507,152,152,1873,2025,1,153,24863,0,0,0,0
ping_wheel_icon_assist_small_glow-2x,23460,2507,76,76,1283,1359,907,983,24864,0,0,0,0
ping_wheel_icon_attack_glow-2x,23461,2507,152,152,1719,1871,155,307,24865,0,0,0,0
ping_wheel_icon_attack_small_glow-2x,23462,2507,76,76,441,517,1669,1745,24866,0,0,0,0
ping_wheel_icon_onmyway_glow-2x,23463,2507,152,152,1873,2025,309,461,24867,0,0,0,0
ping_wheel_icon_onmyway_small_glow-2x,23464,2507,76,76,345,421,1843,1919,24868,0,0,0,0
ping_wheel_icon_warning_glow-2x,23465,2507,152,152,1129,1281,603,755,24869,0,0,0,0
ping_wheel_icon_warning_small_glow-2x,23466,2507,76,76,501,577,1765,1841,24870,0,0,0,0
ping_wheel_icon_assist_glow,23467,2501,76,76,941,1017,1,77,24863,0,0,0,0
ping_wheel_icon_assist_glow_small,23468,2501,38,38,722,760,457,495,24871,0,0,0,0
ping_wheel_icon_attack_glow,23469,2501,76,76,863,939,79,155,24865,0,0,0,0
ping_wheel_icon_attack_glow_small,23470,2501,38,38,265,303,839,877,24872,0,0,0,0
ping_wheel_icon_onmyway_glow,23471,2501,76,76,941,1017,157,233,24867,0,0,0,0
ping_wheel_icon_onmyway_glow_small,23472,2501,38,38,176,214,968,1006,24873,0,0,0,0
ping_wheel_icon_warning_glow,23473,2501,76,76,567,643,303,379,24869,0,0,0,0
ping_wheel_icon_warning_glow_small,23474,2501,38,38,216,254,928,966,24874,0,0,0,0
radial_wheel_bar_cooldownfx_small,23475,2502,148,148,299,447,864,1012,24862,0,0,0,0
radial_wheel_bar_cooldownfx_small-2x,23477,2508,296,296,595,891,1721,2017,24862,0,0,0,0
spellicon-256x256-repairall,23479,2506,72,72,1,73,138,210,24558,0,0,0,0
spellicon-256x256-repair,23480,2506,72,72,75,147,64,136,24557,0,0,0,0
spellicon-256x256-repairallguild,23481,2506,72,72,75,147,138,210,24559,0,0,0,0
chromietime-portrait-large-battleforazeroth,23482,1565,489,254,896,1385,1,255,24877,0,0,0,0
chromietime-portrait-small-battleforazeroth,23483,1565,312,173,1,313,874,1047,24878,0,0,0,0
shop-card-full-wsg7,23484,2541,568,463,1,569,1,464,24879,0,0,0,0
shop-card-full-dk33,23485,2542,568,463,1,569,1,464,24880,0,0,0,0
shop-card-full-fm24,23486,2543,568,463,1,569,1,464,24881,0,0,0,0
shop-card-full-ku72,23487,2544,568,463,1,569,1,464,24882,0,0,0,0
shop-card-full-cf67,23488,2545,568,463,1,569,1,464,24883,0,0,0,0
perks-maintenance,23491,1918,70,70,885,955,225,295,24890,0,0,0,0
perks-threedots,23492,1918,28,10,647,675,644,654,24891,0,0,0,0
shop-card-full-fm83,23493,2543,568,463,1,569,466,929,24892,0,0,0,0
ping_mapov_assist,23494,2501,36,36,489,525,459,495,24893,0,0,0,0
ping_mapov_attack,23495,2501,36,36,527,563,459,495,24894,0,0,0,0
ping_mapov_nonthreat,23496,2501,36,36,295,331,928,964,24895,0,0,0,0
ping_mapov_onmyway,23497,2501,36,36,295,331,967,1003,24896,0,0,0,0
ping_mapov_threat,23498,2501,36,36,333,369,849,885,24897,0,0,0,0
ping_mapov_warning,23499,2501,36,36,333,369,887,923,24898,0,0,0,0
ping_mappin_threat,23500,2501,16,20,923,939,279,299,24899,0,0,0,0
ping_map_threat,23501,2501,23,23,427,450,771,794,24900,0,0,0,0
ping_map_whole_assist_deprecated,23502,2501,32,32,372,404,808,840,25542,0,0,0,0
ping_map_whole_attack_deprecated,23503,2501,32,32,372,404,842,874,25543,0,0,0,0
ping_map_whole_onmyway_deprecated,23504,2501,32,32,372,404,910,942,25545,0,0,0,0
ping_map_whole_threat_deprecated,23505,2501,32,32,372,404,944,976,25546,0,0,0,0
ping_map_whole_warning_deprecated,23506,2501,32,32,372,404,978,1010,25547,0,0,0,0
ping_mapov_assist-2x,23507,2507,72,72,1361,1433,907,979,24893,0,0,0,0
ping_mapov_attack-2x,23508,2507,72,72,1513,1585,907,979,24894,0,0,0,0
ping_mapov_nonthreat-2x,23509,2507,72,72,1975,2047,603,675,24895,0,0,0,0
ping_mapov_onmyway-2x,23510,2507,72,72,1975,2047,721,793,24896,0,0,0,0
ping_mapov_threat-2x,23511,2507,72,72,1975,2047,839,911,24897,0,0,0,0
ping_mapov_warning-2x,23512,2507,72,72,1975,2047,913,985,24898,0,0,0,0
ping_map_threat-2x,23513,2507,46,46,735,781,1601,1647,24900,0,0,0,0
ping_map_whole_assist-2x_deprecated,23514,2507,64,64,597,661,1669,1733,25542,0,0,0,0
ping_map_whole_attack-2x_deprecated,23515,2507,64,64,663,727,1751,1815,25543,0,0,0,0
ping_map_whole_nonthreat-2x_deprecated,23516,2507,64,64,663,727,1817,1881,25544,0,0,0,0
ping_map_whole_onmyway-2x_deprecated,23517,2507,64,64,663,727,1883,1947,25545,0,0,0,0
ping_map_whole_threat-2x_deprecated,23518,2507,64,64,663,727,1949,2013,25546,0,0,0,0
ping_map_whole_warning-2x_deprecated,23519,2507,64,64,735,799,1535,1599,25547,0,0,0,0
ping_map_whole_nonthreat_deprecated,23520,2501,32,32,372,404,876,908,25544,0,0,0,0
ping_map_whole_assist,23525,647,32,32,853,885,443,475,24901,0,0,0,0
ping_map_whole_attack,23526,647,32,32,887,919,443,475,24902,0,0,0,0
ping_map_whole_nonthreat,23527,647,32,32,921,953,443,475,24906,0,0,0,0
ping_map_whole_onmyway,23528,647,32,32,955,987,443,475,24903,0,0,0,0
ping_map_whole_threat,23529,647,32,32,989,1021,443,475,24904,0,0,0,0
ping_map_whole_warning,23530,647,32,32,445,477,477,509,24905,0,0,0,0
garrmissionlocation-blackrockmountain-list,23531,566,792,78,1,793,561,639,24473,0,0,0,0
dragonflight-landingpage-background-fadeoverlay-bottom,23532,2172,403,94,1,404,808,902,24888,0,0,0,0
dragonflight-landingpage-background-fadeoverlay-top,23533,2172,403,185,1,404,621,806,24889,0,0,0,0
dragonflight-landingpage-background,23534,2172,880,618,1,881,1,619,20880,0,0,0,0
dragonflight-landingpage-renownbutton-centaur-hover,23535,2133,508,160,913,1421,1,161,20873,0,0,0,0
dragonflight-landingpage-renownbutton-centaur,23536,2133,508,160,403,911,1,161,20619,0,0,0,0
dragonflight-landingpage-renownbutton-expedition-hover,23537,2133,508,160,403,911,163,323,20874,0,0,0,0
dragonflight-landingpage-renownbutton-expedition,23538,2133,508,160,1423,1931,1,161,20620,0,0,0,0
dragonflight-landingpage-renownbutton-locked,23539,2133,508,160,913,1421,163,323,21292,0,0,0,0
dragonflight-landingpage-renownbutton-niffen-hover,23540,2133,508,160,403,911,325,485,23467,0,0,0,0
dragonflight-landingpage-renownbutton-niffen,23541,2133,508,160,1423,1931,163,323,23468,0,0,0,0
dragonflight-landingpage-renownbutton-tuskarr-hover,23542,2133,508,160,1423,1931,325,485,20881,0,0,0,0
dragonflight-landingpage-renownbutton-tuskarr,23543,2133,508,160,913,1421,325,485,20882,0,0,0,0
dragonflight-landingpage-renownbutton-valdrakken-hover,23544,2133,508,160,913,1421,487,647,20876,0,0,0,0
dragonflight-landingpage-renownbutton-valdrakken,23545,2133,508,160,403,911,487,647,20622,0,0,0,0
ping_mappin_threat-2x,23549,2507,32,40,1837,1869,547,587,24899,0,0,0,0
ping_map_threatglw-2x,23550,2507,46,46,735,781,1649,1695,24912,0,0,0,0
ping_map_threatglw,23551,2501,23,23,452,475,771,794,24912,0,0,0,0
ping_marker_flipbook_nonthreat-2x,23552,2507,780,600,1,781,1,601,24913,0,0,0,0
ping_marker_flipbook_threat-2x,23553,2507,780,600,783,1563,1,601,24914,0,0,0,0
ping_marker_flipbook_nonthreat,23554,2501,390,300,1,391,1,301,24913,0,0,0,0
ping_marker_flipbook_threat,23555,2501,390,300,393,783,1,301,24914,0,0,0,0
ping_groundmarker_bg_nonthreat-2x,23556,2507,116,116,1873,1989,463,579,24915,0,0,0,0
ping_groundmarker_bg_nonthreat,23557,2501,58,58,941,999,235,293,24915,0,0,0,0
ping_groundmarker_pin_nonthreat-2x,23558,2507,8,228,755,763,1745,1973,24916,0,0,0,0
ping_groundmarker_pin_nonthreat,23559,2501,4,114,415,419,771,885,24916,0,0,0,0
ping_groundmarker_stroke_nonthreat,23560,2501,58,58,876,934,423,481,24917,0,0,0,0
ping_groundmarker_stroke_nonthreat-2x,23561,2507,116,116,1739,1855,839,955,24917,0,0,0,0
ui-questtracker-objective-fail-2x,23581,2548,38,38,937,975,1,39,24968,0,0,0,0
ui-questtracker-objective-nub-2x,23582,2548,38,38,977,1015,1,39,24969,0,0,0,0
ui-questtracker-primary-objective-header-2x,23583,2548,600,80,1,601,241,321,24970,0,0,0,0
ui-questtracker-progressbar-frame-2x,23584,2548,558,118,1,559,1,119,24971,0,0,0,0
ui-questtracker-progressbar-full-channel-2x,23585,2548,558,118,1,559,121,239,24972,0,0,0,0
ui-questtracker-secondary-objective-header-2x,23586,2548,600,60,1,601,323,383,24973,0,0,0,0
ui-questtracker-tracker-check-2x,23587,2548,38,38,871,909,59,97,24974,0,0,0,0
ui-questtrackerbutton-collapse-all-2x,23588,2548,36,38,951,987,59,97,12246,0,0,0,0
ui-questtrackerbutton-collapse-all-pressed-2x,23589,2548,36,38,905,941,121,159,12245,0,0,0,0
ui-questtrackerbutton-expand-all-2x,23590,2548,36,38,905,941,161,199,12250,0,0,0,0
ui-questtrackerbutton-expand-all-pressed-2x,23591,2548,36,38,905,941,201,239,12249,0,0,0,0
ui-questtrackerbutton-filter-2x,23592,2548,36,38,943,979,121,159,24976,0,0,0,0
ui-questtrackerbutton-filter-pressed-2x,23593,2548,36,38,981,1017,121,159,24975,0,0,0,0
ui-questtrackerbutton-red-highlight-2x,23594,2548,36,38,943,979,161,199,24977,0,0,0,0
ui-questtrackerbutton-secondary-collapse-2x,23595,2548,32,32,989,1021,59,91,24979,0,0,0,0
ui-questtrackerbutton-secondary-collapse-pressed-2x,23596,2548,32,32,943,975,201,233,24978,0,0,0,0
ui-questtrackerbutton-secondary-expand-2x,23597,2548,32,32,981,1013,161,193,24981,0,0,0,0
ui-questtrackerbutton-secondary-expand-pressed-2x,23598,2548,32,32,981,1013,195,227,24980,0,0,0,0
ui-questtrackerbutton-yellow-highlight-2x,23599,2548,32,32,603,635,241,273,24982,0,0,0,0
ui-questpoi-innerglow,23600,2549,32,32,1,33,67,99,24937,0,0,0,0
ui-questpoi-outerglow,23601,2549,64,64,1,65,1,65,24938,0,0,0,0
ui-questpoi-questnumber-pressed-supertracked,23602,2549,32,32,101,133,1,33,24939,0,0,0,0
ui-questpoi-questnumber-pressed,23603,2549,32,32,67,99,69,101,24940,0,0,0,0
ui-questpoi-questnumber-supertracked,23604,2549,32,32,101,133,35,67,24941,0,0,0,0
ui-questpoi-questnumber,23605,2549,32,32,67,99,35,67,24942,0,0,0,0
ui-questpoi-innerglow-2x,23612,2550,64,64,1,65,131,195,24937,0,0,0,0
ui-questpoi-outerglow-2x,23613,2550,128,128,1,129,1,129,24938,0,0,0,0
ui-questpoi-questnumber-2x,23614,2550,64,64,131,195,67,131,24942,0,0,0,0
ui-questpoi-questnumber-pressed-2x,23615,2550,64,64,131,195,133,197,24940,0,0,0,0
ui-questpoi-questnumber-pressed-supertracked-2x,23616,2550,64,64,197,261,1,65,24939,0,0,0,0
ui-questpoi-questnumber-supertracked-2x,23617,2550,64,64,197,261,67,131,24941,0,0,0,0
ping_chat_assist,23618,924,30,30,1,31,67,97,24949,0,0,0,0
ping_chat_attack,23619,924,30,30,37,67,1,31,24950,0,0,0,0
ping_chat_onmyway,23621,924,30,30,37,67,65,95,24952,0,0,0,0
ping_chat_warning,23622,924,30,30,69,99,1,31,24953,0,0,0,0
ping_chat_nonthreat,23623,924,30,30,37,67,33,63,24954,0,0,0,0
ping_chat_threat,23624,924,30,30,37,67,97,127,24955,0,0,0,0
ui-hud-unitframe-player-combaticon-glow-2x,23625,2074,64,64,1953,2017,171,235,20613,0,0,0,0
ui-hud-unitframe-player-portraiton-2x,23626,2074,396,142,1,397,171,313,19918,0,0,0,0
ui-hud-unitframe-player-portraiton-bar-energy-2x,23627,2074,248,20,1667,1915,479,499,20366,0,0,0,0
ui-hud-unitframe-player-portraiton-bar-focus-2x,23628,2074,248,20,387,635,501,521,20367,0,0,0,0
ui-hud-unitframe-player-portraiton-bar-health-2x,23629,2074,248,40,1101,1349,361,401,19916,0,0,0,0
ui-hud-unitframe-player-portraiton-bar-health-status-2x,23630,2074,248,40,1351,1599,359,399,20418,0,0,0,0
ui-hud-unitframe-player-portraiton-bar-mana-2x,23631,2074,248,20,637,885,501,521,19917,0,0,0,0
ui-hud-unitframe-player-portraiton-bar-mana-status-2x,23632,2074,248,20,887,1135,501,521,21397,0,0,0,0
ui-hud-unitframe-player-portraiton-bar-rage-2x,23633,2074,248,20,1137,1385,501,521,20368,0,0,0,0
ui-hud-unitframe-player-portraiton-bar-runicpower-2x,23634,2074,248,20,1387,1635,501,521,20369,0,0,0,0
ui-hud-unitframe-player-portraiton-classresource-2x,23635,2074,396,148,1607,2003,1,149,24213,0,0,0,0
ui-hud-unitframe-player-portraiton-classresource-bar-energy-2x,23636,2074,248,20,1637,1885,501,521,24261,0,0,0,0
ui-hud-unitframe-player-portraiton-classresource-bar-mana-2x,23637,2074,248,20,387,635,523,543,24237,0,0,0,0
ui-hud-unitframe-player-portraiton-classresource-incombat-2x,23638,2074,384,142,793,1177,171,313,24262,0,0,0,0
ui-hud-unitframe-player-portraiton-cornerembellishment-2x,23639,2074,46,46,387,433,545,591,20270,0,0,0,0
ui-hud-unitframe-player-portraiton-incombat-2x,23640,2074,384,142,1179,1563,171,313,20425,0,0,0,0
ui-hud-unitframe-player-portraiton-status-2x,23641,2074,392,142,399,791,171,313,20272,0,0,0,0
ui-hud-unitframe-player-portraiton-vehicle-2x,23642,2074,404,168,1,405,1,169,20821,0,0,0,0
ui-hud-unitframe-player-portraiton-vehicle-incombat-2x,23643,2074,396,168,811,1207,1,169,21139,0,0,0,0
ui-hud-unitframe-player-portraiton-vehicle-status-2x,23644,2074,402,168,407,809,1,169,21140,0,0,0,0
ui-hud-unitframe-target-highleveltarget_icon-2x,23645,2074,22,28,2019,2041,171,199,20290,0,0,0,0
ui-hud-unitframe-target-minusmob-portraiton-2x,23646,2074,384,134,1,385,315,449,20067,0,0,0,0
ui-hud-unitframe-target-minusmob-portraiton-bar-energy-2x,23647,2074,254,20,1737,1991,457,477,20370,0,0,0,0
ui-hud-unitframe-target-minusmob-portraiton-bar-focus-2x,23648,2074,254,20,387,641,479,499,20371,0,0,0,0
ui-hud-unitframe-target-minusmob-portraiton-bar-health-2x,23649,2074,250,24,1,251,995,1019,20066,0,0,0,0
ui-hud-unitframe-target-minusmob-portraiton-bar-health-status-2x,23650,2074,250,24,1163,1413,415,439,20419,0,0,0,0
ui-hud-unitframe-target-minusmob-portraiton-bar-mana-2x,23651,2074,254,20,643,897,479,499,20372,0,0,0,0
ui-hud-unitframe-target-minusmob-portraiton-bar-mana-status-2x,23652,2074,254,20,899,1153,479,499,21398,0,0,0,0
ui-hud-unitframe-target-minusmob-portraiton-bar-rage-2x,23653,2074,254,20,1155,1409,479,499,20373,0,0,0,0
ui-hud-unitframe-target-minusmob-portraiton-bar-runicpower-2x,23654,2074,254,20,1411,1665,479,499,20374,0,0,0,0
ui-hud-unitframe-target-minusmob-portraiton-incombat-2x,23655,2074,376,134,1,377,723,857,21056,0,0,0,0
ui-hud-unitframe-target-minusmob-portraiton-status-2x,23656,2074,386,138,1565,1951,171,309,21057,0,0,0,0
ui-hud-unitframe-target-portraiton-2x,23657,2074,384,134,1,385,451,585,19926,0,0,0,0
ui-hud-unitframe-target-portraiton-bar-energy-2x,23658,2074,268,20,1666,1934,415,435,20375,0,0,0,0
ui-hud-unitframe-target-portraiton-bar-focus-2x,23659,2074,268,20,387,655,457,477,20376,0,0,0,0
ui-hud-unitframe-target-portraiton-bar-health-2x,23660,2074,252,40,1603,1855,315,355,19919,0,0,0,0
ui-hud-unitframe-target-portraiton-bar-health-status-2x,23661,2074,252,40,1603,1855,357,397,20420,0,0,0,0
ui-hud-unitframe-target-portraiton-bar-mana-2x,23662,2074,268,20,657,925,457,477,19920,0,0,0,0
ui-hud-unitframe-target-portraiton-bar-mana-status-2x,23663,2074,268,20,927,1195,457,477,21400,0,0,0,0
ui-hud-unitframe-target-portraiton-bar-rage-2x,23664,2074,268,20,1197,1465,457,477,20377,0,0,0,0
ui-hud-unitframe-target-portraiton-bar-runicpower-2x,23665,2074,268,20,1467,1735,457,477,20378,0,0,0,0
ui-hud-unitframe-target-portraiton-incombat-2x,23666,2074,376,134,1,377,859,993,20930,0,0,0,0
ui-hud-unitframe-target-portraiton-type-2x,23667,2074,270,36,891,1161,415,451,20225,0,0,0,0
ui-hud-unitframe-target-portraiton-vehicle-2x,23668,2074,396,162,1209,1605,1,163,20822,0,0,0,0
ui-hud-unitframe-targetoftarget-portraiton-2x,23669,2074,240,98,387,627,315,413,19929,0,0,0,0
ui-hud-unitframe-targetoftarget-portraiton-bar-energy-2x,23670,2074,148,14,1607,1755,151,165,20380,0,0,0,0
ui-hud-unitframe-targetoftarget-portraiton-bar-focus-2x,23671,2074,148,14,1757,1905,151,165,20381,0,0,0,0
ui-hud-unitframe-targetoftarget-portraiton-bar-health-2x,23672,2074,140,20,1857,1997,315,335,19927,0,0,0,0
ui-hud-unitframe-targetoftarget-portraiton-bar-health-status-2x,23673,2074,140,20,1857,1997,357,377,20421,0,0,0,0
ui-hud-unitframe-targetoftarget-portraiton-bar-mana-2x,23674,2074,148,14,1857,2005,337,351,19928,0,0,0,0
ui-hud-unitframe-targetoftarget-portraiton-bar-mana-status-2x,23675,2074,148,14,1603,1751,399,413,21399,0,0,0,0
ui-hud-unitframe-targetoftarget-portraiton-bar-rage-2x,23676,2074,148,14,1163,1311,441,455,20382,0,0,0,0
ui-hud-unitframe-targetoftarget-portraiton-bar-runicpower-2x,23677,2074,148,14,1415,1563,440,454,20383,0,0,0,0
ui-hud-unitframe-targetoftarget-portraiton-incombat-2x,23678,2074,228,94,871,1099,315,409,21058,0,0,0,0
ui-hud-unitframe-targetoftarget-portraiton-status-2x,23679,2074,240,98,629,869,315,413,21059,0,0,0,0
ui-hud-unitframe-target-rare-portraiton-2x,23680,2074,384,134,1,385,587,721,20379,0,0,0,0
ui-hud-unitframe-player-portrait-mask-2x,23681,2551,128,128,0,128,0,128,20199,0,0,16,0
ui-hud-unitframe-player-portraiton-bar-health-mask-2x,23683,2553,256,64,0,256,0,64,20392,0,0,16,0
ui-hud-unitframe-target-portraiton-bar-health-mask-2x,23684,2552,256,64,0,256,0,64,20177,0,0,16,0
ui-hud-unitframe-player-portraiton-bar-mana-mask-2x,23685,2554,256,32,0,256,0,32,20393,0,0,16,0
ui-hud-unitframe-target-portraiton-bar-mana-mask-2x,23686,2555,512,32,0,512,0,32,20178,0,0,16,0
ui-hud-unitframe-target-minusmob-portraiton-bar-health-mask-2x,23687,2556,256,32,0,256,0,32,21895,0,0,16,0
greatvault-unlocked-anim,23689,2558,900,1980,1,901,1,1981,24956,0,0,0,0
greatvault-frame-dis,23690,2558,99,99,1834,1933,428,527,24957,0,0,0,0
greatvault-frame-gleam,23691,2558,99,99,1935,2034,428,527,24958,0,0,0,0
greatvault-frame-whole,23692,2558,129,129,1471,1600,428,557,24959,0,0,0,0
greatvault-frame,23693,2558,99,99,1733,1832,428,527,24960,0,0,0,0
greatvault-lock-gleam,23694,2558,40,40,1989,2029,205,245,24961,0,0,0,0
greatvault-lock-glow,23695,2558,56,56,1984,2040,59,115,24962,0,0,0,0
greatvault-lock,23696,2558,56,56,1984,2040,1,57,24963,0,0,0,0
greatvault-dis-start,23697,2558,129,129,1209,1338,428,557,24964,0,0,0,0
greatvault-keyhole-glow,23698,2558,75,75,985,1060,561,636,24965,0,0,0,0
greatvault-keyhole_line,23699,2558,25,32,1989,2014,247,279,24966,0,0,0,0
greatvault-slotfill,23700,2558,80,80,903,983,561,641,24967,0,0,0,0
ui-questtracker-objective-fail,23701,2547,19,19,471,490,1,20,24968,0,0,0,0
ui-questtracker-objective-nub,23702,2547,19,19,492,511,1,20,24969,0,0,0,0
ui-questtracker-primary-objective-header,23703,2547,300,40,1,301,123,163,24970,0,0,0,0
ui-questtracker-progressbar-frame,23704,2547,279,59,1,280,1,60,24971,0,0,0,0
ui-questtracker-progressbar-full-channel,23705,2547,279,59,1,280,62,121,24972,0,0,0,0
ui-questtracker-secondary-objective-header,23706,2547,300,30,1,301,165,195,24973,0,0,0,0
ui-questtracker-tracker-check,23707,2547,19,19,438,457,31,50,24974,0,0,0,0
ui-questtrackerbutton-collapse-all-pressed,23708,2547,18,19,458,476,62,81,12245,0,0,0,0
ui-questtrackerbutton-collapse-all,23709,2547,18,19,480,498,31,50,12246,0,0,0,0
ui-questtrackerbutton-expand-all-pressed,23710,2547,18,19,458,476,83,102,12249,0,0,0,0
ui-questtrackerbutton-expand-all,23711,2547,18,19,478,496,62,81,12250,0,0,0,0
ui-questtrackerbutton-filter-pressed,23712,2547,18,19,303,321,123,142,24975,0,0,0,0
ui-questtrackerbutton-filter,23713,2547,18,19,478,496,83,102,24976,0,0,0,0
ui-questtrackerbutton-red-highlight,23714,2547,18,19,303,321,144,163,24977,0,0,0,0
ui-questtrackerbutton-secondary-collapse-pressed,23715,2547,16,16,478,494,104,120,24978,0,0,0,0
ui-questtrackerbutton-secondary-collapse,23716,2547,16,16,458,474,104,120,24979,0,0,0,0
ui-questtrackerbutton-secondary-expand-pressed,23717,2547,16,16,323,339,141,157,24980,0,0,0,0
ui-questtrackerbutton-secondary-expand,23718,2547,16,16,323,339,123,139,24981,0,0,0,0
ui-questtrackerbutton-yellow-highlight,23719,2547,16,16,341,357,123,139,24982,0,0,0,0
ui-questtracker-objfx-barglow-2x,23720,2548,374,56,561,935,1,57,24987,0,0,0,0
ui-questtracker-objfx_lineglow-2x,23722,2548,742,12,1,743,385,397,24989,0,0,0,0
ui-questtracker-objfx-barglow,23724,2547,187,28,282,469,1,29,24987,0,0,0,0
ui-questtracker-objfx_lineglow,23726,2547,371,6,1,372,197,203,24989,0,0,0,0
greatvault-slotfill-dis,23728,2558,68,68,1062,1130,561,629,24991,0,0,0,0
greatvault-handles,23729,2558,241,241,1746,1987,153,394,24992,0,0,0,0
greatvault-windfx-1,23730,2558,283,273,903,1186,153,426,24993,0,0,0,0
greatvault-windfx-2,23731,2558,283,273,1188,1471,153,426,24994,0,0,0,0
greatvault-particle1,23732,2558,151,131,903,1054,428,559,24995,0,0,0,0
greatvault-particle2,23733,2558,151,131,1056,1207,428,559,24996,0,0,0,0
greatvault-bg-circglow,23734,2558,271,271,1473,1744,153,424,24997,0,0,0,0
greatvault-bg-glow,23735,2558,556,126,1426,1982,1,127,24998,0,0,0,0
greatvault-bg-line1-white,23736,2558,504,2,1,505,2045,2047,24999,0,0,0,0
greatvault-bg-line1,23737,2558,504,2,1,505,2041,2043,25000,0,0,0,0
greatvault-bg-line2-white,23738,2558,538,12,1426,1964,129,141,25001,0,0,0,0
greatvault-bg-line2,23739,2558,538,12,1,539,2027,2039,25002,0,0,0,0
greatvault-bg-line3-white,23740,2558,538,20,1,539,2005,2025,25003,0,0,0,0
greatvault-bg-line3,23741,2558,538,20,1,539,1983,2003,25004,0,0,0,0
greatvault-bg-text,23742,2558,521,150,903,1424,1,151,25005,0,0,0,0
greatvault-frame-glow,23743,2558,129,129,1340,1469,428,557,25006,0,0,0,0
greatvault-start,23744,2558,129,129,1602,1731,428,557,25007,0,0,0,0
greatvault-lockhole-glow,23745,2558,50,50,1989,2039,153,203,25008,0,0,0,0
secretsofazeroth-ohnahrastatue,23746,2559,241,265,1,242,1,266,25009,0,0,0,0
uitools-button-background-active,23764,2561,90,34,121,211,40,74,25514,0,0,0,0
uitools-button-background-default,23765,2561,90,34,121,211,4,38,25515,0,0,0,0
uitools-button-background-disabled,23766,2561,90,34,121,211,76,110,25516,0,0,0,0
uitools-tab-background-default,23777,2561,128,32,331,459,38,70,25527,0,0,0,0
uitools-tab-background-active,23778,2561,128,32,331,459,4,36,25528,0,0,0,0
uitools-title-bar-background,23781,2561,34,34,365,399,72,106,25529,0,0,0,0
ui-questpoiimportant-innerglow-2x,23783,2562,64,72,1,65,131,203,24345,0,0,0,0
ui-questpoiimportant-outerglow-2x,23784,2562,128,128,1,129,1,129,24346,0,0,0,0
ui-questpoiimportant-questbang-2x,23785,2562,64,72,131,195,1,73,24347,0,0,0,0
ui-questpoiimportant-questbangturnin-2x,23786,2562,64,72,131,195,149,221,24348,0,0,0,0
ui-questpoiimportant-questnumber-2x,23787,2562,64,72,197,261,1,73,24352,0,0,0,0
ui-questpoiimportant-questnumber-pressed-2x,23788,2562,64,72,197,261,75,147,24350,0,0,0,0
ui-questpoiimportant-questnumber-pressed-supertracked-2x,23789,2562,64,72,197,261,149,221,24349,0,0,0,0
ui-questpoiimportant-questnumber-supertracked-2x,23790,2562,64,72,263,327,1,73,24351,0,0,0,0
dreamsurge_fire-portal-icon_128x128,23799,647,64,64,1,65,465,529,25036,32,32,0,0
dreamsurge_hub-icon_128x128,23800,647,64,64,1,65,531,595,25037,32,32,0,0
dreamsurge-world-quest-icon_16x16,23801,743,16,16,489,505,187,203,25038,0,0,0,0
dragonriding-sgvigor-background-2x,23802,2564,71,99,1200,1271,656,755,25133,0,0,0,2
dragonriding-sgvigor-burst-flipbook-2x,23803,2564,800,800,1,801,1,801,25135,0,0,0,2
dragonriding-sgvigor-decor-dark-2x,23804,2564,117,151,394,511,803,954,25137,0,0,0,2
dragonriding-sgvigor-decor-gold-2x,23805,2564,117,151,513,630,803,954,25138,0,0,0,2
dragonriding-sgvigor-decor-silver-2x,23806,2564,117,151,632,749,803,954,25139,0,0,0,2
dragonriding-sgvigor-fill-flipbook-2x,23807,2564,288,500,803,1091,427,927,25140,0,0,0,2
dragonriding-sgvigor-fillfull-2x,23810,2564,72,100,1200,1272,554,654,25141,0,0,0,2
dragonriding-sgvigor-flash-2x,23813,2564,105,140,1093,1198,427,567,25142,0,0,0,2
dragonriding-sgvigor-flashlightning-flipbook-2x,23816,2564,272,200,1,273,803,1003,25164,0,0,0,2
dragonriding-sgvigor-frame-dark-2x,23819,2564,89,125,1093,1182,696,821,25145,0,0,0,2
dragonriding-sgvigor-frame-gold-2x,23820,2564,89,125,1093,1182,823,948,25146,0,0,0,2
dragonriding-sgvigor-frame-silver-2x,23821,2564,89,125,1200,1289,427,552,25147,0,0,0,2
dragonriding-sgvigor-spark-2x,23826,2564,93,20,275,368,956,976,25149,0,0,0,2
dragonriding-sgvigor-mask-2x,23827,2565,128,128,0,128,0,128,25159,0,0,16,0
genericwidgetbar-background-left,23828,2566,11,33,1,12,1,34,25064,0,0,0,0
genericwidgetbar-background-middle,23829,2566,176,38,14,190,1,39,25065,0,0,0,0
genericwidgetbar-background-right,23830,2566,11,33,1,12,45,78,25066,0,0,0,0
genericwidgetbar-spark-arrows,23831,2566,23,27,208,231,41,68,25067,0,0,0,0
genericwidgetbar-spell-frame,23833,2566,86,86,120,206,41,127,25069,0,0,0,0
genericwidgetbar-spell-glow,23834,2566,86,86,32,118,41,127,25070,0,0,0,0
genericwidgetbar-spark-line,23835,2566,16,15,14,30,41,56,25071,0,0,0,0
ui-questtrackerbutton-questitem-frame-glow,23836,2547,48,48,332,380,62,110,25072,0,0,0,0
ui-questtrackerbutton-questitem-frame,23837,2547,48,48,282,330,62,110,25073,0,0,0,0
questbg-emeralddream,23841,2571,299,407,1,300,1,408,25076,0,0,0,0
questbg-parchment-accessibility2,23842,1711,299,407,302,601,1,408,25077,0,0,0,0
questbg-parchment-accessibility3,23843,1711,299,407,603,902,1,408,25078,0,0,0,0
questbg-parchment-accessibility4,23844,1711,299,407,302,601,410,817,25079,0,0,0,0
campaign_emeralddream,23845,2063,608,138,1,609,281,419,25080,0,0,0,2
dragonriding-sgvigor-background-dark-2x,23853,2564,71,99,1200,1271,757,856,25134,0,0,0,2
dragonriding-barbershop-icon-netherwingdrake,23858,2070,128,128,317,445,261,389,25100,0,0,0,0
dragonriding-barbershop-icon-sg,23859,2579,128,128,1,129,1,129,25101,0,0,0,0
dreamsurge-backhighlight-full,23861,2587,45,46,1,46,1,47,25103,0,0,0,0
dreamsurge-tophighlight,23862,2587,43,43,48,91,1,44,25104,0,0,0,0
seedplanting-empty,23870,647,32,32,513,545,647,679,25105,18,18,0,0
seedplanting-full,23871,647,32,32,513,545,681,713,25106,18,18,0,0
ui-questtracker-objfx-shine-2x,23872,2548,308,46,561,869,59,105,25110,0,0,0,0
ui-questtrackerbutton-questitem-frame-2x,23873,2548,96,96,561,657,121,217,25073,0,0,0,0
ui-questtrackerbutton-questitem-frame-glow-2x,23874,2548,96,96,659,755,121,217,25072,0,0,0,0
ui-questtracker-objfx-shine,23875,2547,154,23,282,436,31,54,25110,0,0,0,0
cursor_ping_128,23876,2589,128,128,1,129,1,129,25111,0,0,0,0
cursor_ping_32,23877,2589,32,32,261,293,67,99,25112,0,0,0,0
cursor_ping_48,23878,2589,48,48,393,441,1,49,25113,0,0,0,0
cursor_ping_64,23879,2589,64,64,261,325,1,65,25114,0,0,0,0
cursor_ping_96,23880,2589,96,96,1,97,131,227,25115,0,0,0,0
cursor_unableping_128,23881,2589,128,128,131,259,1,129,25116,0,0,0,0
cursor_unableping_32,23882,2589,32,32,261,293,101,133,25117,0,0,0,0
cursor_unableping_48,23883,2589,48,48,443,491,1,49,25118,0,0,0,0
cursor_unableping_64,23884,2589,64,64,327,391,1,65,25119,0,0,0,0
cursor_unableping_96,23885,2589,96,96,131,227,131,227,25120,0,0,0,0
ui-lfg-declinemark-raid,23886,2462,64,64,1947,2011,259,323,25121,0,0,0,0
ui-lfg-pendingmark-raid,23887,2462,64,64,1947,2011,325,389,25122,0,0,0,0
ui-lfg-readymark-raid,23888,2462,64,64,1947,2011,391,455,25123,0,0,0,0
ui-lfg-roleicon-dps-micro-raid,23889,2462,12,12,2022,2034,70,82,25124,0,0,0,0
ui-lfg-roleicon-generic-micro-raid,23890,2462,12,12,2003,2015,89,101,25125,0,0,0,0
ui-lfg-roleicon-healer-micro-raid,23891,2462,12,12,2017,2029,89,101,25126,0,0,0,0
ui-lfg-roleicon-leader-micro-raid,23892,2462,12,12,2031,2043,89,101,25127,0,0,0,0
ui-lfg-roleicon-rangeddps-micro-raid,23893,2462,12,12,2003,2015,103,115,25128,0,0,0,0
ui-lfg-roleicon-tank-micro-raid-role,23894,2462,17,17,2003,2020,70,87,25129,0,0,0,0
ui-lfg-roleicon-tank-micro-raid,23895,2462,12,12,2017,2029,103,115,25130,0,0,0,0
dragonriding-sgvigor-decor-bronze-2x,23896,2564,117,151,275,392,803,954,25136,0,0,0,2
dragonriding-sgvigor-frame-bronze-2x,23897,2564,89,125,1093,1182,569,694,25144,0,0,0,2
ping_tutorial,23908,2594,945,760,1,946,1,761,25160,0,0,0,0
dragonriding-sgvigor-lightning-flipbook-left-2x,23909,2564,620,424,803,1423,1,425,25162,0,0,0,2
dragonriding-sgvigor-lightning-flipbook-right-2x,23910,2564,620,424,1425,2045,1,425,25163,0,0,0,2
splash-1017-botleft,23911,2595,137,371,374,511,587,958,25165,0,0,0,0
splash-1017-right,23912,2595,508,584,1,509,1,585,25166,0,0,0,0
splash-1017-topleft,23913,2595,371,434,1,372,587,1021,25167,0,0,0,0
shop-bundles-1017-91,24193,2606,277,224,1705,1982,1,225,25335,0,0,0,0
shop-bundles-1017-92,24194,2606,277,224,1705,1982,228,452,25336,0,0,0,0
shop-bundles-1017-93,24195,2606,277,224,569,846,682,906,25337,0,0,0,0
shop-bundles-1017-94,24196,2606,277,224,848,1125,682,906,25338,0,0,0,0
shop-bundles-1017-95,24197,2606,566,225,1,567,1,226,25339,0,0,0,0
shop-bundles-1017-96,24198,2606,566,225,569,1135,1,226,25340,0,0,0,0
shop-bundles-1017-97,24199,2606,566,225,1137,1703,1,226,25341,0,0,0,0
shop-bundles-1017-98,24200,2606,566,225,1,567,228,453,25342,0,0,0,0
talents-arrow-line-red,24201,2071,16,16,0,16,73,89,25343,8,8,4,0
shop-card-full-h35,24202,2607,568,463,1,569,1,464,25344,0,0,0,0
shop-card-full-lb74,24203,2608,568,463,1,569,1,464,25345,0,0,0,0
shop-card-full-ro64,24204,2609,568,463,1,569,1,464,25346,0,0,0,0
shop-card-full-hto12,24205,2610,568,463,1,569,1,464,25347,0,0,0,0
shop-card-full-hto365,24206,2610,568,463,1,569,466,929,25348,0,0,0,0
ui-questtracker-tracker-check-glow,24235,2547,19,19,459,478,31,50,25378,0,0,0,0
ui-questtracker-tracker-check-glow-2x,24236,2548,38,38,911,949,59,97,25378,0,0,0,0
ui-world-quest-black,24237,2613,330,1,134,464,16,17,25380,0,0,0,0
ui-world-quest-filigree-glow,24238,2613,49,19,83,132,16,35,25381,0,0,0,0
ui-world-quest-filigree,24239,2613,49,19,1,50,42,61,25382,0,0,0,0
ui-world-quest-golden-line-glow,24240,2613,350,6,83,433,1,7,25383,0,0,0,0
ui-world-quest-golden-line,24241,2613,350,5,83,433,9,14,25384,0,0,0,0
ui-world-quest-spark,24242,2613,23,5,52,75,42,47,25385,0,0,0,0
ui-world-quest-black-2x,24243,2614,660,2,263,923,27,29,25380,0,0,0,0
ui-world-quest-filigree-2x,24244,2614,98,38,1,99,81,119,25382,0,0,0,0
ui-world-quest-filigree-glow-2x,24245,2614,98,38,163,261,27,65,25381,0,0,0,0
ui-world-quest-golden-line-2x,24246,2614,700,10,163,863,15,25,25384,0,0,0,0
ui-world-quest-golden-line-glow-2x,24247,2614,700,12,163,863,1,13,25383,0,0,0,0
ui-world-quest-spark-2x,24248,2614,46,10,101,147,81,91,25385,0,0,0,0
shop-bundles-1017-apac-epic,24314,2606,566,225,1,567,455,680,25394,0,0,0,0
shop-bundles-1017-apac-heroic,24315,2606,566,225,1,567,682,907,25395,0,0,0,0
shop-bundles-1017-standard-base,24316,2606,277,224,1137,1414,455,679,25396,0,0,0,0
shop-bundles-1017-standard-epic,24317,2606,566,225,569,1135,228,453,25397,0,0,0,0
shop-bundles-1017-standard-heroic,24318,2606,277,224,1137,1414,681,905,25398,0,0,0,0
shop-bundles-1017-upsell-base2epic,24319,2606,566,225,1137,1703,228,453,25399,0,0,0,0
shop-bundles-1017-upsell-base2heroic,24320,2606,277,224,1416,1693,455,679,25400,0,0,0,0
shop-bundles-1017-upsell-heroic2epic,24321,2606,566,225,569,1135,455,680,25401,0,0,0,0
perks-theme-winterveil-tl-top,24403,2621,801,161,1,802,1,162,25483,0,0,0,0
perks-theme-winterveil-tp-bottombig,24404,2621,527,171,1,528,164,335,25484,0,0,0,0
perks-theme-winterveil-tp-topbig,24410,2621,527,108,223,750,337,445,25490,0,0,0,0
perks-theme-winterveil-tp-topsmall,24411,2621,360,133,530,890,164,297,25491,0,0,0,0
perks-theme-winterveil-tl-box,24412,2621,220,290,1,221,337,627,25492,0,0,0,0
transparentsquaremask,24413,2622,64,64,0,64,0,64,25493,0,0,16,0
cursor_unablewrapperturnin_128,24414,2623,128,128,131,259,1,129,25408,0,0,0,0
cursor_unablewrapperturnin_32,24415,2623,32,32,131,163,363,395,25409,0,0,0,0
cursor_unablewrapperturnin_48,24416,2623,48,48,51,99,457,505,25410,0,0,0,0
cursor_unablewrapperturnin_64,24417,2623,64,64,295,359,131,195,25411,0,0,0,0
cursor_unablewrapperturnin_96,24418,2623,96,96,1,97,261,357,25412,0,0,0,0
cursor_unablewrapper_128,24419,2623,128,128,1,129,1,129,25413,0,0,0,0
cursor_unablewrapper_32,24420,2623,32,32,131,163,329,361,25414,0,0,0,0
cursor_unablewrapper_48,24421,2623,48,48,1,49,457,505,25415,0,0,0,0
cursor_unablewrapper_64,24422,2623,64,64,229,293,131,195,25416,0,0,0,0
cursor_unablewrapper_96,24423,2623,96,96,391,487,1,97,25417,0,0,0,0
cursor_wrapperturnin_128,24424,2623,128,128,1,129,131,259,25418,0,0,0,0
cursor_wrapperturnin_32,24425,2623,32,32,131,163,431,463,25419,0,0,0,0
cursor_wrapperturnin_48,24426,2623,48,48,131,179,279,327,25420,0,0,0,0
cursor_wrapperturnin_64,24427,2623,64,64,427,491,131,195,25421,0,0,0,0
cursor_wrapperturnin_96,24428,2623,96,96,131,227,131,227,25422,0,0,0,0
cursor_wrapper_128,24429,2623,128,128,261,389,1,129,25423,0,0,0,0
cursor_wrapper_32,24430,2623,32,32,131,163,397,429,25424,0,0,0,0
cursor_wrapper_48,24431,2623,48,48,131,179,229,277,25425,0,0,0,0
cursor_wrapper_64,24432,2623,64,64,361,425,131,195,25426,0,0,0,0
cursor_wrapper_96,24433,2623,96,96,1,97,359,455,25427,0,0,0,0
cursor_recurring_128,24434,2624,128,128,131,259,1,129,26059,0,0,0,0
cursor_recurringturnin_32,24435,2624,32,32,131,163,363,395,26060,0,0,0,0
cursor_recurringturnin_48,24436,2624,48,48,51,99,457,505,26061,0,0,0,0
cursor_recurringturnin_64,24437,2624,64,64,295,359,131,195,26062,0,0,0,0
cursor_recurringturnin_96,24438,2624,96,96,1,97,261,357,26063,0,0,0,0
cursor_recurring_128,24439,2624,128,128,1,129,1,129,26054,0,0,0,0
cursor_recurring_32,24440,2624,32,32,131,163,329,361,26055,0,0,0,0
cursor_recurring_48,24441,2624,48,48,1,49,457,505,26056,0,0,0,0
cursor_recurring_64,24442,2624,64,64,229,293,131,195,26057,0,0,0,0
cursor_recurring_96,24443,2624,96,96,391,487,1,97,26058,0,0,0,0
cursor_unablerecurringturnin_128,24444,2624,128,128,1,129,131,259,26069,0,0,0,0
cursor_unablerecurringturnin_32,24445,2624,32,32,131,163,431,463,26070,0,0,0,0
cursor_unablerecurringturnin_48,24446,2624,48,48,131,179,279,327,26071,0,0,0,0
cursor_unablerecurringturnin_64,24447,2624,64,64,427,491,131,195,26072,0,0,0,0
cursor_unablerecurringturnin_96,24448,2624,96,96,131,227,131,227,26073,0,0,0,0
cursor_unablerecurring_128,24449,2624,128,128,261,389,1,129,26064,0,0,0,0
cursor_unablerecurring_32,24450,2624,32,32,131,163,397,429,26065,0,0,0,0
cursor_unablerecurring_48,24451,2624,48,48,131,179,229,277,26066,0,0,0,0
cursor_unablerecurring_64,24452,2624,64,64,361,425,131,195,26067,0,0,0,0
cursor_unablerecurring_96,24453,2624,96,96,1,97,359,455,26068,0,0,0,0
repeatableactivequesticon,24484,2625,24,24,1,25,1,25,26083,16,16,0,0
repeatableavailablequesticon,24485,2625,24,24,27,51,1,25,26084,16,16,0,0
repeatableincompletequesticon,24486,2625,24,24,1,25,27,51,26085,16,16,0,0
wrapperactivequesticon,24497,2626,24,24,1,25,1,25,25451,16,16,0,0
wrapperavailablequesticon,24498,2626,24,24,27,51,1,25,25452,16,16,0,0
wrapperincompletequesticon,24499,2626,24,24,1,25,27,51,25453,16,16,0,0
ui-questpoirecurring-innerglow,24500,2627,32,32,1,33,67,99,26074,0,0,0,0
ui-questpoirecurring-outerglow,24501,2627,64,64,1,65,1,65,26075,0,0,0,0
ui-questpoirecurring-questbang,24502,2627,32,32,67,99,1,33,26076,0,0,0,0
ui-questpoirecurring-questbangturnin,24503,2627,32,32,67,99,69,101,26077,0,0,0,0
ui-questpoirecurring-questnumber-pressed-supertracked,24504,2627,32,32,101,133,69,101,26080,0,0,0,0
ui-questpoirecurring-questnumber-pressed,24505,2627,32,32,101,133,35,67,26079,0,0,0,0
ui-questpoirecurring-questnumber-supertracked,24506,2627,32,32,135,167,1,33,26081,0,0,0,0
ui-questpoirecurring-questnumber,24507,2627,32,32,101,133,1,33,26078,0,0,0,0
ui-questpoirecurring-innerglow-2x,24508,2628,64,64,1,65,131,195,26074,0,0,0,0
ui-questpoirecurring-outerglow-2x,24509,2628,128,128,1,129,1,129,26075,0,0,0,0
ui-questpoirecurring-questbang-2x,24510,2628,64,64,131,195,1,65,26076,0,0,0,0
ui-questpoirecurring-questbangturnin-2x,24511,2628,64,64,131,195,133,197,26077,0,0,0,0
ui-questpoirecurring-questnumber-2x,24512,2628,64,64,197,261,1,65,26078,0,0,0,0
ui-questpoirecurring-questnumber-pressed-2x,24513,2628,64,64,197,261,67,131,26079,0,0,0,0
ui-questpoirecurring-questnumber-pressed-supertracked-2x,24514,2628,64,64,197,261,133,197,26080,0,0,0,0
ui-questpoirecurring-questnumber-supertracked-2x,24515,2628,64,64,263,327,1,65,26082,0,0,0,0
ui-questpoiwrapper-innerglow,24516,2629,32,32,1,33,67,99,25462,0,0,0,0
ui-questpoiwrapper-outerglow,24517,2629,64,64,1,65,1,65,25463,0,0,0,0
ui-questpoiwrapper-questbang,24518,2629,32,32,67,99,1,33,25464,0,0,0,0
ui-questpoiwrapper-questbangturnin,24519,2629,32,32,67,99,69,101,25465,0,0,0,0
ui-questpoiwrapper-questnumber-pressed-supertracked,24520,2629,32,32,101,133,69,101,25466,0,0,0,0
ui-questpoiwrapper-questnumber-pressed,24521,2629,32,32,101,133,35,67,25467,0,0,0,0
ui-questpoiwrapper-questnumber-supertracked,24522,2629,32,32,135,167,1,33,25468,0,0,0,0
ui-questpoiwrapper-questnumber,24523,2629,32,32,101,133,1,33,25469,0,0,0,0
ui-questpoiwrapper-innerglow-2x,24524,2630,64,64,1,65,131,195,25462,0,0,0,0
ui-questpoiwrapper-outerglow-2x,24525,2630,128,128,1,129,1,129,25463,0,0,0,0
ui-questpoiwrapper-questbang-2x,24526,2630,64,64,131,195,1,65,25464,0,0,0,0
ui-questpoiwrapper-questbangturnin-2x,24527,2630,64,64,131,195,133,197,25465,0,0,0,0
ui-questpoiwrapper-questnumber-2x,24528,2630,64,64,197,261,1,65,25469,0,0,0,0
ui-questpoiwrapper-questnumber-pressed-2x,24529,2630,64,64,197,261,67,131,25467,0,0,0,0
ui-questpoiwrapper-questnumber-pressed-supertracked-2x,24530,2630,64,64,197,261,133,197,25466,0,0,0,0
ui-questpoiwrapper-questnumber-supertracked-2x,24531,2630,64,64,263,327,1,65,25468,0,0,0,0
questlog-questtypeicon-recurring,24532,2429,18,18,41,59,105,123,26090,0,0,0,0
questlog-questtypeicon-recurringturnin,24533,2429,18,18,61,79,45,63,26091,0,0,0,0
questlog-questtypeicon-wrapper,24534,2429,18,18,61,79,85,103,25478,0,0,0,0
questlog-questtypeicon-wrapperturnin,24535,2429,18,18,61,79,105,123,25479,0,0,0,0
quest-repeatable-available,24536,647,32,32,479,511,647,679,26087,0,0,0,0
quest-repeatable-trivial,24537,647,32,32,479,511,681,713,26088,0,0,0,0
quest-repeatable-turnin,24538,647,32,32,479,511,715,747,26089,0,0,0,0
quest-wrapper-available,24539,647,32,32,479,511,749,781,25473,0,0,0,0
quest-wrapper-trivial,24540,647,32,32,479,511,783,815,25474,0,0,0,0
quest-wrapper-turnin,24541,647,32,32,479,511,817,849,25475,0,0,0,0
ui-dream-highlight-middle,24544,2633,800,262,1,801,1,263,25504,0,0,0,0
ui-dream-highlight-bottom,24545,2633,798,228,1,799,567,795,25505,0,0,0,0
ui-dream-rewardframe,24546,2633,128,128,877,1005,265,393,25506,0,0,0,0
ui-dream-headerorb-level0,24547,2633,182,220,803,985,1,221,25507,0,0,0,0
ui-dream-headerorb,24548,2633,182,220,693,875,265,485,25508,0,0,0,0
ui-dream-reward-slate,24549,2633,470,140,1,471,797,937,25509,0,0,0,0
ui-dream-highlight-top,24550,2633,690,300,1,691,265,565,25510,0,0,0,0
ui-dream-headerfill,24551,2633,182,220,801,983,567,787,25511,0,0,0,0
dragonflight-majorfactions-dream-background,24552,2632,822,580,1,823,1,581,25503,0,0,0,0
dragonriding-barbershop-icon-faeriedragon,24559,2070,128,128,317,445,131,259,25531,0,0,0,0
uitools-window-background-shadow,24560,2561,94,94,235,329,4,98,25532,0,0,0,0
uitools-search-background,24562,2561,24,24,235,259,100,124,25534,0,0,0,0
uitools-scrollbar-thumb,24565,2561,8,9,1,9,111,120,25537,0,0,0,0
uitools-scrollbar-track,24566,2561,8,9,141,149,112,121,25538,0,0,0,0
uitools-tab-gradient,24570,2561,32,32,331,363,72,104,25541,0,0,0,0
uitools-scrollbar-thumb-down,24603,2561,8,9,11,19,111,120,25566,0,0,0,0
uitools-scrollbar-thumb-over,24604,2561,8,9,131,139,112,121,25567,0,0,0,0
uitools-icon-highlight,24605,2561,24,24,48,72,77,101,25568,0,0,0,0
nineslicetool-dottedline-horizontal,24616,2561,23,1,45,68,1,2,25577,0,0,0,0
nineslicetool-dottedline-vertical,24617,2561,1,23,45,46,4,27,25578,0,0,0,0
majorfactions_icons_dream512,24618,2079,512,512,515,1027,1,513,25579,0,0,0,0
majorfaction-celebration-dream,24619,2222,235,110,238,473,1,111,25580,0,0,0,0
dragonflight-landingpage-radial-dream,24624,2133,96,96,501,597,811,907,25585,86,86,0,0
dragonflight-landingpage-renownbutton-dream-hover,24625,2133,508,160,1423,1931,487,647,25586,0,0,0,0
dragonflight-landingpage-renownbutton-dream,24626,2133,508,160,403,911,649,809,25587,0,0,0,0
majorfactions_mapicons_dream64,24638,647,64,64,71,135,461,525,25593,40,40,0,0
uitools-scrollbar-chevron-bottom-disabled,24786,2561,20,20,23,43,23,43,25569,0,0,0,0
uitools-scrollbar-chevron-bottom-down,24787,2561,20,20,1,21,89,109,25570,0,0,0,0
uitools-scrollbar-chevron-bottom-over,24788,2561,20,20,23,43,45,65,25571,0,0,0,0
uitools-scrollbar-chevron-bottom,24789,2561,20,20,1,21,1,21,25572,0,0,0,0
uitools-scrollbar-chevron-top-disabled,24790,2561,20,20,213,233,48,68,25573,0,0,0,0
uitools-scrollbar-chevron-top-down,24791,2561,20,20,213,233,92,112,25574,0,0,0,0
uitools-scrollbar-chevron-top-over,24792,2561,20,20,213,233,70,90,25575,0,0,0,0
uitools-scrollbar-chevron-top,24793,2561,20,20,23,43,67,87,25576,0,0,0,0
uitools-icon-checkbox,24797,2561,20,20,48,68,103,123,25517,0,0,0,0
uitools-icon-checkmark,24798,2561,22,20,96,118,77,97,25518,0,0,0,0
uitools-icon-chevron-down,24799,2561,20,20,23,43,89,109,25727,0,0,0,0
uitools-icon-chevron-left,24800,2561,20,20,23,43,1,21,25519,0,0,0,0
uitools-icon-chevron-right,24801,2561,20,20,1,21,67,87,25520,0,0,0,0
uitools-icon-close,24802,2561,20,20,1,21,45,65,25521,0,0,0,0
uitools-icon-minimize,24803,2561,20,20,74,94,77,97,25533,0,0,0,0
uitools-icon-refresh,24804,2561,20,20,96,116,99,119,25522,0,0,0,0
uitools-icon-search,24805,2561,20,20,213,233,26,46,25523,0,0,0,0
common-dropdown-a-button-disabled,24812,2634,27,27,93,120,221,248,25588,0,0,0,0
common-dropdown-a-button-hover,24813,2634,27,27,134,161,180,207,25553,0,0,0,0
common-dropdown-a-button-open,24814,2634,27,27,134,161,209,236,25559,0,0,0,0
common-dropdown-a-button-pressed,24815,2634,27,27,175,202,57,84,25554,0,0,0,0
common-dropdown-a-button-pressedhover,24816,2634,27,27,175,202,86,113,25555,0,0,0,0
common-dropdown-a-button,24817,2634,27,27,57,84,163,190,25556,0,0,0,0
common-dropdown-b-button-disabled,24818,2634,97,26,192,289,1,27,25589,0,0,0,0
common-dropdown-b-button-hover,24819,2634,97,26,291,388,1,27,25548,0,0,0,0
common-dropdown-b-button-open,24820,2634,97,26,390,487,1,27,25560,0,0,0,0
common-dropdown-b-button-pressed,24821,2634,97,26,93,190,29,55,25549,0,0,0,0
common-dropdown-b-button-pressedhover,24822,2634,97,26,192,289,29,55,25550,0,0,0,0
common-dropdown-b-button,24823,2634,97,26,93,190,1,27,25551,0,0,0,0
common-dropdown-bg,24824,2634,68,68,1,69,93,161,25557,0,0,0,0
common-dropdown-c-bg,24825,2634,90,90,1,91,1,91,25590,0,0,0,0
common-dropdown-c-button-disabled,24826,2634,39,39,42,81,206,245,25591,0,0,0,0
common-dropdown-c-button-hover-1,24827,2634,39,39,93,132,57,96,25728,0,0,0,0
common-dropdown-c-button-hover-2,24828,2634,39,39,93,132,98,137,25729,0,0,0,0
common-dropdown-c-button-hover-arrow,24829,2634,12,5,71,83,155,160,25565,0,0,0,0
common-dropdown-c-button-open,24830,2634,39,39,93,132,139,178,25513,0,0,0,0
common-dropdown-c-button-pressed-1,24831,2634,39,39,93,132,180,219,25730,0,0,0,0
common-dropdown-c-button-pressed-2,24832,2634,39,39,134,173,57,96,25731,0,0,0,0
common-dropdown-c-button-pressedhover-1,24833,2634,39,39,134,173,98,137,25732,0,0,0,0
common-dropdown-c-button-pressedhover-2,24834,2634,39,39,134,173,139,178,25733,0,0,0,0
common-dropdown-c-button,24835,2634,39,39,1,40,206,245,25502,0,0,0,0
common-dropdown-icon-checkmark-yellow,24836,2634,15,14,424,439,29,43,25561,0,0,0,0
common-dropdown-icon-radialtick-yellow,24837,2634,18,18,71,89,115,133,25562,0,0,0,0
common-dropdown-textholder,24838,2634,54,41,1,55,163,204,25558,0,0,0,0
common-dropdown-tickradial,24839,2634,18,18,71,89,135,153,25563,0,0,0,0
common-dropdown-ticksquare,24840,2634,12,12,57,69,192,204,25564,0,0,0,0
common-dropdown-icon-back-disabled,24841,2634,17,17,291,308,29,46,25734,0,0,0,0
common-dropdown-icon-back,24842,2634,17,17,489,506,1,18,25735,0,0,0,0
common-dropdown-icon-next-disabled,24843,2634,17,17,329,346,29,46,25736,0,0,0,0
common-dropdown-icon-next,24844,2634,17,17,310,327,29,46,25737,0,0,0,0
common-dropdown-icon-play,24845,2634,17,17,348,365,29,46,25738,0,0,0,0
common-dropdown-icon-sound-off,24846,2634,17,17,367,384,29,46,25739,0,0,0,0
common-dropdown-icon-sound-on,24847,2634,17,17,386,403,29,46,25740,0,0,0,0
common-dropdown-icon-stop,24848,2634,17,17,405,422,29,46,25741,0,0,0,0
fruit-minimap-icon,24905,647,32,32,581,613,409,441,25817,0,0,0,0
taxinode_undiscovered,24908,647,32,32,513,545,987,1019,25820,21,21,0,0
ui-flightpoint-discovery-toast-frame,24911,2613,80,39,1,81,1,40,25822,0,0,0,0
ui-flightpoint-discovery-toast-frame-2x,24912,2614,160,78,1,161,1,79,25822,0,0,0,0
unit_demonhunter_fury_endcap_1x,24913,2647,10,10,1,11,13,23,25826,0,0,0,0
unit_demonhunter_fury_fill_1x,24914,2647,126,10,1,127,1,11,25827,0,0,0,0
unit_demonhunter_fury_endcap_2x,24915,2648,20,21,1,21,24,45,25826,0,0,0,0
unit_demonhunter_fury_fill_2x,24916,2648,250,21,1,251,1,22,25827,0,0,0,0
unit_druid_astralpower_fill_1x,24917,2649,126,10,1,127,1,11,25830,0,0,0,0
unit_druid_astralpower_endcap_1x,24918,2649,10,10,1,11,13,23,25831,0,0,0,0
unit_druid_astralpower_endcap_2x,24919,2650,20,21,1,21,24,45,25831,0,0,0,0
unit_druid_astralpower_fill_2x,24920,2650,250,21,1,251,1,22,25830,0,0,0,0
unit_shaman_maelstrom_endcap_1x,24921,2651,10,10,1,11,13,23,25834,0,0,0,0
unit_shaman_maelstrom_fill_1x,24922,2651,126,10,1,127,1,11,25835,0,0,0,0
unit_shaman_maelstrom_endcap_2x,24923,2652,20,21,1,21,24,45,25834,0,0,0,0
unit_shaman_maelstrom_fill_2x,24924,2652,250,21,1,251,1,22,25835,0,0,0,0
unit_priest_insanity_fill_2x,24940,2654,250,21,1,251,1,22,25888,0,0,0,0
unit_priest_insanity_endcap_2x,24943,2654,20,21,253,273,1,22,25887,0,0,0,0
unit_priest_void_fill_2x_flipbook,24972,2654,1250,189,1,1251,24,213,25889,0,0,0,0
unit_priest_void_portraitfx_2x_flipbook,24973,2654,950,1710,1,951,215,1925,25890,0,0,0,0
unit_monk_stagger_fill_green_2x,24974,2657,250,21,1,251,1,22,25891,0,0,0,0
unit_monk_stagger_fill_red_2x,24975,2657,250,21,1,251,24,45,25892,0,0,0,0
unit_monk_stagger_fill_yellow_2x,24976,2657,250,21,1,251,47,68,25893,0,0,0,0
unit_monk_stagger_endcap_2x,24977,2657,20,21,1,21,70,91,25894,0,0,0,0
common-dropdown-c-bg-2x,24978,2658,180,180,1,181,1,181,25590,0,0,0,0
common-dropdown-c-button-2x,24979,2658,78,78,431,509,1,79,25502,0,0,0,0
common-dropdown-c-button-disabled-2x,24980,2658,78,78,321,399,85,163,25591,0,0,0,0
common-dropdown-c-button-hover-1-2x,24981,2658,78,78,401,479,85,163,25728,0,0,0,0
common-dropdown-c-button-hover-2-2x,24982,2658,78,78,1,79,345,423,25729,0,0,0,0
common-dropdown-c-button-hover-arrow-2x,24983,2658,24,10,321,345,165,175,25565,0,0,0,0
common-dropdown-c-button-open-2x,24984,2658,78,78,1,79,425,503,25513,0,0,0,0
common-dropdown-c-button-pressed-1-2x,24985,2658,78,78,81,159,345,423,25730,0,0,0,0
common-dropdown-c-button-pressed-2-2x,24986,2658,78,78,81,159,425,503,25731,0,0,0,0
common-dropdown-c-button-pressedhover-1-2x,24987,2658,78,78,161,239,345,423,25732,0,0,0,0
common-dropdown-c-button-pressedhover-2-2x,24988,2658,78,78,161,239,425,503,25733,0,0,0,0
common-dropdown-icon-back-2x,24989,2658,34,34,393,427,183,217,25735,0,0,0,0
common-dropdown-icon-back-disabled-2x,24990,2658,34,34,429,463,183,217,25734,0,0,0,0
common-dropdown-icon-next-2x,24991,2658,34,34,465,499,183,217,25737,0,0,0,0
common-dropdown-icon-next-disabled-2x,24992,2658,34,34,393,427,237,271,25736,0,0,0,0
common-dropdown-icon-play-2x,24993,2658,34,34,429,463,237,271,25738,0,0,0,0
common-dropdown-icon-sound-off-2x,24994,2658,34,34,465,499,237,271,25739,0,0,0,0
common-dropdown-icon-sound-on-2x,24995,2658,34,34,393,427,291,325,25740,0,0,0,0
common-dropdown-icon-stop-2x,24996,2658,34,34,429,463,291,325,25741,0,0,0,0
unit_monk_stagger_endcap_1x,24997,2659,10,10,1,11,37,47,25894,0,0,0,0
unit_monk_stagger_fill_green_1x,24998,2659,126,10,1,127,1,11,25891,0,0,0,0
unit_monk_stagger_fill_red_1x,24999,2659,126,10,1,127,13,23,25892,0,0,0,0
unit_monk_stagger_fill_yellow_1x,25000,2659,126,10,1,127,25,35,25893,0,0,0,0
ui-questpoilegendary-innerglow-2x,25001,2660,64,64,1,65,131,195,23779,0,0,0,0
ui-questpoilegendary-outerglow-2x,25002,2660,128,128,1,129,1,129,23780,0,0,0,0
ui-questpoilegendary-questbang-2x,25003,2660,64,64,131,195,1,65,23682,0,0,0,0
ui-questpoilegendary-questbangturnin-2x,25004,2660,64,64,131,195,133,197,23683,0,0,0,0
ui-questpoilegendary-questnumber-2x,25005,2660,64,64,197,261,1,65,23687,0,0,0,0
ui-questpoilegendary-questnumber-pressed-2x,25006,2660,64,64,197,261,67,131,23685,0,0,0,0
ui-questpoilegendary-questnumber-pressed-supertracked-2x,25007,2660,64,64,197,261,133,197,23684,0,0,0,0
ui-questpoilegendary-questnumber-supertracked-2x,25008,2660,64,64,263,327,1,65,23686,0,0,0,0
ui-questpoi-questbangturnin,25009,2549,32,32,67,99,1,33,25895,0,0,0,0
ui-questpoi-questbangturnin-2x,25010,2550,64,64,131,195,1,65,25895,0,0,0,0
unit_priest_insanity_endcap_1x,25011,2661,10,10,129,139,1,11,25887,0,0,0,0
unit_priest_insanity_fill_1x,25012,2661,126,10,1,127,1,11,25888,0,0,0,0
unit_priest_void_fill_1x_flipbook,25013,2661,595,90,1,596,13,103,25889,0,0,0,0
unit_priest_void_portraitfx_1x_flipbook,25014,2661,475,855,1,476,105,960,25890,0,0,0,0
unit_barmask_1x,25015,2662,128,16,0,128,0,16,25898,0,0,16,0
unit_barmask_2x,25016,2663,256,32,0,256,0,32,25898,0,0,16,0
spinner_ring,25017,2664,142,142,204,346,1,143,25899,0,0,0,0
spinner_sparks,25018,2664,142,142,348,490,1,143,25900,0,0,0,0
uitools-icon-window-resize-down,25020,2561,8,8,33,41,111,119,25902,0,0,0,0
uitools-icon-window-resize-over,25021,2561,8,8,23,31,111,119,25905,0,0,0,0
uitools-icon-window-resize,25022,2561,8,8,121,129,112,120,25540,0,0,0,0
common-dropdown-a-button-2x,25023,2658,54,54,241,295,345,399,25556,0,0,0,0
common-dropdown-a-button-disabled-2x,25024,2658,54,54,241,295,401,455,25588,0,0,0,0
common-dropdown-a-button-hover-2x,25025,2658,54,54,241,295,457,511,25553,0,0,0,0
common-dropdown-a-button-open-2x,25026,2658,54,54,297,351,345,399,25559,0,0,0,0
common-dropdown-a-button-pressed-2x,25027,2658,54,54,297,351,401,455,25554,0,0,0,0
common-dropdown-a-button-pressedhover-2x,25028,2658,54,54,297,351,457,511,25555,0,0,0,0
common-dropdown-b-button-2x,25029,2658,194,52,1,195,183,235,25551,0,0,0,0
common-dropdown-b-button-disabled-2x,25030,2658,194,52,197,391,183,235,25589,0,0,0,0
common-dropdown-b-button-hover-2x,25031,2658,194,52,1,195,237,289,25548,0,0,0,0
common-dropdown-b-button-open-2x,25032,2658,194,52,197,391,237,289,25560,0,0,0,0
common-dropdown-b-button-pressed-2x,25033,2658,194,52,1,195,291,343,25549,0,0,0,0
common-dropdown-b-button-pressedhover-2x,25034,2658,194,52,197,391,291,343,25550,0,0,0,0
common-dropdown-bg-2x,25035,2658,136,136,183,319,1,137,25557,0,0,0,0
common-dropdown-icon-checkmark-yellow-2x,25036,2658,30,28,481,511,85,113,25561,0,0,0,0
common-dropdown-icon-radialtick-yellow-2x,25037,2658,36,36,225,261,139,175,25562,0,0,0,0
common-dropdown-textholder-2x,25038,2658,108,82,321,429,1,83,25558,0,0,0,0
common-dropdown-tickradial-2x,25039,2658,36,36,263,299,139,175,25563,0,0,0,0
common-dropdown-ticksquare-2x,25040,2658,24,24,481,505,115,139,25564,0,0,0,0
quest-in-progress-icon-brown-2x,25058,2670,64,64,1,65,1,65,25923,0,0,0,0
quest-in-progress-icon-yellow-2x,25059,2670,64,64,67,131,1,65,25924,0,0,0,0
kiosk-bg,25060,2671,1920,1080,1,1921,1,1081,25925,0,0,0,0
kiosk-button,25061,2671,468,128,1,469,1083,1211,25926,0,0,0,0
common-dropdown-customize-mouseover-2x,25062,2658,40,40,183,223,139,179,25927,0,0,0,0
common-dropdown-customize-mouseover,25063,2634,20,20,71,91,93,113,25927,0,0,0,0
questlog-storylineicon,25066,2429,22,22,49,71,1,23,25930,0,0,0,0
questdetailsbackgrounds-accessibility_dark,25067,103,287,464,579,866,1,465,25931,0,0,0,0
questdetailsbackgrounds-accessibility_light,25068,103,287,464,579,866,467,931,25932,0,0,0,0
questdetailsbackgrounds-accessibility_medium,25069,103,287,464,868,1155,1,465,25933,0,0,0,0
questbg-shadow-bottom,25070,2673,299,60,1,300,1,61,25934,0,0,0,0
itembelt-empty-bg,25077,2674,72,72,1,73,1,73,25935,0,0,0,0
itembelt-frame-click,25078,2674,72,72,75,147,1,73,25936,0,0,0,0
itembelt-frame-highlight,25079,2674,72,72,149,221,1,73,25937,0,0,0,0
itembelt-frame,25080,2674,72,72,1,73,75,147,25938,0,0,0,0
itembelt-legendary-frame-highlight,25081,2674,72,72,1,73,149,221,25939,0,0,0,0
itembelt-legendary-frame,25082,2674,72,72,75,147,75,147,25940,0,0,0,0
wowlabs_minimapvoid-circle_corners,25083,2675,1000,1000,1,1001,1,1001,25941,0,0,0,0
wowlabs_minimapvoid-ring-single,25085,2675,1000,1000,1003,2003,1,1001,25943,0,0,0,0
clock-icon,25086,2676,32,32,961,993,1,33,24303,0,0,0,0
duos-icon-bubble-active,25087,2676,256,256,1,257,1,257,25944,0,0,0,0
duos-icon-bubble-default,25088,2676,256,256,259,515,1,257,25945,0,0,0,0
duos-icon-bubble-highlight,25089,2676,256,256,517,773,1,257,25946,0,0,0,0
queue-header-background,25090,2676,184,36,775,959,1,37,25947,0,0,0,0
solos-icon-bubble-active,25091,2676,256,256,1,257,259,515,25948,0,0,0,0
solos-icon-bubble-default,25092,2676,256,256,1,257,517,773,25949,0,0,0,0
solos-icon-bubble-highlight,25093,2676,256,256,259,515,259,515,25950,0,0,0,0
trios-icon-bubble-active,25094,2676,256,256,517,773,259,515,25951,0,0,0,0
trios-icon-bubble-default,25095,2676,256,256,259,515,517,773,25952,0,0,0,0
trios-icon-bubble-highlight,25096,2676,256,256,517,773,517,773,25953,0,0,0,0
wowlabs-currency-container-2x,25097,2677,196,76,1,197,1,77,25954,0,0,0,0
wowlabs-currency-container-highlight-2x,25098,2677,196,76,1,197,79,155,25955,0,0,0,0
wowlabs-background-rays,25099,2678,442,128,1,443,256,384,25956,0,0,0,0
wowlabs-score-background,25100,2678,467,253,1,468,1,254,25957,0,0,0,0
wowlabs-score-footer,25101,2678,467,71,1,468,386,457,25958,0,0,0,0
wowlabs-score-topper,25102,2678,467,71,470,937,131,202,25959,0,0,0,0
wowlabs-stars-fixed-multicolor-128,25103,2678,442,128,470,912,1,129,25960,0,0,0,0
wowlabs_spellbucketicon-fireball,25104,2679,32,32,1,33,1,33,25961,0,0,0,0
wowlabs_spellbucketicon-stars,25105,2679,32,32,1,33,1,33,25962,0,0,0,0
wowlabs_spellbucketicon-sword,25106,2679,32,32,35,67,1,33,25963,0,0,0,0
squad_size_duos,25107,2680,64,64,1923,1987,615,679,25964,0,0,0,0
squad_size_solo,25108,2680,64,64,1923,1987,681,745,25965,0,0,0,0
squad_size_trios,25109,2680,64,64,1923,1987,747,811,25966,0,0,0,0
wowlabs-in-world-item-common,25110,2681,60,60,1,61,1,61,25967,0,0,0,0
wowlabs-in-world-item-epic,25111,2681,60,60,1,61,63,123,25968,0,0,0,0
wowlabs-in-world-item-legendary,25112,2681,60,60,63,123,1,61,25969,0,0,0,0
wowlabs-in-world-item-rare,25113,2681,60,60,63,123,63,123,25970,0,0,0,0
wowlabs-in-world-item-uncommon,25114,2681,60,60,125,185,1,61,25971,0,0,0,0
wowlabs-rarity-pip-bg,25115,2681,48,16,125,173,63,79,25972,0,0,0,0
wowlabs-rarity-pip,25116,2681,7,7,175,182,63,70,25973,0,0,0,0
wowlabs-spectatecycling-arrowleft,25117,2682,58,55,535,593,1,56,25974,0,0,0,0
wowlabs-spectatecycling-arrowleft_disabled,25118,2682,58,55,595,653,1,56,25975,0,0,0,0
wowlabs-spectatecycling-arrowleft_hover,25119,2682,58,55,655,713,1,56,25976,0,0,0,0
wowlabs-spectatecycling-arrowleft_pressed,25120,2682,58,55,715,773,1,56,25977,0,0,0,0
wowlabs-spectatecycling-arrowright,25121,2682,58,55,775,833,1,56,25978,0,0,0,0
wowlabs-spectatecycling-arrowright_disabled,25122,2682,58,55,835,893,1,56,25979,0,0,0,0
wowlabs-spectatecycling-arrowright_hover,25123,2682,58,55,895,953,1,56,25980,0,0,0,0
wowlabs-spectatecycling-arrowright_pressed,25124,2682,58,55,955,1013,1,56,25981,0,0,0,0
wowlabs-spectatormode-footerbanner,25125,2682,532,52,1,533,1,53,25982,0,0,0,0
wowlabs-ability-icon-frame,25126,2683,60,60,329,389,1981,2041,25983,0,0,0,0
wowlabs-currency-container-2x,25127,2683,196,76,1039,1235,1482,1558,25954,0,0,0,0
wowlabs-currency-container-highlight-2x,25128,2683,196,76,1237,1433,1482,1558,25955,0,0,0,0
wowlabs-rarity-pip-bg,25129,2683,48,16,1951,1999,539,555,25972,0,0,0,0
wowlabs-rarity-pip,25130,2683,7,7,1377,1384,605,612,25973,0,0,0,0
wowlabs-spell-icon-frame-highlight,25131,2683,80,80,1039,1119,1560,1640,25984,0,0,0,0
wowlabs-switch-slots-key,25132,2683,64,32,323,387,1706,1738,25985,0,0,0,0
ui-hud-wowlabs-actionbar-bookend-left,25133,2683,152,80,237,389,1899,1979,25986,0,0,0,0
ui-hud-wowlabs-actionbar-bookend-right,25134,2683,152,80,879,1031,1596,1676,25987,0,0,0,0
ui-hud-wowlabs-actionbar-levelnumber-default,25135,2683,108,108,1919,2027,672,780,25988,0,0,0,0
ui-hud-wowlabs-actionbar-levelnumber-levelup,25136,2683,108,108,1919,2027,782,890,25989,0,0,0,0
ui-hud-wowlabs-actionbar-offense-cap,25137,2683,148,36,1197,1345,625,661,25990,0,0,0,0
ui-hud-wowlabs-actionbar-utility-cap,25138,2683,148,36,1719,1867,994,1030,25991,0,0,0,0
ui-hud-wowlabs-actionbar-xp-bg,25139,2683,320,320,1597,1917,672,992,25992,0,0,0,0
ui-hud-wowlabs-actionbar-xp-fill,25140,2683,320,320,1,321,1433,1753,25993,0,0,0,0
ui-hud-wowlabs-actionbar-xp-frame,25141,2683,320,320,395,715,1274,1594,25994,0,0,0,0
ui-hud-wowlabs-actionbar-xp-futurefill,25142,2683,320,320,395,715,1596,1916,25995,0,0,0,0
ui-hud-wowlabs-actionbar-xp-threshold,25143,2683,320,320,717,1037,1274,1594,25996,0,0,0,0
uitools-window-background,25158,2561,34,34,401,435,72,106,25530,0,0,0,0
roll100-cardbg-glow-inner,25159,2684,235,75,447,682,367,442,25997,0,0,0,0
roll100-cardbg-slam-gradient,25160,2684,235,75,783,1018,607,682,25998,0,0,0,0
roll100-cardbg-slam,25161,2684,311,119,1,312,709,828,25999,0,0,0,0
roll100-outerglow-1,25162,2684,274,114,1,275,830,944,26001,0,0,0,0
roll100-outerglow-2,25163,2684,444,291,1,445,180,471,26002,0,0,0,0
roll100-outerglow-3,25164,2684,343,185,447,790,180,365,26003,0,0,0,0
roll100-outline-top,25165,2684,235,75,1,236,946,1021,26004,0,0,0,0
roll100-sparkfx-1,25166,2684,233,75,314,547,709,784,26006,0,0,0,0
roll100-sparkfx-2,25167,2684,189,61,792,981,180,241,26007,0,0,0,0
rolls100-shine-anim,25168,2684,876,177,1,877,1,178,26008,0,0,0,0
rolls100-sparks1-anim,25169,2684,780,100,1,781,607,707,26009,0,0,0,0
rolls100-sparks2-anim,25170,2684,850,132,1,851,473,605,26010,0,0,0,0
genericwidgetbar-fill-edgeglow,25180,2566,1,13,1,2,80,93,26020,0,0,0,0
professions_tracking_herb_special,25182,647,44,42,203,247,620,662,26021,0,0,0,0
professions_tracking_ore_special,25183,647,48,42,905,953,83,125,26022,0,0,0,0
professions_tracking_fish_special,25186,647,40,40,203,243,748,788,26025,0,0,0,0
colorpicker-checkerboard,25188,2685,32,128,1,33,1,129,26027,0,0,0,0
shop-card-full-rx1,25189,2686,568,463,1,569,1,464,26028,0,0,0,0
shop-card-full-rx2,25190,2686,568,463,1,569,466,929,26029,0,0,0,0
shop-card-full-mq1,25191,2687,568,463,1,569,1,464,26030,0,0,0,0
shop-card-full-ba1,25192,2688,568,463,1,569,1,464,26031,0,0,0,0
shop-card-full-az1,25193,2689,568,463,1,569,1,464,26032,0,0,0,0
splash-1020-botleft,25195,2691,137,371,374,511,587,958,26034,0,0,0,0
splash-1020-right,25196,2691,510,584,1,511,1,585,26035,0,0,0,0
splash-1020-topleft,25197,2691,371,434,1,372,587,1021,26036,0,0,0,0
splash-10202-botleft,25198,2692,137,371,374,511,587,958,26037,0,0,0,0
splash-10202-right,25199,2692,510,584,1,511,1,585,26038,0,0,0,0
splash-10202-topleft,25200,2692,371,434,1,372,587,1021,26039,0,0,0,0
charactercreate-warlockpet-darkglare,25209,897,64,64,781,845,911,975,26042,0,0,0,0
charactercreate-warlockpet-tyrant,25210,897,64,64,1237,1301,131,195,26043,0,0,0,0
spellbook-divider,25217,2696,657,11,253,910,421,432,26050,0,0,0,0
activities-clock-expiringsoon,25664,1939,16,16,564,580,568,584,26094,0,0,0,0
activities-clock-standard,25665,1939,16,16,564,580,550,566,26095,0,0,0,0
spinner_shadow,25696,2664,201,201,1,202,1,202,26104,0,0,0,0
uitools-icon-minus,25699,2561,20,20,74,94,99,119,26107,0,0,0,0
uitools-icon-plus,25700,2561,20,20,213,233,4,24,26108,0,0,0,0
groupfinder-icon-class-color-deathknight,25705,236,30,30,295,325,435,465,26113,0,0,0,0
groupfinder-icon-class-color-demonhunter,25706,236,30,30,295,325,474,504,26114,0,0,0,0
groupfinder-icon-class-color-druid,25707,236,30,30,293,323,513,543,26115,0,0,0,0
groupfinder-icon-class-color-evoker,25708,236,30,30,293,323,551,581,26116,0,0,0,0
groupfinder-icon-class-color-hunter,25709,236,30,30,293,323,589,619,26117,0,0,0,0
groupfinder-icon-class-color-mage,25710,236,30,30,293,323,627,657,26118,0,0,0,0
groupfinder-icon-class-color-monk,25711,236,30,30,293,323,665,695,26119,0,0,0,0
groupfinder-icon-class-color-paladin,25712,236,30,30,293,323,703,733,26120,0,0,0,0
groupfinder-icon-class-color-priest,25713,236,30,30,293,323,741,771,26121,0,0,0,0
groupfinder-icon-class-color-rogue,25714,236,30,30,293,323,779,809,26122,0,0,0,0
groupfinder-icon-class-color-shaman,25715,236,30,30,293,323,817,847,26123,0,0,0,0
groupfinder-icon-class-color-warlock,25716,236,30,30,293,323,855,885,26124,0,0,0,0
groupfinder-icon-class-color-warrior,25717,236,30,30,293,323,893,923,26125,0,0,0,0
groupfinder-icon-role-micro-dps,25718,236,16,16,303,319,387,403,26126,0,0,0,0
groupfinder-icon-role-micro-heal,25719,236,16,16,303,319,405,421,26127,0,0,0,0
groupfinder-icon-role-micro-tank,25720,236,16,16,1,17,1007,1023,26128,0,0,0,0
bags-icon-multiple,25724,202,50,50,157,207,150,200,26132,0,0,0,0
bags-icon-reagents,25726,202,50,50,209,259,46,96,26134,0,0,0,0
bags-icon-profession-goods,25727,202,50,50,209,259,150,200,26135,0,0,0,0
gm-icon-assist-2x,25730,2702,80,80,1,81,1966,2046,26138,0,0,0,0
gm-icon-assistactive-2x,25731,2702,80,80,545,625,1891,1971,26139,0,0,0,0
gm-icon-assiston-2x,25732,2702,80,80,709,789,1809,1889,26140,0,0,0,0
gm-icon-countdown-2x,25733,2702,80,80,709,789,1891,1971,26141,0,0,0,0
gm-icon-difficulty-heroic-2x,25734,2702,80,80,1067,1147,1,81,26142,0,0,0,0
gm-icon-difficulty-heroicassist-2x,25735,2702,80,80,1395,1475,1,81,26143,0,0,0,0
gm-icon-difficulty-heroicselected-2x,25736,2702,80,80,1477,1557,1,81,26144,0,0,0,0
gm-icon-difficulty-mythic-2x,25737,2702,80,80,1723,1803,1,81,26145,0,0,0,0
gm-icon-difficulty-mythicassist-2x,25738,2702,80,80,1067,1147,83,163,26146,0,0,0,0
gm-icon-difficulty-mythicselected-2x,25739,2702,80,80,1149,1229,83,163,26147,0,0,0,0
gm-icon-difficulty-normal-2x,25740,2702,80,80,1395,1475,83,163,26148,0,0,0,0
gm-icon-difficulty-normalassist-2x,25741,2702,80,80,1723,1803,83,163,26149,0,0,0,0
gm-icon-difficulty-normalselected-2x,25742,2702,80,80,1805,1885,83,163,26150,0,0,0,0
gm-icon-menu-2x,25743,2702,80,80,1067,1147,165,245,26151,0,0,0,0
gm-icon-readycheck-2x,25744,2702,80,80,1313,1393,165,245,26152,0,0,0,0
gm-icon-roles-2x,25745,2702,80,80,1559,1639,165,245,26153,0,0,0,0
gm-icon-settings-2x,25746,2702,80,80,1805,1885,165,245,26154,0,0,0,0
gm-icon-visible-2x,25747,2702,80,80,1067,1147,247,327,26155,0,0,0,0
gm-icon-visibledis-2x,25748,2702,80,80,1313,1393,247,327,26156,0,0,0,0
gm-raidmarker-remove-2x,25749,2702,52,52,545,597,1973,2025,26157,0,0,0,0
gm-raidmarker-reset-2x,25750,2702,52,52,627,679,1973,2025,26158,0,0,0,0
gm-raidmarker1-2x,25751,2702,52,52,709,761,1973,2025,26159,0,0,0,0
gm-raidmarker2-2x,25752,2702,52,52,1969,2021,1,53,26160,0,0,0,0
gm-raidmarker3-2x,25753,2702,52,52,1969,2021,83,135,26161,0,0,0,0
gm-raidmarker4-2x,25754,2702,52,52,1969,2021,165,217,26162,0,0,0,0
gm-raidmarker5-2x,25755,2702,52,52,1641,1693,247,299,26163,0,0,0,0
gm-raidmarker6-2x,25756,2702,52,52,1695,1747,247,299,26164,0,0,0,0
gm-raidmarker7-2x,25757,2702,52,52,1749,1801,247,299,26165,0,0,0,0
gm-raidmarker8-2x,25758,2702,52,52,1803,1855,247,299,26166,0,0,0,0
gm-icon-assist,25759,2703,40,40,225,265,953,993,26138,0,0,0,0
gm-icon-assistactive,25760,2703,40,40,317,357,908,948,26139,0,0,0,0
gm-icon-assiston,25761,2703,40,40,401,441,908,948,26140,0,0,0,0
gm-icon-countdown,25762,2703,40,40,401,441,950,990,26141,0,0,0,0
gm-icon-difficulty-heroic,25763,2703,40,40,581,621,1,41,26142,0,0,0,0
gm-icon-difficulty-heroicassist,25764,2703,40,40,749,789,1,41,26143,0,0,0,0
gm-icon-difficulty-heroicselected,25765,2703,40,40,791,831,1,41,26144,0,0,0,0
gm-icon-difficulty-mythic,25766,2703,40,40,917,957,1,41,26145,0,0,0,0
gm-icon-difficulty-mythicassist,25767,2703,40,40,581,621,43,83,26146,0,0,0,0
gm-icon-difficulty-mythicselected,25768,2703,40,40,623,663,43,83,26147,0,0,0,0
gm-icon-difficulty-normal,25769,2703,40,40,749,789,43,83,26148,0,0,0,0
gm-icon-difficulty-normalassist,25770,2703,40,40,917,957,43,83,26149,0,0,0,0
gm-icon-difficulty-normalselected,25771,2703,40,40,959,999,43,83,26150,0,0,0,0
gm-icon-menu,25772,2703,40,40,581,621,85,125,26151,0,0,0,0
gm-icon-readycheck,25773,2703,40,40,707,747,85,125,26152,0,0,0,0
gm-icon-roles,25774,2703,40,40,833,873,85,125,26153,0,0,0,0
gm-icon-settings,25775,2703,40,40,959,999,85,125,26154,0,0,0,0
gm-icon-visible,25776,2703,40,40,581,621,127,167,26155,0,0,0,0
gm-icon-visibledis,25777,2703,40,40,707,747,127,167,26156,0,0,0,0
gm-raidmarker-remove,25778,2703,26,26,275,301,992,1018,26157,0,0,0,0
gm-raidmarker-reset,25779,2703,26,26,317,343,992,1018,26158,0,0,0,0
gm-raidmarker1,25780,2703,26,26,359,385,992,1018,26159,0,0,0,0
gm-raidmarker2,25781,2703,26,26,401,427,992,1018,26160,0,0,0,0
gm-raidmarker3,25782,2703,26,26,875,901,127,153,26161,0,0,0,0
gm-raidmarker4,25783,2703,26,26,903,929,127,153,26162,0,0,0,0
gm-raidmarker5,25784,2703,26,26,931,957,127,153,26163,0,0,0,0
gm-raidmarker6,25785,2703,26,26,959,985,127,153,26164,0,0,0,0
gm-raidmarker7,25786,2703,26,26,987,1013,127,153,26165,0,0,0,0
gm-raidmarker8,25787,2703,26,26,497,523,173,199,26166,0,0,0,0
ui-debug-tool-icon-large,25788,2561,71,71,48,119,4,75,26167,0,0,0,0
ui-debug-tool-icon-small,25789,2561,20,20,1,21,23,43,26168,0,0,0,0
uitools-row-background-01,25793,2561,552,28,461,1013,34,62,25524,0,0,0,0
uitools-row-background-02,25794,2561,552,28,461,1013,64,92,25525,0,0,0,0
uitools-row-background-hover,25795,2561,552,28,461,1013,4,32,25526,0,0,0,0
gm-icon-headcount,25799,2703,20,20,1001,1021,85,105,26169,0,0,0,0
gm-icon-role-dps,25800,2703,20,20,525,545,173,193,26170,0,0,0,0
gm-icon-role-healer,25801,2703,20,20,547,567,173,193,26171,0,0,0,0
gm-icon-role-tank,25802,2703,20,20,569,589,173,193,26172,0,0,0,0
gm-icon-headcount-2x,25803,2702,40,40,939,979,1959,1999,26169,0,0,0,0
gm-icon-role-dps-2x,25804,2702,40,40,939,979,2001,2041,26170,0,0,0,0
gm-icon-role-healer-2x,25805,2702,40,40,1857,1897,247,287,26171,0,0,0,0
gm-icon-role-tank-2x,25806,2702,40,40,1899,1939,247,287,26172,0,0,0,0
gm-bgclose-assists-2x,25807,2702,44,866,893,937,951,1817,26173,0,0,0,0
gm-bgclose-leads-2x,25808,2702,44,948,893,937,1,949,26174,0,0,0,0
gm-bgclose-regulars-2x,25809,2702,44,544,939,983,1269,1813,26175,0,0,0,0
gm-btnback-disabled-2x,25810,2702,32,70,83,115,1966,2036,26176,0,0,0,0
gm-btnback-hover-2x,25811,2702,32,70,413,445,1816,1886,26177,0,0,0,0
gm-btnback-normal-2x,25812,2702,32,70,413,445,1904,1974,26178,0,0,0,0
gm-btnback-pressed-2x,25813,2702,32,70,893,925,1819,1889,26179,0,0,0,0
gm-btnforward-disabled-2x,25814,2702,32,70,893,925,1891,1961,26180,0,0,0,0
gm-btnforward-hover-2x,25815,2702,32,70,893,925,1963,2033,26181,0,0,0,0
gm-btnforward-normal-2x,25816,2702,32,70,939,971,1815,1885,26182,0,0,0,0
gm-btnforward-pressed-2x,25817,2702,32,70,939,971,1887,1957,26183,0,0,0,0
gm-bgclose-assists,25818,2703,22,433,449,471,477,910,26173,0,0,0,0
gm-bgclose-leads,25819,2703,22,474,449,471,1,475,26174,0,0,0,0
gm-bgclose-regulars,25820,2703,22,272,473,495,637,909,26175,0,0,0,0
gm-btnback-disabled,25821,2703,16,35,449,465,912,947,26176,0,0,0,0
gm-btnback-hover,25822,2703,16,35,449,465,949,984,26177,0,0,0,0
gm-btnback-normal,25823,2703,16,35,449,465,986,1021,26178,0,0,0,0
gm-btnback-pressed,25824,2703,16,35,473,489,911,946,26179,0,0,0,0
gm-btnforward-disabled,25825,2703,16,35,473,489,948,983,26180,0,0,0,0
gm-btnforward-hover,25826,2703,16,35,473,489,985,1020,26181,0,0,0,0
gm-btnforward-normal,25827,2703,16,35,1001,1017,1,36,26182,0,0,0,0
gm-btnforward-pressed,25828,2703,16,35,1001,1017,43,78,26183,0,0,0,0
gm-bgopen-assists-2x,25829,2702,444,863,1,445,951,1814,26184,0,0,0,0
gm-bgopen-leads-2x,25830,2702,444,948,1,445,1,949,26185,0,0,0,0
gm-bgopen-regulars-2x,25831,2702,444,534,447,891,1273,1807,26186,0,0,0,0
gm-bgopen-assists,25832,2703,222,432,1,223,477,909,26184,0,0,0,0
gm-bgopen-leads,25833,2703,222,474,1,223,1,475,26187,0,0,0,0
gm-bgopen-regulars,25834,2703,222,267,225,447,639,906,26186,0,0,0,0
ui-hud-minimap-guildbanner-normal-large-2x,25850,2240,32,32,218,250,1,33,26202,0,0,0,0
ui-hud-minimap-guildbanner-normal-large,25851,2239,16,16,95,111,19,35,26202,0,0,0,0
common-button-tertiary-disabled-2x,25852,2705,92,68,1,93,145,213,26190,0,0,0,0
common-button-tertiary-disabled-small-2x,25853,2705,130,50,143,273,1,51,26203,0,0,0,0
common-button-tertiary-hover-2x,25854,2705,92,68,107,199,115,183,26191,0,0,0,0
common-button-tertiary-hover-small-2x,25855,2705,130,50,275,405,1,51,26204,0,0,0,0
common-button-tertiary-normal-2x,25856,2705,92,68,107,199,185,253,26192,0,0,0,0
common-button-tertiary-normal-small-2x,25857,2705,130,50,107,237,63,113,26205,0,0,0,0
common-button-tertiary-pressed-2x,25858,2705,92,68,201,293,115,183,26193,0,0,0,0
common-button-tertiary-pressed-small-2x,25859,2705,130,50,239,369,63,113,26206,0,0,0,0
common-button-tertiary-selected-2x,25860,2705,104,80,1,105,63,143,26194,0,0,0,0
common-button-tertiary-selected-small-2x,25861,2705,140,60,1,141,1,61,26207,0,0,0,0
common-button-tertiary-disabled-small,25862,2704,65,25,73,138,1,26,26203,0,0,0,0
common-button-tertiary-disabled,25863,2704,46,34,1,47,75,109,26190,0,0,0,0
common-button-tertiary-hover-small,25864,2704,65,25,140,205,1,26,26204,0,0,0,0
common-button-tertiary-hover,25865,2704,46,34,55,101,60,94,26191,0,0,0,0
common-button-tertiary-normal-small,25866,2704,65,25,55,120,33,58,26205,0,0,0,0
common-button-tertiary-normal,25867,2704,46,34,103,149,60,94,26192,0,0,0,0
common-button-tertiary-pressed-small,25868,2704,65,25,122,187,33,58,26206,0,0,0,0
common-button-tertiary-pressed,25869,2704,46,34,151,197,60,94,26193,0,0,0,0
common-button-tertiary-selected-small,25870,2704,70,30,1,71,1,31,26207,0,0,0,0
common-button-tertiary-selected,25871,2704,52,40,1,53,33,73,26194,0,0,0,0
gm-button-marker-applied,25872,2703,48,43,61,109,911,954,26208,0,0,0,0
gm-button-marker-appliedselected,25873,2703,48,43,61,109,956,999,26209,0,0,0,0
gm-button-marker-available,25874,2703,48,43,111,159,911,954,26210,0,0,0,0
gm-button-marker-hover,25875,2703,48,43,111,159,956,999,26211,0,0,0,0
gm-button-marker-pressed,25876,2703,48,43,161,209,956,999,26212,0,0,0,0
gm-button-marker-selected,25877,2703,48,43,225,273,908,951,26213,0,0,0,0
gm-button-marker-applied-2x,25878,2702,96,86,119,215,1816,1902,26208,0,0,0,0
gm-button-marker-appliedselected-2x,25879,2702,96,86,119,215,1904,1990,26209,0,0,0,0
gm-button-marker-available-2x,25880,2702,96,86,217,313,1816,1902,26210,0,0,0,0
gm-button-marker-hover-2x,25881,2702,96,86,217,313,1904,1990,26211,0,0,0,0
gm-button-marker-pressed-2x,25882,2702,96,86,315,411,1904,1990,26212,0,0,0,0
gm-button-marker-selected-2x,25883,2702,96,86,447,543,1809,1895,26213,0,0,0,0
gm-button-marker-disabled,25885,2703,48,43,161,209,911,954,26215,0,0,0,0
gm-button-marker-disabled-2x,25886,2702,96,86,315,411,1816,1902,26215,0,0,0,0
genericwidgetbar-neutralfill,25888,2566,13,13,14,27,58,71,26218,0,0,0,0
genericwidgetbar-arrow,25894,2566,7,7,1,8,36,43,26223,0,0,0,0
genericwidgetbar-marker-diamond,25895,2566,31,30,192,223,1,31,26224,0,0,0,0
genericwidgetbar-marker-plain,25896,2566,23,27,225,248,1,28,26225,0,0,0,0
gm-indicator-player,25897,2703,16,16,429,445,992,1008,26226,0,0,0,0
gm-indicator-player-2x,25898,2702,32,32,505,537,2013,2045,26226,0,0,0,0
ui-hud-minimap-guildbanner-normal-mini,25902,2239,10,11,39,49,53,64,26230,0,0,0,0
gm-tab-active-2x,25903,2702,86,44,119,205,1992,2036,26231,0,0,0,0
gm-tab-body-2x,25904,2702,116,148,1,117,1816,1964,26232,0,0,0,0
gm-tab-inactive-2x,25905,2702,86,40,217,303,1992,2032,26233,0,0,0,0
gm-tab-active,25906,2703,43,22,61,104,1001,1023,26231,0,0,0,0
gm-tab-body,25907,2703,58,74,1,59,911,985,26232,0,0,0,0
gm-tab-inactive,25908,2703,43,20,111,154,1001,1021,26233,0,0,0,0
gm-checkbox,25909,2703,16,16,255,271,995,1011,26234,0,0,0,0
gm-checkbox-2x,25910,2702,32,32,505,537,1979,2011,26234,0,0,0,0
streamcinematic-bc-large-down,25911,2707,246,135,1,247,1,136,26235,0,0,0,0
streamcinematic-bc-large-up,25912,2707,246,135,249,495,1,136,26236,0,0,0,0
streamcinematic-bfa-large-down,25913,2707,246,135,497,743,1,136,26237,0,0,0,0
streamcinematic-bfa-large-up,25914,2707,246,135,745,991,1,136,26238,0,0,0,0
streamcinematic-cc-large-down,25915,2707,246,135,1,247,138,273,26239,0,0,0,0
streamcinematic-cc-large-up,25916,2707,246,135,249,495,138,273,26240,0,0,0,0
streamcinematic-classic-large-down,25917,2707,246,135,497,743,138,273,26241,0,0,0,0
streamcinematic-classic-large-up,25918,2707,246,135,745,991,138,273,26242,0,0,0,0
streamcinematic-dragonflight-large-down,25920,2707,246,135,1,247,275,410,26243,0,0,0,0
streamcinematic-dragonflight-large-up,25921,2707,246,135,249,495,275,410,26244,0,0,0,0
streamcinematic-dragonflight2-large-up,25923,2707,246,135,745,991,275,410,26246,0,0,0,0
streamcinematic-legion-large-down,25925,2707,246,135,497,743,412,547,26247,0,0,0,0
streamcinematic-legion-large-up,25926,2707,246,135,745,991,412,547,26248,0,0,0,0
streamcinematic-lk-large-down,25927,2707,246,135,1,247,549,684,26249,0,0,0,0
streamcinematic-lk-large-up,25928,2707,246,135,1,247,686,821,26250,0,0,0,0
streamcinematic-mop-large-down,25929,2707,246,135,1,247,823,958,26251,0,0,0,0
streamcinematic-mop-large-up,25930,2707,246,135,249,495,549,684,26252,0,0,0,0
streamcinematic-shadowlands-large-down,25933,2707,246,135,497,743,549,684,26253,0,0,0,0
streamcinematic-shadowlands-large-up,25934,2707,246,135,745,991,549,684,26254,0,0,0,0
streamcinematic-wod-large-down,25935,2707,246,135,497,743,823,958,26255,0,0,0,0
streamcinematic-wod-large-up,25936,2707,246,135,745,991,823,958,26256,0,0,0,0
ui-hud-actionbar-frame-2x,25937,2708,110,110,1,111,1,111,26258,0,0,0,0
perks-list-fademask,25938,1918,350,107,533,883,225,332,26259,0,0,0,0
genericwidgetbar-neutralfill-glow,25939,2566,16,16,14,30,73,89,26219,0,0,0,0
streamcinematic-dragonflight2-large-down,25940,2707,246,135,497,743,275,410,26245,0,0,0,0
ui-hud-actionbar-petautocast-ants-2x,25941,2015,112,112,189,301,1533,1645,26262,0,0,0,0
ui-hud-actionbar-petautocast-corners-2x,25942,2015,68,68,303,371,1797,1865,26263,0,0,0,0
ui-hud-actionbar-petautocast-ants,25943,2476,77,77,1036,1113,403,480,26262,0,0,0,0
ui-hud-actionbar-petautocast-corners,25944,2476,46,46,1059,1105,498,544,26263,0,0,0,0
ui-hud-actionbar-petautocast-mask-2x,25945,2709,64,64,0,64,0,64,26265,0,0,16,0
ui-hud-actionbar-petautocast-mask,25946,2710,32,32,0,32,0,32,26265,0,0,16,0
ui-questtracker-lfg-eye-selected,25956,2547,36,46,420,456,62,108,26275,0,0,0,0
ui-questtracker-lfg-eye,25957,2547,36,46,382,418,62,108,26276,0,0,0,0
ui-questtracker-lfg-eye-2x,25958,2548,72,92,757,829,121,213,26276,0,0,0,0
ui-questtracker-lfg-eye-selected-2x,25959,2548,72,92,831,903,121,213,26275,0,0,0,0
splash-1025-botleft,25960,2711,137,371,374,511,587,958,26279,0,0,0,0
splash-1025-right,25961,2711,510,584,1,511,1,585,26280,0,0,0,0
splash-1025-topleft,25962,2711,371,434,1,372,587,1021,26281,0,0,0,0
hunter-stable-bg-art_cunning,25963,2712,720,520,1,721,1,521,26282,0,0,0,0
hunter-stable-bg-art_ferocity,25964,2712,720,520,723,1443,1,521,26283,0,0,0,0
hunter-stable-bg-art_tenacity,25965,2712,720,520,1,721,523,1043,26284,0,0,0,0
controls-bg,25976,2712,249,64,971,1220,693,757,26290,0,0,0,0
footer-bg,25977,2712,716,104,723,1439,523,627,26291,0,0,0,0
footer_active-ring,25978,2712,88,102,1927,2015,1,103,26292,0,0,0,0
footer_connecting-line,25979,2712,24,2,1464,1488,495,497,26293,0,0,0,0
footer_inactive-ring,25980,2712,116,116,1809,1925,1,117,26294,0,0,0,0
gold-divide,25981,2712,341,2,1222,1563,693,695,26295,0,0,0,0
pencil-icon,25982,2712,30,29,1575,1605,399,428,26296,0,0,0,0
pet-list-bg,25983,2712,315,525,1,316,1045,1570,26297,0,0,0,0
pet-list_active-ring_2x,25984,2712,180,180,1445,1625,1,181,26298,0,0,0,0
pet-list_default-ring_2x,25985,2712,180,180,1445,1625,183,363,26299,0,0,0,0
pet-list_inactive-ring_2x,25986,2712,180,180,1627,1807,1,181,26300,0,0,0,0
summojn-random-pet-icon_128,25987,2712,128,128,1445,1573,365,493,26354,0,0,0,0
summojn-random-pet-icon_32,25988,2712,32,32,1575,1607,365,397,26355,0,0,0,0
summojn-random-pet-icon_64,25989,2712,64,64,1927,1991,105,169,26356,0,0,0,0
wood-topper,25990,2712,1032,62,723,1755,629,691,26304,0,0,0,0
pet-list-bg-cunning-active,25992,2712,246,74,1627,1873,183,257,26306,0,0,0,0
pet-list-bg-cunning-default,25993,2712,246,74,1627,1873,259,333,26307,0,0,0,0
pet-list-bg-cunning-inactive,25994,2712,246,74,1627,1873,335,409,26308,0,0,0,0
pet-list-bg-ferocity-active,25995,2712,246,74,1627,1873,411,485,26309,0,0,0,0
pet-list-bg-ferocity-default,25996,2712,246,74,1441,1687,523,597,26310,0,0,0,0
pet-list-bg-ferocity-inactive,25997,2712,246,74,1689,1935,523,597,26311,0,0,0,0
pet-list-bg-tenacity-active,25998,2712,246,74,723,969,693,767,26312,0,0,0,0
pet-list-bg-tenacity-default,25999,2712,246,74,723,969,769,843,26313,0,0,0,0
pet-list-bg-tenacity-inactive,26000,2712,246,74,723,969,845,919,26314,0,0,0,0
pet-list_active-ring,26001,2712,90,90,1875,1965,411,501,26315,0,0,0,0
pet-list_default-ring,26002,2712,90,90,1937,2027,523,613,26316,0,0,0,0
pet-list_inactive-ring,26003,2712,90,90,723,813,921,1011,26317,0,0,0,0
plunderstorm-actionbar-topper-attack,26004,2683,160,96,1197,1357,527,623,26318,80,48,0,0
plunderstorm-actionbar-topper-offensive,26005,2683,708,96,945,1653,1050,1146,26319,354,48,0,0
plunderstorm-actionbar-topper-potion,26006,2683,160,96,1827,1987,561,657,26320,80,48,0,0
plunderstorm-actionbar-slot-background,26007,2683,84,84,1951,2035,189,273,26321,0,0,0,0
plunderstorm-actionbar-slot-border,26008,2683,84,84,1951,2035,281,365,26322,0,0,0,0
plunderstorm-actionbar-slot-corners,26009,2683,84,84,1951,2035,453,537,26323,0,0,0,0
plunderstorm-actionbar-slot-pip,26010,2683,16,16,1359,1375,605,621,26324,8,8,0,0
plunderstorm-actionbar-slot-pipbackground,26011,2683,84,84,879,963,1882,1966,26325,0,0,0,0
paw-icon,26012,2712,17,17,1445,1462,495,512,26326,0,0,0,0
plunderstorm-stormbar-background,26014,2683,464,55,1470,1934,1148,1203,26328,0,0,0,0
plunderstorm-stormbar-border,26015,2683,464,55,1470,1934,1205,1260,26329,0,0,0,0
plunderstorm-stormbar-fill,26016,2683,464,55,1039,1503,1274,1329,26330,0,0,0,0
plunderstorm-stormbar-spark,26017,2683,58,40,1989,2047,627,667,26331,29,20,0,0
plunderstorm-glues-queue-pending-background,26018,2680,379,110,1,380,1599,1709,26332,0,0,0,0
plunderstorm-glues-queue-pending-spinner-back,26019,2680,86,86,1923,2009,1,87,26333,0,0,0,0
plunderstorm-glues-queueselector-duo-selected,26021,2680,152,152,155,307,1865,2017,26335,76,76,0,0
plunderstorm-glues-queueselector-duo,26022,2680,152,152,155,307,1711,1863,26336,76,76,0,0
plunderstorm-glues-queueselector-solo-selected,26023,2680,152,152,309,461,1865,2017,26337,76,76,0,0
plunderstorm-glues-queueselector-solo,26024,2680,152,152,309,461,1711,1863,26338,76,76,0,0
plunderstorm-glues-queueselector-trio-selected,26025,2680,152,152,539,691,1237,1389,26339,76,76,0,0
plunderstorm-glues-queueselector-trio,26026,2680,152,152,539,691,1083,1235,26340,76,76,0,0
plunderstorm-spectate-arrow,26027,2683,21,33,1377,1398,625,658,26341,0,0,0,0
plunderstorm-spectate-background,26028,2683,523,65,945,1468,1148,1213,26342,0,0,0,0
plunderstorm-scenariotracker-active,26029,2683,263,91,1655,1918,1050,1141,26343,0,0,0,0
plunderstorm-scenariotracker-decoration,26030,2683,90,53,1936,2026,1148,1201,26344,0,0,0,0
plunderstorm-scenariotracker-waiting,26031,2683,263,91,1039,1302,1331,1422,26345,0,0,0,0
plunderstorm-toast-levelup-background,26032,2683,600,524,799,1399,1,525,26346,0,0,0,0
plunderstorm-glues-logoarrow,26036,2680,128,126,539,667,1699,1825,26350,64,63,0,0
plunderstorm-glues-button-friendslist,26037,2680,78,94,1923,2001,353,447,26351,52,63,0,0
shop-card-full-generic1,26038,2716,568,463,1,569,1,464,26352,0,0,0,0
shop-card-full-generic2,26039,2716,568,463,1,569,466,929,26353,0,0,0,0
plunderstorm-icon-item,26041,2683,56,64,981,1037,1678,1742,26358,0,0,0,0
plunderstorm-icon-offensive,26042,2683,56,64,981,1037,1780,1844,26359,0,0,0,0
plunderstorm-icon-utility,26043,2683,56,64,1907,1963,1482,1546,26360,0,0,0,0
plunderstorm-icon-upgrade,26044,2683,56,64,965,1021,1882,1946,26361,0,0,0,0
mappinglowblue-background,26049,2717,45,46,1,46,1,47,26366,0,0,0,0
mappinglowblue-tophighlight,26050,2717,43,43,48,91,1,44,26367,0,0,0,0
mappinglowgreen-background,26051,2717,45,46,1,46,49,95,26368,0,0,0,0
mappinglowgreen-tophighlight,26052,2717,43,43,48,91,46,89,26369,0,0,0,0
majorfaction-celebration-plunderstorm-bottomglowline,26053,2222,266,25,515,781,113,138,26370,0,0,0,0
majorfaction-celebration-plunderstorm,26054,2222,235,110,1,236,337,447,26371,0,0,0,0
majorfactions_icons_plunderstorm512,26055,2079,512,512,1029,1541,515,1027,26372,0,0,0,0
ui-plunderstorm-headerfill,26057,2719,182,220,803,985,1,221,26374,0,0,0,0
ui-plunderstorm-headerorb-level0,26058,2719,182,220,693,875,265,485,26375,0,0,0,0
ui-plunderstorm-headerorb,26059,2719,182,220,801,983,567,787,26376,0,0,0,0
ui-plunderstorm-highlight-bottom,26060,2719,798,228,1,799,567,795,26377,0,0,0,0
ui-plunderstorm-highlight-middle,26061,2719,800,262,1,801,1,263,26378,0,0,0,0
ui-plunderstorm-highlight-top,26062,2719,690,300,1,691,265,565,26379,0,0,0,0
ui-plunderstorm-reward-slate,26063,2719,470,140,1,471,797,937,26380,0,0,0,0
ui-plunderstorm-rewardframe,26064,2719,128,128,877,1005,265,393,26381,0,0,0,0
plunderstorm-decalbottom,26065,2720,120,45,1,121,795,840,26382,0,0,0,0
plunderstorm-nineslice-cornerbottomleft,26066,2720,166,166,1,167,65,231,26383,0,0,0,0
plunderstorm-nineslice-cornerbottomright,26067,2720,166,166,1,167,233,399,26384,0,0,0,0
plunderstorm-nineslice-cornertopleft,26068,2720,166,166,1,167,401,567,26385,0,0,0,0
plunderstorm-nineslice-cornertopright,26069,2720,166,166,1,167,569,735,26386,0,0,0,0
_plunderstorm-nineslice-edgebottom,26072,2720,256,30,0,256,1,31,26389,0,0,4,0
_plunderstorm-nineslice-edgetop,26073,2720,256,30,0,256,33,63,26390,0,0,4,0
wowlabs_minimapvoid-ring-prediction,26076,2675,1000,1000,1,1001,1003,2003,26393,0,0,0,0
wowlabs_minimapvoid-ring-single_lighting_1,26077,2722,1000,1000,1,1001,1,1001,26394,1266,1266,0,0
wowlabs_minimapvoid-ring-single_lighting_2,26078,2722,1000,1000,1003,2003,1,1001,26395,1266,1266,0,0
wowlabs_minimapvoid-ring-single_lighting_3,26079,2722,1000,1000,1,1001,1003,2003,26396,1266,1266,0,0
wowlabs_minimapvoid-ring-single_lighting_4,26080,2722,1000,1000,1003,2003,1003,2003,26397,1266,1266,0,0
plunderstorm-landingpagebutton-down,26081,2683,100,100,879,979,1678,1778,26398,0,0,0,0
plunderstorm-landingpagebutton-up,26082,2683,100,100,879,979,1780,1880,26399,0,0,0,0
shop-card-full-tw1,26083,2723,568,463,1,569,1,464,26400,0,0,0,0
shop-card-full-mu1,26084,2724,568,463,1,569,1,464,26401,0,0,0,0
shop-card-full-dr1,26085,2725,568,463,1,569,1,464,26402,0,0,0,0
ui-questpoilegendary-questbangturnin,26086,2423,32,32,67,99,69,101,23683,0,0,0,0
plunderstorm-actionbar-slot-border-swappable,26087,2683,84,84,1951,2035,367,451,26403,0,0,0,0
plunderstorm-actionbar-tabswappable-background,26088,2683,148,72,717,865,1973,2045,26404,0,0,0,0
plunderstorm-toast-finish-lose,26089,2683,548,278,1401,1949,1,279,26405,0,0,0,0
plunderstorm-toast-finish-win,26090,2683,548,278,1401,1949,281,559,26406,0,0,0,0
plunderstorm-nameplates-icon-1,26091,2683,76,76,879,955,1968,2044,26407,0,0,0,0
plunderstorm-nameplates-icon-2,26092,2683,76,76,957,1033,1968,2044,26408,0,0,0,0
plunderstorm-nameplates-icon-3,26093,2683,76,76,1829,1905,1482,1558,26409,0,0,0,0
plunderstorm-glues-logo-backglow,26094,2680,225,225,1,226,1372,1597,26410,0,0,0,0
plunderstorm-glues-logo-shadow,26095,2680,1920,1080,1,1921,1,1081,26411,0,0,0,0
gearenchantfx_charui_frame,26105,2728,233,323,417,650,372,695,26417,0,0,0,0
gearenchantfx_charui_mask,26109,2729,512,512,0,512,0,512,26421,0,0,16,0
plunderstorm-glues-queue-pending-spinner-front-duo,26110,2680,86,86,1923,2009,89,175,26422,0,0,0,0
plunderstorm-glues-queue-pending-spinner-front-solo,26111,2680,86,86,1923,2009,177,263,26423,0,0,0,0
plunderstorm-glues-queue-pending-spinner-front-trio,26112,2680,86,86,1923,2009,265,351,26424,0,0,0,0
plunderstorm-scenariotracker-active-frame,26113,2683,263,91,395,658,1918,2009,26425,0,0,0,0
cursor_enchant_128,26114,2730,128,128,1,129,1,129,26426,0,0,0,0
cursor_enchant_32,26115,2730,32,32,261,293,67,99,26427,0,0,0,0
cursor_enchant_48,26116,2730,48,48,393,441,1,49,26428,0,0,0,0
cursor_enchant_64,26117,2730,64,64,261,325,1,65,26429,0,0,0,0
cursor_enchant_96,26118,2730,96,96,1,97,131,227,26430,0,0,0,0
cursor_unableenchant_128,26119,2730,128,128,131,259,1,129,26431,0,0,0,0
cursor_unableenchant_32,26120,2730,32,32,261,293,101,133,26432,0,0,0,0
cursor_unableenchant_48,26121,2730,48,48,443,491,1,49,26433,0,0,0,0
cursor_unableenchant_64,26122,2730,64,64,327,391,1,65,26434,0,0,0,0
cursor_unableenchant_96,26123,2730,96,96,131,227,131,227,26435,0,0,0,0
plunderstorm-scenariotracker-waiting-frame,26124,2683,263,91,1304,1567,1331,1422,26436,0,0,0,0
plunderstorm-glues-tutorial-line,26125,2680,343,2,884,1227,1083,1085,26437,0,0,0,0
plunderstorm-glues-tutorial-swords,26126,2680,142,121,1,143,1915,2036,26438,0,0,0,0
glues-characterselect-button-card-down-disabled-2x,26128,2727,64,64,1863,1927,1209,1273,26440,0,0,0,0
glues-characterselect-button-card-up-disabled-2x,26132,2727,64,64,659,723,1423,1487,26444,0,0,0,0
glues-characterselect-card-camp-2x,26135,2727,632,190,1345,1977,253,443,26447,0,0,0,0
glues-characterselect-card-drag-2x,26136,2727,632,190,635,1267,499,689,26448,0,0,0,0
glues-characterselect-card-empty-2x,26137,2727,632,190,1269,1901,499,689,26449,0,0,0,0
glues-characterselect-card-glow-2x,26138,2727,656,214,1381,2037,1,215,26450,0,0,0,0
glues-characterselect-card-glow-swap-2x,26139,2727,656,214,687,1343,253,467,26451,0,0,0,0
glues-characterselect-card-singles-2x,26140,2727,620,178,1,621,883,1061,26452,0,0,0,0
glues-characterselect-divider-2x,26141,2727,784,20,807,1591,1187,1207,26453,0,0,0,0
glues-characterselect-icon-addcard-2x,26142,2727,156,156,1887,2043,691,847,26454,0,0,0,0
glues-characterselect-icon-addcard-glow-2x,26143,2727,156,156,1,157,1887,2043,26455,0,0,0,0
glues-characterselect-icon-faction-alliance-2x,26144,2727,72,92,305,377,1701,1793,26456,0,0,0,0
glues-characterselect-icon-faction-alliance-selected-2x,26145,2727,86,112,499,585,1401,1513,26457,0,0,0,0
glues-characterselect-icon-faction-horde-2x,26146,2727,72,92,499,571,1723,1815,26458,0,0,0,0
glues-characterselect-icon-faction-horde-selected-2x,26147,2727,86,112,499,585,1515,1627,26459,0,0,0,0
glues-characterselect-icon-minus-2x,26148,2727,62,62,725,787,1423,1485,26460,0,0,0,0
glues-characterselect-icon-minus-pressed-2x,26149,2727,62,62,725,787,1615,1677,26461,0,0,0,0
glues-characterselect-icon-plus-2x,26150,2727,62,62,725,787,1679,1741,26462,0,0,0,0
glues-characterselect-icon-search-2x,26151,2727,28,28,1887,1915,849,877,26463,0,0,0,0
glues-characterselect-plus-pressed-2x,26152,2727,62,62,725,787,1871,1933,26464,0,0,0,0
glues-characterselect-scroll-arrow-down-2x,26153,2727,32,22,1917,1949,849,871,26465,0,0,0,0
glues-characterselect-scroll-arrow-up-2x,26154,2727,32,22,1951,1983,849,871,26466,0,0,0,0
glues-characterselect-button-card-down-disabled,26155,2726,32,32,989,1021,314,346,26440,0,0,0,0
glues-characterselect-button-card-up-disabled,26159,2726,32,32,794,826,537,569,26444,0,0,0,0
glues-characterselect-card-camp,26163,2726,316,95,675,991,128,223,26447,0,0,0,0
glues-characterselect-card-drag,26164,2726,316,95,319,635,252,347,26448,0,0,0,0
glues-characterselect-card-empty,26165,2726,316,95,637,953,252,347,26449,0,0,0,0
glues-characterselect-card-glow-swap,26166,2726,328,107,345,673,128,235,26451,0,0,0,0
glues-characterselect-card-glow,26167,2726,328,107,693,1021,1,108,26450,0,0,0,0
glues-characterselect-card-singles,26168,2726,310,89,1,311,446,535,26452,0,0,0,0
glues-characterselect-divider,26169,2726,392,10,625,1017,499,509,26453,0,0,0,0
glues-characterselect-icon-addcard-glow,26170,2726,78,78,192,270,772,850,26455,0,0,0,0
glues-characterselect-icon-addcard,26171,2726,78,78,192,270,692,770,26454,0,0,0,0
glues-characterselect-icon-faction-alliance-selected,26172,2726,43,56,272,315,692,748,26457,0,0,0,0
glues-characterselect-icon-faction-alliance,26173,2726,36,46,154,190,860,906,26456,0,0,0,0
glues-characterselect-icon-faction-horde-selected,26174,2726,43,56,272,315,750,806,26459,0,0,0,0
glues-characterselect-icon-faction-horde,26175,2726,36,46,658,694,639,685,26458,0,0,0,0
glues-characterselect-icon-minus-pressed,26176,2726,31,31,317,348,791,822,26461,0,0,0,0
glues-characterselect-icon-minus,26177,2726,31,31,317,348,692,723,26460,0,0,0,0
glues-characterselect-icon-plus-pressed,26178,2726,31,31,317,348,923,954,26467,0,0,0,0
glues-characterselect-icon-plus,26179,2726,31,31,317,348,824,855,26462,0,0,0,0
glues-characterselect-icon-search,26180,2726,14,14,1007,1021,371,385,26463,0,0,0,0
glues-characterselect-scroll-arrow-down,26181,2726,16,12,1007,1023,387,399,26465,0,0,0,0
glues-characterselect-scroll-arrow-up,26182,2726,16,12,625,641,519,531,26466,0,0,0,0
plunderstorm-icon-fullyupgraded,26183,2683,56,64,1989,2045,561,625,26468,0,0,0,0
plunderstorm-glues-backgroundshadow,26184,2731,1920,1080,1,1921,1,1081,26469,0,0,0,0
glues-characterselect-tophud-bg-2x,26185,2727,660,102,1245,1905,883,985,26470,0,0,0,0
glues-characterselect-tophud-selected-left-2x,26186,2727,362,94,1,363,1509,1603,26471,0,0,0,0
glues-characterselect-tophud-selected-right-2x,26189,2727,362,94,1,363,1605,1699,26474,0,0,0,0
glues-characterselect-tophud-bg,26190,2726,330,51,625,955,446,497,26470,0,0,0,0
glues-characterselect-tophud-selected-left,26191,2726,181,47,1,182,762,809,26471,0,0,0,0
glues-characterselect-tophud-selected-right,26194,2726,181,47,1,182,811,858,26474,0,0,0,0
plunderstorm-icon-small-fullyupgraded,26195,2683,28,32,1347,1375,625,657,26475,21,24,0,0
plunderstorm-icon-small-item,26196,2683,28,32,1869,1897,994,1026,26476,21,24,0,0
plunderstorm-icon-small-offensive,26197,2683,28,32,1994,2022,998,1030,26477,21,24,0,0
plunderstorm-icon-small-upgrade,26198,2683,28,32,1,29,2006,2038,26478,21,24,0,0
plunderstorm-icon-small-utility,26199,2683,28,32,31,59,2006,2038,26479,21,24,0,0
glues-characterselect-button-collapseexpand,26200,2726,34,34,947,981,409,443,26480,0,0,0,0
glues-characterselect-card-all-bg,26201,2726,60,60,955,1015,252,312,26481,0,0,0,0
glues-characterselect-card-camp-bg,26202,2726,40,40,734,774,639,679,26482,0,0,0,0
glues-characterselect-scrollbar-bg,26203,2726,10,20,1007,1017,349,369,26483,0,0,0,0
glues-characterselect-scrollbar,26204,2726,10,20,1010,1020,225,245,26484,0,0,0,0
glues-characterselect-searchbar,26205,2726,24,24,998,1022,537,561,26485,0,0,0,0
glues-characterselect-button-collapseexpand-2x,26206,2727,68,68,1903,1971,621,689,26480,0,0,0,0
glues-characterselect-card-all-bg-2x,26207,2727,120,120,1903,2023,499,619,26481,0,0,0,0
glues-characterselect-card-camp-bg-2x,26208,2727,80,80,989,1069,1209,1289,26482,0,0,0,0
glues-characterselect-scrollbar-2x,26209,2727,20,40,2007,2027,445,485,26484,0,0,0,0
glues-characterselect-scrollbar-bg-2x,26210,2727,20,40,2025,2045,499,539,26483,0,0,0,0
glues-characterselect-searchbar-2x,26211,2727,48,48,1909,1957,445,493,26485,0,0,0,0
plunderstorm-stormbar-bgcenter,26212,2683,352,56,1569,1921,1331,1387,26486,176,28,0,0
plunderstorm-stormbar-bgleft,26213,2683,56,56,1411,1467,1215,1271,26487,28,28,0,0
plunderstorm-stormbar-bgright,26214,2683,56,56,1923,1979,1331,1387,26488,28,28,0,0
plunderstorm-stormbar-bordercenter,26215,2683,352,56,1039,1391,1424,1480,26489,176,28,0,0
plunderstorm-stormbar-borderleft,26216,2683,56,56,1981,2037,1331,1387,26490,28,28,0,0
plunderstorm-stormbar-borderright,26217,2683,56,56,1393,1449,1424,1480,26491,28,28,0,0
plunderstorm-stormbar-fill-filling,26218,2683,464,56,945,1409,1215,1271,26492,232,28,0,0
plunderstorm-toast-finish-matchend,26219,2683,548,222,395,943,1050,1272,26493,0,0,0,0
plunderstorm-ui-hud-unitframe-party-portraiton,26220,2683,120,49,1597,1717,994,1043,26494,0,0,0,0
glues-characterselect-carddivider-2x,26221,2727,649,5,687,1336,483,488,26497,0,0,0,0
glues-characterselect-listlauncher-bg-2x,26222,2727,740,74,1245,1985,987,1061,26498,0,0,0,0
glues-characterselect-carddivider,26223,2726,325,3,693,1018,110,113,26497,0,0,0,0
glues-characterselect-listlauncher-bg,26224,2726,370,37,192,562,537,574,26498,0,0,0,0
plunderstorm-scenariotracker-active-decoration,26225,2683,90,53,237,327,1981,2034,26499,0,0,0,0
plunderstorm-scenariotracker-waiting-decoration,26226,2683,90,53,1936,2026,1205,1258,26500,0,0,0,0
glues-characterselect-tophud-selected-line-left,26227,2726,175,6,693,868,115,121,26501,0,0,0,0
glues-characterselect-tophud-selected-line-middle,26228,2726,174,6,625,799,511,517,26502,0,0,0,0
glues-characterselect-tophud-selected-line-right,26229,2726,175,6,345,520,237,243,26503,0,0,0,0
glues-characterselect-tophud-selected-middle,26230,2726,24,47,986,1010,639,686,26504,0,0,0,0
glues-characterselect-tophud-bg-divider,26231,2726,2,44,1017,1019,252,296,26505,0,0,0,0
glues-characterselect-tophud-bg-divider-2x,26232,2727,4,88,2039,2043,1,89,26505,0,0,0,0
glues-characterselect-tophud-selected-line-left-2x,26233,2727,350,12,1381,1731,217,229,26501,0,0,0,0
glues-characterselect-tophud-selected-line-middle-2x,26234,2727,348,12,687,1035,469,481,26502,0,0,0,0
glues-characterselect-tophud-selected-line-right-2x,26235,2727,350,12,1381,1731,231,243,26503,0,0,0,0
glues-characterselect-tophud-selected-middle-2x,26236,2727,48,94,609,657,1291,1385,26504,0,0,0,0
plunderstorm-glues-icon-mouse-rightbutton,26237,2680,152,202,1,153,1711,1913,26506,52,69,0,0
glues-characterselect-card-selected-2x,26238,2727,684,244,695,1379,1,245,26507,0,0,0,0
glues-characterselect-card-selected,26239,2726,342,122,349,691,1,123,26507,0,0,0,0
plunderstorm-ui-hud-unitframe-party-portraiton-bar-health-mask,26240,2732,128,32,0,128,0,32,26508,0,0,16,0
ui-ej-icon-empoweredraid-large,26241,207,66,64,1,67,151,215,18484,32,32,0,0
plunderstorm-glues-wow-plunderstormlogo,26242,2680,536,287,1,537,1083,1370,26509,256,137,0,0
glues-characterselect-button-collapseexpand-pressed-2x,26243,2727,68,68,1727,1795,1209,1277,26510,0,0,0,0
glues-characterselect-button-collapseexpand-pressed,26244,2726,34,34,656,690,537,571,26510,0,0,0,0
plunderstorm-logo-limitedtimeevent-glow,26245,2680,189,44,693,882,1083,1127,26511,0,0,0,0
campaigninprogressquesticon,26246,2733,16,18,1,17,1,19,26512,0,0,0,0
importantinprogressquesticon,26247,2733,16,18,1,17,21,39,26513,0,0,0,0
legendaryinprogressquesticon,26248,2733,16,18,1,17,41,59,26514,0,0,0,0
repeatableinprogressquesticon,26249,2733,16,18,19,35,1,19,26515,0,0,0,0
sideinprogressquesticon,26250,2733,16,18,37,53,1,19,26516,0,0,0,0
wrapperinprogressquesticon,26251,2733,16,18,19,35,21,39,26517,0,0,0,0
plunderstorm-wavesleft,26252,2720,118,56,1,119,737,793,26518,0,0,0,0
plunderstorm-wavesright,26253,2720,118,56,121,239,737,793,26519,0,0,0,0
plunderstorm-majorfactions-plunderstorm-background,26254,2718,820,578,1,821,1,579,26520,0,0,0,0
!plunderstorm-nineslice-edgeleft,26257,2721,30,256,1,31,0,256,26523,0,0,2,0
!plunderstorm-nineslice-edgeright,26258,2721,30,256,33,63,0,256,26524,0,0,2,0
glues-characterselect-button-collapseexpand-hover,26259,2726,90,34,564,654,537,571,26525,0,0,0,0
glues-characterselect-card-camp-hover,26260,2726,316,95,1,317,252,347,26526,0,0,0,0
glues-characterselect-card-empty-hover,26261,2726,316,95,1,317,349,444,26527,0,0,0,0
glues-characterselect-card-selected-hover,26262,2726,342,122,1,343,128,250,26528,0,0,0,0
glues-characterselect-card-singles-hover,26263,2726,310,89,313,623,446,535,26529,0,0,0,0
glues-characterselect-icon-faction-alliance-hover,26264,2726,36,46,620,656,639,685,26530,0,0,0,0
glues-characterselect-icon-faction-horde-hover,26265,2726,36,46,696,732,639,685,26531,0,0,0,0
glues-characterselect-icon-minus-hover,26266,2726,31,31,317,348,758,789,26532,0,0,0,0
glues-characterselect-icon-plus-hover,26267,2726,31,31,317,348,890,921,26533,0,0,0,0
glues-characterselect-button-collapseexpand-hover-2x,26268,2727,180,68,807,987,1209,1277,26525,0,0,0,0
glues-characterselect-card-camp-hover-2x,26269,2727,632,190,1,633,499,689,26526,0,0,0,0
glues-characterselect-card-empty-hover-2x,26270,2727,632,190,1,633,691,881,26527,0,0,0,0
glues-characterselect-card-selected-hover-2x,26271,2727,684,244,1,685,253,497,26528,0,0,0,0
glues-characterselect-card-singles-hover-2x,26272,2727,620,178,623,1243,883,1061,26529,0,0,0,0
glues-characterselect-icon-faction-alliance-hover-2x,26273,2727,72,92,499,571,1629,1721,26530,0,0,0,0
glues-characterselect-icon-faction-horde-hover-2x,26274,2727,72,92,499,571,1817,1909,26531,0,0,0,0
glues-characterselect-icon-minus-hover-2x,26275,2727,62,62,725,787,1551,1613,26532,0,0,0,0
glues-characterselect-icon-plus-hover-2x,26276,2727,62,62,725,787,1807,1869,26533,0,0,0,0
plunderstorm-ui-hud-unitframe-player-portraiton-2x,26277,2683,396,142,799,1195,527,669,26534,0,0,0,2
plunderstorm-ui-hud-unitframe-player-portraiton,26278,2683,198,71,1435,1633,1482,1553,26535,0,0,0,0
plunderstorm-ui-hud-unitframe-player-portraiton-bar-health-mask,26280,2734,128,32,0,128,0,32,26537,0,0,16,0
plunderstorm-ui-hud-unitframe-player-portraiton-bar-health-mask-2x,26281,2735,256,64,0,256,0,64,26536,0,0,16,0
glues-characterselect-button-card-hover,26282,2726,32,32,726,758,537,569,26538,0,0,0,0
glues-characterselect-button-card-hover-2x,26284,2727,64,64,659,723,1291,1355,26538,0,0,0,0
questlog-frame,26286,2736,107,107,1,108,1,108,26540,0,0,0,0
questlog-frame-filigree,26291,2736,48,19,110,158,1,20,26545,0,0,0,0
questlog-header-glow-yellow,26292,2736,307,20,160,467,1,21,26546,0,0,0,0
questlog-icon-checkmark-yellow,26293,2736,17,14,130,147,22,36,26547,0,0,0,0
questlog-icon-expand,26294,2736,18,18,127,145,58,76,26548,0,0,0,0
questlog-icon-setting,26295,2736,15,16,110,125,58,74,26549,0,0,0,0
questlog-icon-shrink,26296,2736,18,18,110,128,22,40,26550,0,0,0,0
questlog-icon-ticksquare,26297,2736,14,14,110,124,42,56,26551,0,0,0,0
questlog-tab-side-glow-yellow,26302,2736,51,60,363,414,134,194,26556,0,0,0,0
questlog-tab-side,26303,2736,51,60,310,361,110,170,26557,0,0,0,0
questlog-main-background,26309,2737,307,510,310,617,1,511,26552,0,0,0,0
questlog-frame-2x,26310,2738,214,214,1,215,800,1014,26540,0,0,0,0
questlog-frame-filigree-2x,26314,2738,96,38,617,713,123,161,26545,0,0,0,0
questlog-header-glow-yellow-2x,26315,2738,614,40,217,831,800,840,26546,0,0,0,0
questlog-icon-checkmark-yellow-2x,26316,2738,34,28,987,1021,33,61,26547,0,0,0,0
questlog-icon-expand-2x,26317,2738,36,36,721,757,123,159,26548,0,0,0,0
questlog-icon-setting-2x,26318,2738,30,32,955,985,33,65,26549,0,0,0,0
questlog-icon-shrink-2x,26319,2738,36,36,759,795,123,159,26550,0,0,0,0
questlog-icon-ticksquare-2x,26320,2738,28,28,825,853,79,107,26551,0,0,0,0
questlog-tab-side-2x,26324,2738,102,120,617,719,1,121,26557,0,0,0,0
questlog-tab-side-glow-yellow-2x,26325,2738,102,120,721,823,1,121,26556,0,0,0,0
questlog-main-background-2x,26327,2739,614,1020,617,1231,1,1021,26552,0,0,0,0
glues-characterselect-button-card-down-disabled-hover,26328,2726,32,32,692,724,537,569,26576,0,0,0,0
glues-characterselect-button-card-pressed,26329,2726,32,32,760,792,537,569,26577,0,0,0,0
glues-characterselect-button-card-up-disabled-hover,26330,2726,32,32,828,860,537,569,26578,0,0,0,0
glues-characterselect-button-card,26331,2726,32,32,955,987,314,346,26579,0,0,0,0
glues-characterselect-icon-arrowdown-hover,26332,2726,32,32,896,928,537,569,26580,0,0,0,0
glues-characterselect-icon-arrowdown-pressed,26334,2726,32,32,930,962,537,569,26582,0,0,0,0
glues-characterselect-icon-arrowdown,26335,2726,32,32,862,894,537,569,26583,0,0,0,0
glues-characterselect-icon-arrowup-hover,26336,2726,32,32,272,304,884,916,26584,0,0,0,0
glues-characterselect-icon-arrowup-pressed,26338,2726,32,32,272,304,918,950,26586,0,0,0,0
glues-characterselect-icon-arrowup,26339,2726,32,32,272,304,850,882,26587,0,0,0,0
glues-characterselect-button-card-2x,26340,2727,64,64,1797,1861,1209,1273,26579,0,0,0,0
glues-characterselect-button-card-down-disabled-hover-2x,26341,2727,64,64,1929,1993,1209,1273,26576,0,0,0,0
glues-characterselect-button-card-pressed-2x,26342,2727,64,64,659,723,1357,1421,26577,0,0,0,0
glues-characterselect-button-card-up-disabled-hover-2x,26343,2727,64,64,659,723,1489,1553,26578,0,0,0,0
glues-characterselect-icon-arrowdown-2x,26344,2727,64,64,659,723,1555,1619,26583,0,0,0,0
glues-characterselect-icon-arrowdown-hover-2x,26345,2727,64,64,659,723,1621,1685,26580,0,0,0,0
glues-characterselect-icon-arrowdown-pressed-2x,26346,2727,64,64,659,723,1687,1751,26582,0,0,0,0
glues-characterselect-icon-arrowup-2x,26348,2727,64,64,659,723,1819,1883,26587,0,0,0,0
glues-characterselect-icon-arrowup-hover-2x,26349,2727,64,64,659,723,1885,1949,26584,0,0,0,0
glues-characterselect-icon-arrowup-pressed-2x,26350,2727,64,64,659,723,1951,2015,26586,0,0,0,0
questlog-frame-gradient-bottom,26354,2736,307,66,1,308,343,409,26589,0,0,0,0
questlog-reward-bottom,26355,2736,307,88,1,308,110,198,26590,0,0,0,0
questlog-reward-header-top,26356,2736,307,56,1,308,285,341,26591,0,0,0,0
questlog-reward-tile-vertical,26357,2736,307,83,1,308,200,283,26592,0,0,0,0
questlog-reward-top-frame,26358,2736,307,52,1,308,411,463,26593,0,0,0,0
questlog-frame-gradient-bottom-2x,26359,2738,614,132,1,615,346,478,26541,0,0,0,0
questlog-reward-bottom-2x,26360,2738,614,175,1,615,1,176,26590,0,0,0,0
questlog-reward-header-top-2x,26361,2738,614,111,1,615,480,591,26591,0,0,0,0
questlog-reward-tile-vertical-2x,26362,2738,614,166,1,615,178,344,26592,0,0,0,0
questlog-reward-top-frame-2x,26363,2738,614,103,1,615,593,696,26593,0,0,0,0
splash-10262-botleft,26367,2740,137,371,374,511,587,958,26599,0,0,0,0
splash-10262-right,26368,2740,510,584,1,511,1,585,26600,0,0,0,0
splash-10262-topleft,26369,2740,371,434,1,372,587,1021,26601,0,0,0,0
glues-characterselect-card-fx-spreada,26371,2726,312,91,319,631,349,440,26602,0,0,0,0
glues-characterselect-card-fx-spreadb,26372,2726,312,91,633,945,349,440,26603,0,0,0,0
glues-characterselect-card-glow-fx,26373,2726,346,125,1,347,1,126,26604,0,0,0,0
glues-characterselect-icon-arrowdown-pressed-hover,26374,2726,32,32,964,996,537,569,26581,0,0,0,0
glues-characterselect-icon-arrowup-pressed-hover,26375,2726,32,32,272,304,952,984,26585,0,0,0,0
glues-characterselect-icon-fx-plus,26376,2726,125,125,1,126,635,760,26605,0,0,0,0
glues-characterselect-card-fx-spreada-2x,26378,2727,624,182,635,1259,691,873,26602,0,0,0,0
glues-characterselect-card-fx-spreadb-2x,26379,2727,624,182,1261,1885,691,873,26603,0,0,0,0
glues-characterselect-card-glow-fx-2x,26380,2727,692,250,1,693,1,251,26604,0,0,0,0
glues-characterselect-icon-arrowdown-pressed-hover-2x,26381,2727,64,64,659,723,1753,1817,26581,0,0,0,0
glues-characterselect-icon-arrowup-pressed-hover-2x,26382,2727,64,64,725,789,1291,1355,26585,0,0,0,0
glues-characterselect-icon-fx-plus-2x,26383,2727,250,250,1,251,1257,1507,26605,0,0,0,0
gearenchantfx_charui_darkgold,26384,2728,414,415,1,415,1,416,26606,0,0,0,0
gearenchantfx_charui_gold,26385,2728,414,415,1,415,418,833,26607,0,0,0,0
gearenchant_iconborder,26386,2728,72,72,1,73,835,907,26608,0,0,0,0
glues-characterselect-card-camp-bg-glow,26387,2726,54,54,936,990,576,630,26609,0,0,0,0
glues-characterselect-card-camp-bg-glow-2x,26388,2727,108,108,499,607,1291,1399,26609,0,0,0,0
gearenchantfx_charui_sparkles,26389,2728,373,369,417,790,1,370,26420,0,0,0,0
plunderstorm-greenglow-redbutton-left,26390,2680,50,98,1923,1973,449,547,26610,0,0,0,0
plunderstorm-greenglow-redbutton-middle,26391,2680,2,98,2027,2029,449,547,26611,0,0,0,0
plunderstorm-greenglow-redbutton-right,26392,2680,50,98,1975,2025,449,547,26612,0,0,0,0
perks-theme-pirateday-tl-top,26395,2741,802,163,1,803,1,164,26615,0,0,0,0
perks-theme-pirateday-tp-bottombig,26396,2741,529,173,1,530,166,339,26616,0,0,0,0
perks-theme-pirateday-tp-bottomsmall,26397,2741,360,77,532,892,341,418,26617,0,0,0,0
perks-theme-pirateday-tp-topbig,26400,2741,529,110,1,530,341,451,26620,0,0,0,0
perks-theme-pirateday-tp-topsmall,26401,2741,360,133,532,892,166,299,26621,0,0,0,0
creditsscreen-keyart-10,26402,2742,1425,966,1,1426,1,967,26622,0,0,0,0
creditsscreen-background-10,26403,2743,512,512,0,512,0,512,26623,0,0,6,0
ui-hud-micromenu-professions-disabled-2x,26404,2136,64,82,595,659,85,167,26925,32,41,0,0
ui-hud-micromenu-professions-down-2x,26405,2136,64,82,595,659,169,251,26926,32,41,0,0
ui-hud-micromenu-professions-mouseover-2x,26406,2136,64,82,595,659,253,335,26927,32,41,0,0
ui-hud-micromenu-professions-up-2x,26407,2136,64,82,595,659,337,419,26928,32,41,0,0
plunderstorm-glues-nametag-renown,26408,2680,42,42,2003,2045,353,395,26628,0,0,0,0
plunderstorm-icon-key,26409,2683,108,96,1920,2028,1050,1146,26629,54,48,0,0
accountupgradebanner-thewarwithin,26410,558,200,134,203,403,273,407,26630,0,0,0,0
campaign_pandaria,26411,2744,608,138,1,609,1,139,26631,0,0,0,2
questbg-pandaria,26412,2745,299,407,1,300,1,408,26632,0,0,0,0
plunderstorm-logo-limitedtimeevent-glow-background,26413,2680,188,188,228,416,1372,1560,26633,0,0,0,0
raceicon128-earthen-female,26414,897,128,128,391,519,521,649,26634,0,0,0,0
raceicon128-earthen-male,26415,897,128,128,391,519,651,779,26635,0,0,0,0
raceicon-earthen-female,26416,897,64,64,1765,1829,263,327,26636,0,0,0,0
raceicon-earthen-male,26417,897,64,64,1831,1895,263,327,26637,0,0,0,0
activities-clock-completed,26418,1939,16,16,564,580,514,530,26638,0,0,0,0
activities-clock-disabled,26419,1939,16,16,564,580,478,494,26639,0,0,0,0
activities-clock-ineligible,26420,1939,16,16,564,580,532,548,26640,0,0,0,0
plunderstorm-waypoint-ring,26421,2683,52,52,1561,1613,1274,1326,26641,0,0,0,0
campaign_1027,26422,2063,608,138,1,609,1,139,26642,0,0,0,2
questbg-1027,26423,2746,299,407,1,300,1,408,26643,0,0,0,0
gm-bgclose-party-leads,26424,2703,22,344,473,495,1,345,26644,0,0,0,0
gm-bgclose-party-regulars,26425,2703,22,288,473,495,347,635,26645,0,0,0,0
gm-bgopen-party-leads,26426,2703,222,344,225,447,1,345,26646,0,0,0,0
gm-bgopen-party-regulars,26427,2703,222,290,225,447,347,637,26647,0,0,0,0
gm-bgclose-party-leads-2x,26428,2702,44,688,939,983,1,689,26644,0,0,0,0
gm-bgclose-party-regulars-2x,26429,2702,44,576,939,983,691,1267,26645,0,0,0,0
gm-bgopen-party-leads-2x,26430,2702,444,688,447,891,1,689,26646,0,0,0,0
gm-bgopen-party-regulars-2x,26431,2702,444,580,447,891,691,1271,26647,0,0,0,0
plunderstorm-nameplates-icon-ring,26432,2683,54,54,1505,1559,1274,1328,26648,36,36,0,0
timerunning-glues-icon,26433,2747,31,31,814,845,481,512,26649,0,0,0,0
questlog-empty-quest-background-2x,26448,2739,614,1020,1,615,1,1021,26588,0,0,0,0
questlog-empty-quest-background,26449,2737,307,510,1,308,1,511,26588,0,0,0,0
ui-frame-chamfered,26457,2769,137,137,1,138,1,138,26651,0,0,0,2
evergreen-scenario-black-background,26470,2771,330,1,1,331,421,422,26652,0,0,0,0
evergreen-scenario-filigree-bottom,26471,2771,34,12,405,439,12,24,26653,0,0,0,0
evergreen-scenario-filigree-top,26472,2771,50,15,353,403,12,27,26654,0,0,0,0
evergreen-scenario-line-bottom,26473,2771,350,5,1,351,407,412,26655,0,0,0,0
evergreen-scenario-line-top-glowing,26474,2771,350,6,1,351,399,405,26656,0,0,0,0
evergreen-scenario-line-top,26475,2771,350,5,1,351,414,419,26657,0,0,0,0
evergreen-scenario-pattern-background,26476,2771,302,50,1,303,347,397,26658,0,0,0,0
evergreen-scenario-black-background-2x,26479,2772,660,2,1,661,825,827,26652,0,0,0,0
evergreen-scenario-filigree-bottom-2x,26480,2772,68,24,805,873,21,45,26653,0,0,0,0
evergreen-scenario-filigree-top-2x,26481,2772,100,30,703,803,21,51,26654,0,0,0,0
evergreen-scenario-line-bottom-2x,26482,2772,700,10,1,701,801,811,26655,0,0,0,0
evergreen-scenario-line-top-2x,26483,2772,700,10,1,701,813,823,26657,0,0,0,0
evergreen-scenario-line-top-glowing-2x,26484,2772,700,12,1,701,787,799,26656,0,0,0,0
evergreen-scenario-pattern-background-2x,26485,2772,604,100,1,605,685,785,26658,0,0,0,0
timerunning-glues-active-event,26488,2747,446,150,1354,1800,315,465,26661,0,0,0,0
campaign-questlog-lorebackground-2x,26489,2773,614,1020,1,615,1,1021,12075,0,0,0,0
campaign-questlog-lorebottomshadow-2x,26490,2773,614,132,1233,1847,1023,1155,12080,0,0,0,0
campaign-questlog-loredivider-2x,26491,2773,570,116,1233,1803,1157,1273,12076,0,0,0,0
timerunning-glues-active-event-hover,26492,2747,446,150,544,990,856,1006,26662,0,0,0,0
plunderstorm-ui-hud-unitframe-player-portraiton-incombat-2x,26493,2683,384,142,1,385,1755,1897,26663,0,0,0,2
plunderstorm-ui-hud-unitframe-player-portraiton-incombat,26494,2683,192,71,1635,1827,1482,1553,26664,0,0,0,0
shop-card-full-gr45,26496,2775,568,463,1,569,1,464,26666,0,0,0,0
plunderstorm-glues-icon-leader,26498,2680,64,64,1923,1987,549,613,26668,32,32,0,0
splash-1026-botleft,26499,2776,137,371,374,511,587,958,26669,0,0,0,0
splash-1026-right,26500,2776,510,584,1,511,1,585,26670,0,0,0,0
splash-1026-topleft,26501,2776,371,434,1,372,587,1021,26671,0,0,0,0
talents-heroclass-deathknight-deathbringer,26502,2777,200,200,1,201,1,201,26672,0,0,0,0
talents-heroclass-deathknight-sanlayn,26503,2777,200,200,1,201,405,605,26673,0,0,0,0
talents-heroclass-druid-druidoftheclaw,26505,2777,200,200,203,403,1,201,26675,0,0,0,0
talents-heroclass-druid-wildstalker,26507,2777,200,200,203,403,607,807,26677,0,0,0,0
talents-heroclass-evoker-chronowarden,26508,2777,200,200,203,403,809,1009,26678,0,0,0,0
talents-heroclass-hunter-darkranger,26509,2777,200,200,405,605,405,605,26679,0,0,0,0
talents-heroclass-paladin-lightsmith,26510,2777,200,200,809,1009,203,403,26680,0,0,0,0
talents-heroclass-paladin-templar,26511,2777,200,200,809,1009,405,605,26681,0,0,0,0
talents-heroclass-priest-voidweaver,26512,2777,200,200,1011,1211,1,201,26682,0,0,0,0
talents-heroclass-shaman-stormbringer,26513,2777,200,200,1213,1413,1,201,26683,0,0,0,0
talents-heroclass-warrior-mountainthane,26514,2777,200,200,1213,1413,405,605,26684,0,0,0,0
talents-heroclass-druid-eluneschosen,26515,2777,200,200,203,403,203,403,26685,0,0,0,0
talents-heroclass-druid-keeperofthegrove,26516,2777,200,200,203,403,405,605,26686,0,0,0,0
completiondialog-warwithincampaign-adventuremode-icon,26517,2778,66,66,773,839,1,67,26687,0,0,0,0
completiondialog-warwithincampaign-background,26518,2778,770,598,1,771,1,599,26688,0,0,0,0
completiondialog-warwithincampaign-divider,26519,2778,670,111,1,671,601,712,26689,0,0,0,0
completiondialog-warwithincampaign-earthen-icon,26520,2778,67,65,841,908,1,66,26690,0,0,0,0
talents-heroclass-backplate-full,26522,2779,242,362,965,1207,1,363,26692,0,0,0,0
talents-heroclass-backplate-minimized-bottom,26523,2779,128,53,713,841,877,930,26693,0,0,0,0
talents-heroclass-backplate-minimized-middle,26524,2779,128,186,583,711,812,998,26694,0,0,0,0
talents-heroclass-backplate-minimized-top,26525,2779,128,63,713,841,812,875,26695,0,0,0,0
talents-heroclass-ring-mainpane,26526,2779,192,192,389,581,812,1004,26696,0,0,0,0
talents-heroclass-ring-minimize-hide,26527,2779,44,44,901,945,812,856,26697,0,0,0,0
talents-heroclass-ring-minimize-show,26528,2779,44,44,843,887,877,921,26698,0,0,0,0
talents-heroclass-ring-pointsavailable,26529,2779,56,56,843,899,812,868,26699,0,0,0,0
talents-heroclass-ring-selectionpane-gray,26530,2779,248,248,1463,1711,1,249,26700,0,0,0,0
talents-heroclass-ring-selectionpane-yellow,26531,2779,248,248,1713,1961,1,249,26701,0,0,0,0
talents-heroclass-paladin-heraldofthesun,26532,2777,200,200,809,1009,1,201,26702,0,0,0,0
talents-heroclass-shaman-totemic,26533,2777,200,200,1415,1615,1,201,26703,0,0,0,0
talents-heroclass-warrior-slayer,26534,2777,200,200,1213,1413,607,807,26704,0,0,0,0
ui-frame-bossportrait-background,26535,2780,199,244,1,200,46,290,26705,0,0,0,0
ui-frame-bossportrait-devider-left,26536,2780,24,37,202,226,180,217,27725,0,0,0,0
ui-frame-bossportrait-devider-middle-tile,26537,2780,16,23,0,16,1,24,27726,0,0,4,0
ui-frame-bossportrait-devider-right,26538,2780,24,37,228,252,180,217,27727,0,0,0,0
ui-frame-bossportrait-text-background,26539,2780,199,217,1,200,292,509,26709,0,0,0,0
ui-frame-bossportrait-topframe-left,26540,2780,37,65,202,239,46,111,26710,0,0,0,0
ui-frame-bossportrait-topframe-middle-tile,26541,2780,12,26,241,253,46,72,26711,0,0,0,0
ui-frame-bossportrait-topframe-right,26542,2780,37,65,202,239,113,178,26712,0,0,0,0
ui-frame-bossportrait-background-2x,26543,2781,398,488,1,399,87,575,26705,0,0,0,0
ui-frame-bossportrait-devider-left-2x,26544,2781,48,74,401,449,351,425,26706,0,0,0,0
ui-frame-bossportrait-devider-middle-tile-2x,26545,2781,32,46,0,32,1,47,26707,0,0,4,0
ui-frame-bossportrait-devider-right-2x,26546,2781,48,74,451,499,351,425,26708,0,0,0,0
ui-frame-bossportrait-text-background-2x,26547,2781,398,434,1,399,577,1011,26709,0,0,0,0
ui-frame-bossportrait-topframe-left-2x,26548,2781,74,130,401,475,87,217,26710,0,0,0,0
ui-frame-bossportrait-topframe-middle-tile-2x,26549,2781,24,52,477,501,87,139,26711,0,0,0,0
ui-frame-bossportrait-topframe-right-2x,26550,2781,74,130,401,475,219,349,26712,0,0,0,0
perks-theme-pirateday-tp-nineslice,26551,2782,586,862,1,587,1,863,26713,0,0,0,0
ui_icon_chest_npcreward,26552,1933,23,23,1983,2006,56,79,26714,0,0,0,0
timerunning-glues-icon-small,26553,2747,7,12,847,854,504,516,26715,0,0,0,0
timerunninghub,26596,647,19,19,567,586,107,126,26738,0,0,0,0
glues-characterselect-namebg,26597,2726,194,61,192,386,576,637,26739,0,0,0,0
glues-characterselect-iconshop-dis,26598,2726,24,24,984,1008,225,249,26740,0,0,0,0
glues-characterselect-iconshop-hover,26599,2726,24,24,166,190,915,939,26741,0,0,0,0
glues-characterselect-iconshop,26600,2726,24,24,958,982,225,249,26742,0,0,0,0
glues-characterselect-namebg-2x,26601,2727,388,122,381,769,1063,1185,26739,0,0,0,0
glues-characterselect-iconshop-2x,26602,2727,46,46,1959,2005,445,491,26742,0,0,0,0
glues-characterselect-iconshop-dis-2x,26603,2727,46,46,329,375,1809,1855,26740,0,0,0,0
glues-characterselect-iconshop-hover-2x,26604,2727,46,46,315,361,1991,2037,26741,0,0,0,0
talents-heroclass-backplate-intro,26611,2779,198,282,965,1163,365,647,26749,0,0,0,0
talents-heroclass-ring-intro-glow,26612,2779,252,252,1209,1461,1,253,26750,0,0,0,0
talents-heroclass-ring-intro-locked,26613,2779,192,192,195,387,812,1004,26751,0,0,0,0
talents-heroclass-ring-intro,26614,2779,192,192,1,193,812,1004,26752,0,0,0,0
common-mask-semicircle-right,26615,2787,256,256,0,256,0,256,26753,0,0,16,0
common-mask-semicircle-left,26616,2788,256,256,0,256,0,256,26754,0,0,16,0
talents-heroclass-warrior-colossus,26632,2777,200,200,1213,1413,203,403,26765,0,0,0,0
ui-ej-icon-empoweredraid-small,26633,207,16,16,482,498,1,17,18485,0,0,0,0
lang-alert-dede,26760,2672,1014,44,1,1015,1,45,26884,0,0,0,0
lang-alert-encn,26761,2672,394,44,585,979,415,459,26885,0,0,0,0
lang-alert-engb,26762,2672,582,44,1,583,415,459,26886,0,0,0,0
lang-alert-entw,26763,2672,395,44,627,1022,323,367,26887,0,0,0,0
lang-alert-enus,26764,2672,582,44,1,583,461,505,26888,0,0,0,0
lang-alert-eses,26765,2672,624,44,1,625,323,367,26889,0,0,0,0
lang-alert-esmx,26766,2672,624,44,1,625,369,413,26890,0,0,0,0
lang-alert-frfr,26767,2672,749,44,1,750,185,229,26891,0,0,0,0
lang-alert-itit,26768,2672,699,44,1,700,231,275,26892,0,0,0,0
lang-alert-kokr,26769,2672,694,44,1,695,277,321,26893,0,0,0,0
lang-alert-ptbr,26770,2672,1002,44,1,1003,47,91,26894,0,0,0,0
lang-alert-ptpt,26771,2672,1002,44,1,1003,93,137,26895,0,0,0,0
lang-alert-ruru,26772,2672,783,44,1,784,139,183,26896,0,0,0,0
lang-alert-zhcn,26773,2672,394,44,585,979,461,505,26897,0,0,0,0
lang-alert-zhtw,26774,2672,395,44,627,1022,369,413,26898,0,0,0,0
lang-regions-dede,26775,2672,99,44,1,100,553,597,26899,45,22,0,0
lang-regions-encn,26776,2672,246,44,752,998,185,229,26900,123,22,0,0
lang-regions-engb,26777,2672,153,44,218,371,507,551,26901,76,22,0,0
lang-regions-entw,26778,2672,233,44,786,1019,139,183,26902,116,22,0,0
lang-regions-enus,26779,2672,90,44,926,1016,507,551,26903,45,22,0,0
lang-regions-eses,26780,2672,215,44,1,216,507,551,26904,107,22,0,0
lang-regions-esmx,26781,2672,304,44,702,1006,231,275,26905,152,22,0,0
lang-regions-frfr,26782,2672,105,44,501,606,507,551,26906,52,22,0,0
lang-regions-itit,26783,2672,90,44,102,192,553,597,26907,45,22,0,0
lang-regions-kokr,26784,2672,78,44,194,272,553,597,26908,39,22,0,0
lang-regions-ptbr,26785,2672,126,44,373,499,507,551,26909,63,22,0,0
lang-regions-ptpt,26786,2672,285,44,697,982,277,321,26910,142,22,0,0
lang-regions-ruru,26787,2672,102,44,822,924,507,551,26911,51,22,0,0
lang-regions-zhcn,26788,2672,105,44,608,713,507,551,26912,52,22,0,0
lang-regions-zhtw,26789,2672,105,44,715,820,507,551,26913,52,22,0,0
map-filter-button-down,26790,2800,48,48,1,49,1,49,26914,0,0,0,0
map-filter-button,26791,2800,48,48,51,99,1,49,26915,0,0,0,0
common-mask-circle,26792,2801,256,256,0,256,0,256,26916,0,0,16,0
timerunning-dialog-framebackglow,26801,2796,93,93,360,453,502,595,26917,0,0,0,0
timerunning-dialog-frameglow,26802,2796,357,357,1,358,502,859,26918,0,0,0,0
timerunning-dialog-frametop,26803,2796,77,77,360,437,597,674,26919,0,0,0,0
timerunning-redbutton-backglow,26804,2796,265,51,1,266,934,985,26920,0,0,0,0
timerunning-redbutton-glow,26805,2796,278,278,501,779,1,279,26921,0,0,0,0
timerunning-redbutton-glow-mask,26806,2799,256,256,0,256,0,256,26922,0,0,16,0
timerunning-dialog-frameglow-mask,26807,2798,128,128,0,128,0,128,26923,0,0,16,0
timerunning-fx-cornerswoop-flipbook,26808,2795,2025,1792,1,2026,1,1793,26924,0,0,0,0
timerunning-dialog-fixedsize-frameglow-mask,26809,2805,512,512,0,512,0,512,26929,0,0,16,0
timerunning-infographic-background,26810,2747,811,539,1,812,1,540,26930,0,0,0,0
timerunning-infographic-bullet,26811,2747,24,24,814,838,514,538,26931,0,0,0,0
timerunning-infographic-mop-logo,26812,2747,541,312,1,542,856,1168,26932,0,0,0,0
talents-heroclass-priest-oracle,26814,2777,200,200,809,1009,809,1009,26934,0,0,0,0
talents-heroclass-warlock-diabolist,26815,2777,200,200,1617,1817,1,201,26935,0,0,0,0
warwithin-landingbutton-down,26816,2806,100,100,1,101,1,101,26936,0,0,0,0
warwithin-landingbutton-glow,26817,2806,100,100,103,203,1,101,26937,0,0,0,0
warwithin-landingbutton-highlight,26818,2806,100,100,1,101,103,203,26938,0,0,0,0
warwithin-landingbutton-up,26819,2806,100,100,103,203,103,203,26939,0,0,0,0
common-icon-yellowx,26820,1563,18,18,1,19,979,997,26940,0,0,0,0
common-icon-yellowx-down,26821,1563,18,18,1,19,999,1017,26941,0,0,0,0
timerunning-infographic-logo-fx,26885,2747,541,312,544,1085,542,854,26991,0,0,0,0
timerunning-infographic-logo-en,26893,2747,541,312,1,542,542,854,26997,0,0,0,0
timerunning-infographic-logo-cn,26895,2747,541,312,1354,1895,1,313,26996,0,0,0,0
timerunning-infographic-logo-tw,26896,2747,541,312,1087,1628,542,854,26998,0,0,0,0
timerunning-active-event-mask,26897,2809,512,512,0,512,0,512,26999,0,0,16,0
perks-infinity,26898,1918,34,18,815,849,472,490,27000,0,0,0,0
_bank-frame-horiz-shadow,26909,2810,256,64,0,256,1,65,27010,0,0,4,0
!bank-frame-vert-shadow,26910,2811,64,256,1,65,0,256,27011,0,0,2,0
bank-frame-background,26911,2812,256,256,0,256,0,256,27012,0,0,6,0
bank-frame-shadow-cornerbottomleft,26912,2810,46,46,1,47,175,221,27013,0,0,0,0
bank-frame-shadow-cornerbottomright,26913,2810,46,46,56,102,67,113,27014,0,0,0,0
bank-frame-shadow-cornertopleft,26914,2810,46,46,56,102,115,161,27015,0,0,0,0
bank-frame-shadow-cornertopright,26915,2810,46,46,56,102,163,209,27016,0,0,0,0
talents-heroclass-mage-frostfire,26916,2777,200,200,607,807,1,201,27017,0,0,0,0
talents-heroclass-rogue-trickster,26917,2777,200,200,1011,1211,607,807,27018,0,0,0,0
talents-heroclass-shaman-farseer,26918,2777,200,200,1011,1211,809,1009,27019,0,0,0,0
bank-frame-slot,26919,2810,53,52,1,54,67,119,27020,0,0,0,0
timerunning-glues-active-event-pressed,26920,2747,446,150,544,990,1008,1158,27021,0,0,0,0
charactercreate-startingzone-earthen,26922,1617,1022,664,1,1023,1333,1997,27023,0,0,0,0
raid frame,26924,2060,72,34,195,267,255,289,27024,0,0,0,0
ui-hud-unitframe-player-portraitoff-bar-temphploss,26925,2060,126,21,818,944,183,204,27025,0,0,0,0
ui-hud-unitframe-player-portraiton-bar-temphploss-divider-shadow,26926,2060,2,20,1008,1010,51,71,27026,0,0,0,0
ui-hud-unitframe-player-portraiton-bar-temphploss-divider,26927,2060,125,22,690,815,185,207,27027,0,0,0,0
ui-hud-unitframe-player-portraiton-bar-temphploss,26928,2060,130,21,818,948,160,181,27028,0,0,0,0
ui-hud-unitframe-player-portraiton-vehicle-bar-temphploss,26929,2060,118,20,269,387,255,275,27029,0,0,0,0
ui-hud-unitframe-target-minusmob-portraiton-bar-temphploss,26930,2060,125,12,714,839,235,247,27030,0,0,0,0
ui-hud-unitframe-target-portraiton-bar-temphploss,26931,2060,126,20,451,577,213,233,27031,0,0,0,0
ui-hud-unitframe-targetoftarget-portraiton-bar-temphploss,26932,2060,70,10,946,1016,195,205,27032,0,0,0,0
ui-hud-unitframe-player-portraitoff-bar-temphploss-2x,26933,2074,250,42,1351,1601,315,357,27033,0,0,0,0
ui-hud-unitframe-player-portraiton-bar-temphploss-2x,26934,2074,248,40,641,889,415,455,27034,0,0,0,0
ui-hud-unitframe-player-portraiton-bar-temphploss-divider-2x,26935,2074,248,44,1101,1349,315,359,27035,0,0,0,0
ui-hud-unitframe-player-portraiton-bar-temphploss-divider-shadow-2x,26936,2074,3,40,2015,2018,237,277,27036,0,0,0,0
ui-hud-unitframe-target-minusmob-portraiton-bar-temphploss-2x,26937,2074,249,23,1415,1664,415,438,27037,0,0,0,0
ui-hud-unitframe-target-portraiton-bar-temphploss-2x,26938,2074,252,40,387,639,415,455,27038,0,0,0,0
ui-hud-unitframe-targetoftarget-portraiton-bar-temphploss-2x,26939,2074,140,20,1857,1997,379,399,27039,0,0,0,0
ui-hud-unitframe-player-portraiton-bar-temphploss-divider-mask,26940,2815,32,32,0,32,0,32,27040,0,0,16,0
ui-hud-unitframe-player-portraiton-bar-temphploss-divider-mask-2x,26941,2816,64,64,0,64,0,64,27041,0,0,16,0
spellbook-list-backplate,26950,2696,316,106,1,317,313,419,26112,0,0,0,0
character-emptysocket,26952,2747,21,21,847,868,481,502,27050,0,0,0,0
questbg-storm,26953,2818,299,407,1,300,1,408,27051,0,0,0,0
questbg-candle,26954,2819,299,407,1,300,1,408,27052,0,0,0,0
questbg-flame,26955,2820,299,407,1,300,1,408,27053,0,0,0,0
questbg-web,26956,2821,299,407,1,300,1,408,27054,0,0,0,0
campaign_candle,26957,2822,608,138,1,609,141,279,27055,0,0,0,0
campaign_flame,26958,2822,608,138,1,609,281,419,27056,0,0,0,0
campaign_storm,26959,2822,608,138,1,609,421,559,27057,0,0,0,0
campaign_web,26960,2822,608,138,1,609,561,699,27058,0,0,0,0
campaign_1027,26961,2822,608,138,1,609,1,139,26642,0,0,0,0
gm-bgopen-divider-horizontal,26980,2703,215,2,497,712,169,171,27059,0,0,0,0
gm-bgopen-divider-vertical,26981,2703,2,31,211,213,911,942,27060,0,0,0,0
gm-bgopen-divider-horizontal-2x,26982,2702,430,4,985,1415,329,333,27059,0,0,0,0
gm-bgopen-divider-vertical-2x,26983,2702,4,62,529,533,1897,1959,27060,0,0,0,0
spellbook-background-evergreen-left,26987,2823,806,805,914,1720,61,866,27062,0,0,0,0
spellbook-background-evergreen-ribbon,26988,2823,102,557,810,912,61,618,27063,0,0,0,0
spellbook-background-evergreen-right,26989,2823,807,805,1,808,61,866,27064,0,0,0,0
spellbook-background-evergreen-header,26990,2823,1614,58,1,1615,1,59,27065,0,0,0,0
talents-heroclass-demonhunter-felscarred,26991,2777,200,200,1,201,809,1009,27066,0,0,0,0
talents-heroclass-evoker-scalecommander,26992,2777,200,200,405,605,203,403,27067,0,0,0,0
talents-heroclass-hunter-packleader,26993,2777,200,200,405,605,607,807,27068,0,0,0,0
talents-heroclass-monk-conduitofthecelestials,26994,2777,200,200,607,807,607,807,27069,0,0,0,0
talents-heroclass-monk-shadopan,26995,2777,200,200,607,807,809,1009,27070,0,0,0,0
groupfinder-highlightbar-red,26996,236,304,32,637,941,431,463,27071,0,0,0,0
splash-10271-botleft,27000,2826,137,371,374,511,587,958,27072,0,0,0,0
splash-10271-right,27001,2826,510,584,1,511,1,585,27073,0,0,0,0
splash-10271-topleft,27002,2826,371,434,1,372,587,1021,27074,0,0,0,0
splash-1027-botleft,27003,2827,137,371,374,511,587,958,27075,0,0,0,0
splash-1027-right,27004,2827,510,584,1,511,1,585,27076,0,0,0,0
splash-1027-topleft,27005,2827,371,434,1,372,587,1021,27077,0,0,0,0
questlog-frame-devider,27008,2736,93,15,160,253,23,38,27078,0,0,0,0
questlog-tab,27010,2736,64,22,363,427,110,132,27079,0,0,0,0
questlog-frame-devider-2x,27011,2738,186,30,825,1011,1,31,27078,0,0,0,0
questlog-tab-2x,27012,2738,128,44,825,953,33,77,27079,0,0,0,0
go-icon-split-vertical-available-2x,27013,2828,50,50,1,51,859,909,27080,0,0,0,0
go-border-dragging-over-2x,27014,2828,96,86,99,195,563,649,27081,0,0,0,0
go-icon-focus-applied-2x,27015,2828,40,40,105,145,747,787,27082,0,0,0,0
go-icon-split-none-available-2x,27016,2828,50,50,53,103,807,857,27083,0,0,0,0
go-border-group-dragging-over-2x,27017,2828,64,60,377,441,563,623,27084,0,0,0,0
go-bg-panel-2x,27018,2828,500,560,1,501,1,561,27085,0,0,0,0
go-icon-role-dps-ranged-2x,27019,2828,40,40,53,93,953,993,27086,0,0,0,0
go-icon-header-assist-applied-2x,27020,2828,50,50,53,103,755,805,27087,0,0,0,0
go-icon-plus-2-2x,27021,2828,80,80,295,375,563,643,27088,0,0,0,0
go-border-mainplayer-2x,27022,2828,96,86,1,97,563,649,27089,0,0,0,0
go-icon-assist-available-2x,27023,2828,40,40,105,145,789,829,27090,0,0,0,0
go-icon-plus-1-2x,27024,2828,56,56,443,499,563,619,27091,0,0,0,0
go-icon-split-none-applied-2x,27025,2828,50,50,1,51,963,1013,27092,0,0,0,0
go-icon-role-header-dps-ranged-2x,27026,2828,50,50,53,103,651,701,27093,0,0,0,0
go-dragging-inbetween-2x,27027,2828,190,10,105,295,651,661,27094,0,0,0,0
go-icon-role-header-tank-2x,27028,2828,50,50,1,51,703,753,27095,0,0,0,0
go-icon-assist-applied-2x,27029,2828,40,40,53,93,911,951,27096,0,0,0,0
go-icon-lead-applied-2x,27030,2828,40,40,105,145,705,745,27097,0,0,0,0
go-bg-group-2x,27031,2828,502,344,503,1005,1,345,27098,0,0,0,0
go-border-dragging-2x,27032,2828,96,86,197,293,563,649,27099,0,0,0,0
go-icon-focus-available-2x,27033,2828,40,40,105,145,663,703,27100,0,0,0,0
go-icon-header-assist-available-2x,27034,2828,50,50,1,51,651,701,27101,0,0,0,0
go-yellow-slice-2x,27035,2828,14,14,377,391,625,639,27102,0,0,0,0
go-icon-split-horizontal-available-2x,27036,2828,50,50,1,51,911,961,27103,0,0,0,0
go-icon-split-horizontal-applied-2x,27037,2828,50,50,1,51,755,805,27104,0,0,0,0
go-icon-split-vertical-applied-2x,27038,2828,50,50,53,103,703,753,27105,0,0,0,0
go-icon-role-header-dps-2x,27039,2828,50,50,53,103,859,909,27106,0,0,0,0
go-icon-role-header-healer-2x,27040,2828,50,50,1,51,807,857,27107,0,0,0,0
go-bg-group,27041,2829,251,172,253,504,1,173,27098,0,0,0,0
go-bg-panel,27042,2829,250,280,1,251,1,281,27085,0,0,0,0
go-border-dragging-over,27043,2829,48,43,51,99,283,326,27081,0,0,0,0
go-border-dragging,27044,2829,48,43,1,49,283,326,27099,0,0,0,0
go-border-group-dragging-over,27045,2829,32,30,193,225,283,313,27084,0,0,0,0
go-border-mainplayer,27046,2829,48,43,101,149,283,326,27089,0,0,0,0
go-dragging-inbetween,27047,2829,95,5,85,180,328,333,27094,0,0,0,0
go-icon-assist-applied,27048,2829,20,20,227,247,283,303,27096,0,0,0,0
go-icon-assist-available,27049,2829,20,20,227,247,305,325,27090,0,0,0,0
go-icon-focus-applied,27050,2829,20,20,31,51,490,510,27082,0,0,0,0
go-icon-focus-available,27051,2829,20,20,58,78,355,375,27100,0,0,0,0
go-icon-header-assist-applied,27052,2829,25,25,1,26,358,383,27087,0,0,0,0
go-icon-header-assist-available,27053,2829,25,25,1,26,385,410,27101,0,0,0,0
go-icon-lead-applied,27054,2829,20,20,58,78,377,397,27097,0,0,0,0
go-icon-plus-1,27055,2829,28,28,1,29,328,356,27091,0,0,0,0
go-icon-plus-2,27056,2829,40,40,151,191,283,323,27088,0,0,0,0
go-icon-role-dps-ranged,27057,2829,20,20,58,78,399,419,27086,0,0,0,0
go-icon-role-header-dps-ranged,27058,2829,25,25,1,26,439,464,27093,0,0,0,0
go-icon-role-header-dps,27059,2829,25,25,1,26,412,437,27106,0,0,0,0
go-icon-role-header-healer,27060,2829,25,25,1,26,466,491,27107,0,0,0,0
go-icon-role-header-tank,27061,2829,25,25,31,56,328,353,27095,0,0,0,0
go-icon-split-horizontal-applied,27062,2829,25,25,31,56,355,380,27104,0,0,0,0
go-icon-split-horizontal-available,27063,2829,25,25,31,56,382,407,27103,0,0,0,0
go-icon-split-none-applied,27064,2829,25,25,31,56,409,434,27092,0,0,0,0
go-icon-split-none-available,27065,2829,25,25,31,56,436,461,27083,0,0,0,0
go-icon-split-vertical-applied,27066,2829,25,25,31,56,463,488,27105,0,0,0,0
go-icon-split-vertical-available,27067,2829,25,25,58,83,328,353,27080,0,0,0,0
go-yellow-slice,27068,2829,7,7,193,200,315,322,27102,0,0,0,0
talents-animations-orb-activated,27069,2220,600,600,1219,1819,1,601,27108,0,0,0,0
talents-animations-heroclass-backplate-full-glow,27070,2220,242,362,1,243,1,363,27109,0,0,0,0
talents-animations-heroclass-backplate-intro-glow,27071,2220,198,282,1,199,365,647,27110,0,0,0,0
warbands-icon-2x,27074,2831,46,62,1,47,1,63,27113,0,0,0,0
warbands-icon,27075,2830,23,31,1,24,1,32,27113,0,0,0,0
warband-bank-frame-slot,27076,2810,53,52,1,54,121,173,27114,0,0,0,0
128-redbutton-arrowdown-disabled,27077,871,128,128,295,423,651,779,27115,0,0,0,0
128-redbutton-arrowdown-highlight,27078,871,128,128,295,423,781,909,27116,0,0,0,0
128-redbutton-arrowdown-pressed,27079,871,128,128,1,129,911,1039,27117,0,0,0,0
128-redbutton-arrowdown,27080,871,128,128,295,423,521,649,27118,0,0,0,0
128-redbutton-arrowupglow-disabled,27081,871,128,128,261,389,911,1039,27119,0,0,0,0
128-redbutton-arrowupglow-highlight,27082,871,128,128,1,129,1041,1169,27120,0,0,0,0
128-redbutton-arrowupglow-pressed,27083,871,128,128,131,259,1041,1169,27121,0,0,0,0
128-redbutton-arrowupglow,27084,871,128,128,131,259,911,1039,27122,0,0,0,0
talents-animations-heroclass-backgroundrunes,27085,2220,828,399,1219,2047,603,1002,27123,0,0,0,0
warbands-transferable-icon-2x,27086,2831,46,62,49,95,1,63,27124,0,0,0,0
warbands-transferable-icon,27087,2830,23,31,26,49,1,32,27124,0,0,0,0
delves-companion-background,27088,2832,336,460,1,337,1,461,27125,0,0,0,0
delves-companion-divider,27090,2832,290,3,1,291,463,466,27127,0,0,0,0
delves-companion-portrait-frame,27091,2832,228,247,339,567,1,248,27128,0,0,0,0
delves-companion-progress-fill,27092,2832,166,166,339,505,250,416,27129,0,0,0,0
go-bg-header,27093,2828,1026,82,1007,2033,1,83,27130,0,0,0,0
go-bg-header,27094,2829,513,41,506,1019,1,42,27130,0,0,0,0
shop-card-full-cm40,27095,2833,568,463,1,569,1,464,27131,0,0,0,0
talents-heroclass-demonhunter-aldrachireaver,27096,2777,200,200,1,201,607,807,27132,0,0,0,0
talents-heroclass-mage-sunfury,27097,2777,200,200,607,807,405,605,27133,0,0,0,0
timerunning-infographic-rewards,27114,2747,538,478,814,1352,1,479,26933,0,0,0,0
loreobject-32x32,27115,647,32,32,411,443,545,577,27147,0,0,0,0
notoriety-32x32,27116,647,45,45,823,868,83,128,27148,26,26,0,0
keyflameoff-32x32,27117,647,32,32,411,443,443,475,27149,0,0,0,0
keyflameon-32x32,27118,647,32,32,411,443,477,509,27150,0,0,0,0
delves-bountiful,27120,647,64,64,1,65,333,397,27152,25,25,0,0
delves-regular,27121,647,64,64,1,65,399,463,27153,30,30,0,0
bountiful-dark-circle,27122,2836,48,48,949,997,64,112,27154,0,0,0,0
bountiful-glow-rays-mask,27123,2836,76,105,1,77,667,772,27155,0,0,0,0
bountiful-glow,27124,2836,75,101,1,76,774,875,27156,0,0,0,0
bountiful-icon,27125,2836,61,61,949,1010,1,62,27157,0,0,0,0
bountiful-glow-rays,27126,2836,946,664,1,947,1,665,27158,0,0,0,0
ui-frame-thewarwithin-cardparchment,27127,2837,254,439,591,845,88,527,27159,0,0,0,0
ui-frame-thewarwithin-cardparchmentwider,27128,2837,515,438,1,516,678,1116,27160,0,0,0,0
ui-frame-thewarwithin-disablesubtitle,27129,2837,207,30,591,798,640,670,27161,0,0,0,0
ui-frame-thewarwithin-portrait,27130,2837,205,109,591,796,529,638,27162,0,0,0,0
ui-frame-thewarwithin-portraitdisable,27131,2837,205,109,1,206,1204,1313,27163,0,0,0,0
ui-frame-thewarwithin-portraitwider,27132,2837,390,207,518,908,678,885,27164,0,0,0,0
ui-frame-thewarwithin-portraitwiderdisable,27133,2837,390,207,518,908,887,1094,27165,0,0,0,0
ui-frame-thewarwithin-ribbon,27134,2837,281,84,1,282,1118,1202,27166,0,0,0,0
ui-frame-thewarwithin-subtitle,27135,2837,207,30,284,491,1118,1148,27167,0,0,0,0
ui-frame-thewarwithin-titleleft,27136,2837,202,85,208,410,1204,1289,27168,0,0,0,0
ui-frame-thewarwithin-titleright,27137,2837,202,85,412,614,1204,1289,27169,0,0,0,0
_ui-frame-thewarwithin-titlemiddle,27138,2837,128,85,0,128,1,86,27170,0,0,4,0
glues-characterselect-icon-notify-bg-2x,27139,2727,80,80,1071,1151,1209,1289,27171,0,0,0,0
glues-characterselect-icon-notify-bg-hover-2x,27140,2727,80,80,1153,1233,1209,1289,27172,0,0,0,0
glues-characterselect-icon-notify-inprogress-2x,27141,2727,80,80,1235,1315,1209,1289,27173,0,0,0,0
glues-characterselect-icon-notify-inprogress-hover-2x,27142,2727,80,80,1317,1397,1209,1289,27174,0,0,0,0
glues-characterselect-icon-notify-lock-2x,27143,2727,80,80,1399,1479,1209,1289,27175,0,0,0,0
glues-characterselect-icon-notify-lock-hover-2x,27144,2727,80,80,1481,1561,1209,1289,27176,0,0,0,0
glues-characterselect-icon-notify-mail-2x,27145,2727,80,80,1563,1643,1209,1289,27177,0,0,0,0
glues-characterselect-icon-notify-mail-hover-2x,27146,2727,80,80,1645,1725,1209,1289,27178,0,0,0,0
glues-characterselect-icon-restorecharacter-2x,27147,2727,116,116,381,497,1763,1879,27179,0,0,0,0
glues-characterselect-icon-restorecharacter-hover-2x,27148,2727,116,116,381,497,1881,1997,27180,0,0,0,0
glues-characterselect-icon-restorecharacter-pointer-2x,27149,2727,68,172,1979,2047,253,425,27181,0,0,0,0
glues-characterselect-icon-notify-bg-hover,27150,2726,40,40,818,858,639,679,27172,0,0,0,0
glues-characterselect-icon-notify-bg,27151,2726,40,40,776,816,639,679,27171,0,0,0,0
glues-characterselect-icon-notify-inprogress-hover,27152,2726,40,40,902,942,639,679,27174,0,0,0,0
glues-characterselect-icon-notify-inprogress,27153,2726,40,40,860,900,639,679,27173,0,0,0,0
glues-characterselect-icon-notify-lock-hover,27154,2726,40,40,228,268,931,971,27176,0,0,0,0
glues-characterselect-icon-notify-lock,27155,2726,40,40,944,984,639,679,27175,0,0,0,0
glues-characterselect-icon-notify-mail-hover,27156,2726,40,40,272,312,808,848,27178,0,0,0,0
glues-characterselect-icon-notify-mail,27157,2726,40,40,228,268,973,1013,27177,0,0,0,0
glues-characterselect-icon-restorecharacter-hover,27158,2726,58,58,876,934,576,634,27180,0,0,0,0
glues-characterselect-icon-restorecharacter-pointer,27159,2726,34,86,192,226,931,1017,27181,0,0,0,0
glues-characterselect-icon-restorecharacter,27160,2726,58,58,816,874,576,634,27179,0,0,0,0
shop-card-full-fp27,27161,2838,568,463,1,569,1,464,27182,0,0,0,0
shop-card-full-ap27,27162,2839,568,463,1,569,1,464,27183,0,0,0,0
poi-hub,27163,647,64,64,401,465,131,195,27184,32,32,0,0
ui-frame-thewarwithin-backgroundtile,27164,2840,256,256,0,256,0,256,27185,0,0,6,0
timerunning-tophud-button-glow,27166,2796,456,71,1,457,861,932,27187,0,0,0,0
timerunning-tophud-fx-glow,27167,2796,498,499,1,499,1,500,27188,0,0,0,0
timerunning-tophud-fx-mask,27168,2841,512,512,0,512,0,512,27189,0,0,16,0
ui-frame-thewarwithin-border,27169,2837,588,588,1,589,88,676,27190,0,0,0,0
delves-scenario-frame,27173,2842,264,84,1,265,1,85,27576,0,0,0,0
delves-affix-mask,27182,2844,49,49,64,113,1,50,27200,0,0,0,0
arrow-long,27184,2845,38,18,1,39,423,441,27202,0,0,0,0
arrow-short,27185,2845,21,18,41,62,423,441,27203,0,0,0,0
transfer-log-background,27186,2845,300,284,453,753,221,505,27204,0,0,0,0
transfer-panel-background,27187,2845,426,218,453,879,1,219,27205,0,0,0,0
transfer-log-button-down,27188,2845,27,25,1,28,443,468,27206,0,0,0,0
transfer-log-button-up,27189,2845,27,25,1,28,470,495,27207,0,0,0,0
character-panel-background,27190,2845,450,420,1,451,1,421,27208,0,0,0,0
talents-heroclass-deathknight-rideroftheapocalypse,27204,2777,200,200,1,201,203,403,27222,0,0,0,0
talents-heroclass-evoker-flameshaper,27205,2777,200,200,405,605,1,201,27223,0,0,0,0
taxinode_continent_alliance_timed,27206,647,64,64,863,927,131,195,27224,28,28,0,0
taxinode_continent_horde_timed,27207,647,64,64,137,201,197,261,27225,28,28,0,0
taxinode_continent_neutral_timed,27208,647,64,64,137,201,329,393,27226,28,28,0,0
chromietime-portrait-small-dragonflight,27210,1565,312,173,1032,1344,769,942,27228,0,0,0,0
chromietime-portrait-large-dragonflight,27211,1565,490,254,404,894,1,255,27229,0,0,0,0
completiondialog-warwithincampaign-worldquests-icon,27212,2778,59,59,910,969,1,60,26691,0,0,0,0
echoes-icon,27213,647,56,56,203,259,263,319,27404,40,40,0,0
vignettekill-pressed-supertracked,27215,647,64,64,269,333,197,261,27232,32,32,0,0
vignettekill-pressed,27216,647,64,64,203,267,197,261,27233,32,32,0,0
vignettekill-supertracked,27217,647,64,64,335,399,197,261,27234,32,32,0,0
vignettekillelite-pressed-supertracked,27218,647,64,64,797,861,197,261,27235,32,32,0,0
vignettekillelite-pressed,27219,647,64,64,731,795,197,261,27236,32,32,0,0
vignettekillelite-supertracked,27220,647,64,64,863,927,197,261,27237,32,32,0,0
spellbook-corner-flipbook-evergreen,27221,2696,600,310,1,601,1,311,27042,0,0,0,0
spellbook-item-backplate,27222,2696,256,64,319,575,313,377,27043,0,0,0,0
spellbook-item-iconframe-hover,27223,2696,132,125,1,133,550,675,27044,0,0,0,0
spellbook-item-iconframe-inactive,27224,2696,136,127,1,137,421,548,27045,0,0,0,0
spellbook-item-iconframe-passive-inactive,27225,2696,112,112,139,251,421,533,27046,0,0,0,0
spellbook-item-iconframe,27226,2696,138,131,875,1013,1,132,27047,0,0,0,0
spellbook-item-unassigned-glow,27227,2696,127,127,1,128,677,804,27048,0,0,0,0
spellbook-item-iconframe-sheen-mask,27228,2817,128,128,0,128,0,128,27049,0,0,16,0
worldquest-icon,27230,743,32,32,334,366,400,432,27239,16,16,0,0
worldquest-questmarker-epic-down-supertracked,27231,743,64,64,334,398,296,360,27240,32,32,0,0
worldquest-questmarker-epic-supertracked,27232,743,64,64,400,464,296,360,27241,32,32,0,0
questbonusobjective-pressed-supertracked,27243,647,64,64,599,663,131,195,27243,32,32,0,0
questbonusobjective-pressed,27244,647,64,64,533,597,131,195,27244,32,32,0,0
questbonusobjective-supertracked,27245,647,64,64,665,729,131,195,27245,32,32,0,0
tokens-changefaction-regular,27246,2847,56,56,1,57,139,195,27246,0,0,0,0
tokens-changefaction-small,27247,2847,49,49,132,181,175,224,27247,0,0,0,0
tokens-changename-regular,27248,2847,56,56,1,57,197,253,27248,0,0,0,0
tokens-changename-small,27249,2847,49,49,190,239,1,50,27249,0,0,0,0
tokens-changerace-regular,27250,2847,56,56,74,130,1,57,27250,0,0,0,0
tokens-changerace-small,27251,2847,49,49,190,239,52,101,27251,0,0,0,0
tokens-charactertransfer-small,27252,2847,49,49,190,239,103,152,27252,0,0,0,0
tokens-counterbg,27253,2847,30,30,241,271,154,184,27253,0,0,0,0
tokens-frame-regular,27254,2847,71,71,1,72,1,72,27254,0,0,0,0
tokens-frame-small,27255,2847,63,63,1,64,74,137,27255,0,0,0,0
tokens-guildchangefaction-regular,27256,2847,56,56,74,130,59,115,27256,0,0,0,0
tokens-guildchangefaction-small,27257,2847,49,49,190,239,154,203,27257,0,0,0,0
tokens-guildchangename-regular,27258,2847,56,56,74,130,117,173,27258,0,0,0,0
tokens-guildchangename-small,27259,2847,49,49,190,239,205,254,27259,0,0,0,0
tokens-guildrealmtransfer-regular,27260,2847,56,56,74,130,175,231,27260,0,0,0,0
tokens-guildrealmtransfer-small,27261,2847,49,49,241,290,1,50,27261,0,0,0,0
tokens-wow-dragonflight-regular,27262,2847,56,56,132,188,1,57,27262,0,0,0,0
tokens-wow-dragonflight-small,27263,2847,49,49,241,290,52,101,27263,0,0,0,0
tokens-wow-generic-regular,27264,2847,56,56,132,188,59,115,27264,0,0,0,0
tokens-wow-generic-small,27265,2847,49,49,241,290,103,152,27265,0,0,0,0
tokens-charactertransfer-regular,27286,2847,56,56,132,188,117,173,27274,0,0,0,0
tokens-changefaction-small-2x,27287,2848,98,98,259,357,343,441,27247,0,0,0,0
tokens-changename-regular-2x,27288,2848,112,112,1,113,273,385,27248,0,0,0,0
tokens-changename-small-2x,27289,2848,98,98,373,471,1,99,27249,0,0,0,0
tokens-changerace-regular-2x,27290,2848,112,112,1,113,387,499,27250,0,0,0,0
tokens-changerace-small-2x,27291,2848,98,98,373,471,101,199,27251,0,0,0,0
tokens-charactertransfer-regular-2x,27292,2848,112,112,145,257,1,113,27274,0,0,0,0
tokens-charactertransfer-small-2x,27293,2848,98,98,373,471,201,299,27252,0,0,0,0
tokens-counterbg-2x,27294,2848,60,60,259,319,443,503,27253,0,0,0,0
tokens-frame-regular-2x,27295,2848,142,142,1,143,1,143,27254,0,0,0,0
tokens-frame-small-2x,27296,2848,126,126,1,127,145,271,27255,0,0,0,0
tokens-guildchangefaction-regular-2x,27297,2848,112,112,145,257,115,227,27256,0,0,0,0
tokens-guildchangefaction-small-2x,27298,2848,98,98,373,471,301,399,27257,0,0,0,0
tokens-guildchangename-regular-2x,27299,2848,112,112,145,257,229,341,27258,0,0,0,0
tokens-guildchangename-small-2x,27300,2848,98,98,373,471,401,499,27259,0,0,0,0
tokens-guildrealmtransfer-regular-2x,27301,2848,112,112,145,257,343,455,27260,0,0,0,0
tokens-guildrealmtransfer-small-2x,27302,2848,98,98,473,571,1,99,27261,0,0,0,0
tokens-wow-dragonflight-regular-2x,27303,2848,112,112,259,371,1,113,27262,0,0,0,0
tokens-wow-dragonflight-small-2x,27304,2848,98,98,473,571,101,199,27263,0,0,0,0
tokens-wow-generic-regular-2x,27305,2848,112,112,259,371,115,227,27264,0,0,0,0
tokens-wow-generic-small-2x,27306,2848,98,98,473,571,201,299,27265,0,0,0,0
vas-bg-divider,27308,2849,60,14,954,1014,1,15,27275,0,0,0,0
vas-bg-frame,27309,2849,60,60,243,303,149,209,27276,0,0,0,0
vas-bg-header,27310,2849,350,97,243,593,1,98,27277,0,0,0,0
vas-bg,27311,2849,60,60,142,202,398,458,27278,0,0,0,0
vas-charlist-line,27313,2849,44,93,188,232,303,396,27280,0,0,0,0
vas-icon-checkmark,27314,2849,61,55,305,366,149,204,27281,0,0,0,0
vas-number-1,27315,2849,36,36,204,240,398,434,27282,0,0,0,0
vas-number-2,27316,2849,36,36,142,178,460,496,27283,0,0,0,0
vas-number-3,27317,2849,36,36,180,216,460,496,27284,0,0,0,0
vas-number-4,27318,2849,36,36,878,914,1,37,27285,0,0,0,0
vas-number-5,27319,2849,36,36,916,952,1,37,27286,0,0,0,0
vas-selection-active,27320,2849,281,47,595,876,1,48,27287,0,0,0,0
vas-selection-hover,27321,2849,281,47,243,524,100,147,27288,0,0,0,0
vas-bg-2x,27322,2850,120,120,483,603,293,413,27278,0,0,0,0
vas-bg-divider-2x,27323,2850,112,29,369,481,973,1002,27275,0,0,0,0
vas-bg-frame-2x,27324,2850,120,120,483,603,415,535,27276,0,0,0,0
vas-bg-header-2x,27325,2850,700,194,483,1183,1,195,27277,0,0,0,0
vas-charlist-line-2x,27327,2850,88,186,279,367,791,977,27280,0,0,0,0
vas-icon-checkmark-2x,27328,2850,122,110,605,727,293,403,27281,0,0,0,0
vas-number-1-2x,27329,2850,72,72,369,441,603,675,27282,0,0,0,0
vas-number-2-2x,27330,2850,72,72,369,441,677,749,27283,0,0,0,0
vas-number-3-2x,27331,2850,72,72,369,441,751,823,27284,0,0,0,0
vas-number-4-2x,27332,2850,72,72,369,441,825,897,27285,0,0,0,0
vas-number-5-2x,27333,2850,72,72,369,441,899,971,27286,0,0,0,0
vas-selection-active-2x,27334,2850,561,94,1185,1746,1,95,27287,0,0,0,0
vas-selection-hover-2x,27335,2850,561,94,483,1044,197,291,27288,0,0,0,0
delve-entrance-background-earthcrawl-mines,27348,2846,584,384,1,585,1,385,27210,0,0,0,0
delve-entrance-background-fungal-folly,27349,2846,584,384,587,1171,1,385,27211,0,0,0,0
delve-entrance-background-kriegvals-rest,27350,2846,584,384,1173,1757,1,385,27212,0,0,0,0
delve-entrance-background-mycomancer-cavern,27351,2846,584,384,1,585,387,771,27213,0,0,0,0
delve-entrance-background-nightfall-sanctum,27352,2846,584,384,587,1171,387,771,27214,0,0,0,0
delve-entrance-background-skittering-breach,27353,2846,584,384,1173,1757,387,771,27242,0,0,0,0
delve-entrance-background-tak-rethan-abyss,27354,2846,584,384,1,585,773,1157,27215,0,0,0,0
delve-entrance-background-the-dread-pit,27355,2846,584,384,1,585,1159,1543,27216,0,0,0,0
delve-entrance-background-the-sinkhole,27356,2846,584,384,1,585,1545,1929,27217,0,0,0,0
delve-entrance-background-the-spiral-weave,27357,2846,584,384,587,1171,773,1157,27218,0,0,0,0
delve-entrance-background-the-waterworks,27358,2846,584,384,1173,1757,773,1157,27219,0,0,0,0
delve-entrance-background-zekvirs-lair,27359,2846,584,384,587,1171,1159,1543,27221,0,0,0,0
worldquest-capstone-banner,27362,743,64,64,281,345,223,287,27302,32,32,0,0
worldquest-capstone-questmarker-epic-down-supertrack,27363,743,64,64,1,65,394,458,27303,32,32,0,0
worldquest-capstone-questmarker-epic-down,27364,743,64,64,413,477,223,287,27304,32,32,0,0
worldquest-capstone-questmarker-epic-locked,27365,743,64,64,99,163,384,448,27305,32,32,0,0
worldquest-capstone-questmarker-epic-supertrack,27366,743,64,64,202,266,296,360,27306,32,32,0,0
worldquest-capstone-questmarker-epic,27367,743,64,64,347,411,223,287,27307,32,32,0,0
worldquest-capstone,27368,743,32,32,165,197,384,416,27308,16,16,0,0
delves-dashboard-background,27390,2852,551,401,1,552,1,402,27299,0,0,0,0
delves-dashboard-bar-background-glow,27391,2852,475,35,455,930,404,439,27310,0,0,0,0
delves-dashboard-bar-background,27392,2852,471,32,455,926,441,473,27289,0,0,0,0
delves-dashboard-bar-border-glow,27393,2852,471,32,218,689,524,556,27311,0,0,0,0
delves-dashboard-bar-border,27394,2852,471,32,455,926,475,507,27290,0,0,0,0
delves-dashboard-bar-diamond-complete-glow,27395,2852,40,40,629,669,361,401,27312,0,0,0,0
delves-dashboard-bar-diamond-complete,27396,2852,40,40,554,594,361,401,27313,0,0,0,0
delves-dashboard-bar-diamond-incomplete,27397,2852,40,40,704,744,286,326,27314,0,0,0,0
delves-dashboard-bar-divider-complete,27398,2852,2,20,609,611,376,396,27293,0,0,0,0
delves-dashboard-bar-divider-incomplete,27399,2852,2,20,613,615,376,396,27294,0,0,0,0
delves-dashboard-bar-end,27400,2852,11,31,596,607,361,392,27295,0,0,0,0
delves-dashboard-bar-fill-glow,27401,2852,471,32,218,689,592,624,27315,0,0,0,0
delves-dashboard-bar-fill,27402,2852,471,32,218,689,558,590,27296,0,0,0,0
delves-dashboard-bar-reward-border-disabled,27403,2852,73,73,629,702,286,359,27316,0,0,0,0
delves-dashboard-bar-reward-border,27404,2852,73,73,554,627,286,359,27317,0,0,0,0
delves-dashboard-card-companion,27405,2852,215,283,771,986,1,284,27300,0,0,0,0
delves-dashboard-card-disabled,27406,2852,215,283,1,216,404,687,27301,0,0,0,0
delves-dashboard-card,27407,2852,215,283,554,769,1,284,27298,0,0,0,0
delves-dashboard-checkmark,27408,2852,15,13,609,624,361,374,27318,0,0,0,0
delves-dashboard-checkmark_flipbook,27409,2852,235,118,218,453,404,522,27319,0,0,0,0
minimap-genericevent-hornicon-pressed-supertracked,27410,647,64,64,137,201,131,195,27320,40,40,0,0
minimap-genericevent-hornicon-pressed,27411,647,64,64,71,135,923,987,27321,40,40,0,0
minimap-genericevent-hornicon-supertracked,27412,647,64,64,203,267,131,195,27322,40,40,0,0
progress-bar-diamond-pip-mask,27413,2853,36,36,1,37,1,37,27323,0,0,0,0
spellbook-item-spellicon-mask,27414,2854,64,64,0,64,0,64,27324,0,0,16,0
spellbook-item-iconframe-passive-hover,27415,2696,108,108,139,247,535,643,27325,0,0,0,0
shop-card-full-murloc-romper-green,27416,2855,568,463,1,569,1,464,27326,0,0,0,0
groupfinder-background-delves,27417,236,333,96,331,664,99,195,27327,0,0,0,0
groupfinder-button-delves,27418,236,290,36,1,291,703,739,27328,0,0,0,0
shop-card-full-mrlgrl-pack,27419,2856,568,463,1,569,1,464,27329,0,0,0,0
shop-card-full-gametimebundle-90day,27425,2862,568,463,1,569,1,464,27335,0,0,0,0
ui-hud-minimap-guildbanner-delves-large,27432,2239,16,17,77,93,1,18,27342,0,0,0,0
ui-hud-minimap-guildbanner-delves-mini,27433,2239,11,12,113,124,1,13,27343,0,0,0,0
ui-hud-minimap-guildbanner-delves-large-2x,27434,2240,35,35,147,182,1,36,27342,0,0,0,0
glues-characterselect-button-collapseexpand-disabled,27435,2726,34,34,983,1017,409,443,27345,0,0,0,0
glues-characterselect-icon-minus-disabled,27436,2726,31,31,317,348,725,756,27346,0,0,0,0
glues-characterselect-icon-plus-disabled,27437,2726,31,31,317,348,857,888,27347,0,0,0,0
glues-characterselect-button-collapseexpand-disabled-2x,27438,2727,68,68,1973,2041,621,689,27345,0,0,0,0
glues-characterselect-icon-minus-disabled-2x,27439,2727,62,62,725,787,1487,1549,27346,0,0,0,0
glues-characterselect-icon-plus-disabled-2x,27440,2727,62,62,725,787,1743,1805,27347,0,0,0,0
photosensitivitywarning-questbang-icon,27442,2872,64,72,1,65,147,219,27349,0,0,0,0
photosensitivitywarning-vignette,27443,2872,256,144,1,257,1,145,27350,0,0,0,0
128-redbutton-minus-disabled,27444,871,128,128,131,259,1301,1429,27352,0,0,0,0
128-redbutton-minus-highlight,27445,871,128,128,261,389,1301,1429,27353,0,0,0,0
128-redbutton-minus-pressed,27446,871,128,128,1,129,1431,1559,27354,0,0,0,0
128-redbutton-minus,27447,871,128,128,1,129,1301,1429,27355,0,0,0,0
128-redbutton-plus-disabled,27448,871,128,128,261,389,1431,1559,27356,0,0,0,0
128-redbutton-plus-highlight,27449,871,128,128,1,129,1561,1689,27357,0,0,0,0
128-redbutton-plus-pressed,27450,871,128,128,1,129,1691,1819,27358,0,0,0,0
128-redbutton-plus,27451,871,128,128,131,259,1431,1559,27359,0,0,0,0
groupfinder-background-raids-war-within,27452,236,333,96,1336,1669,295,391,27360,0,0,0,0
groupfinder-button-raids-war-within,27453,236,290,36,1207,1497,393,429,27361,0,0,0,0
alliedrace-unlockingframe-modelbackground-earthen,27454,942,314,578,1581,1895,1,579,27362,0,0,0,0
alliedrace-crest-earthen,27455,923,64,64,199,263,67,131,27363,0,0,0,0
transmog-background-race-earthen,27456,2873,294,494,1,295,1,495,27364,0,0,0,0
delves-affix-ring,27457,2844,61,61,1,62,1,62,27201,0,0,0,0
quest-in-progress-icon-brown,27458,2669,32,32,1,33,1,33,25923,0,0,0,0
quest-in-progress-icon-yellow,27459,2669,32,32,35,67,1,33,25924,0,0,0,0
nerubian-extrabutton,27460,2874,256,128,1,257,1,129,27366,0,0,0,0
talents-animations-mask-heroclass-backplatefull,27461,2875,256,512,0,256,0,512,27367,0,0,16,0
talents-animations-mask-heroclass-ring,27462,2813,128,128,0,128,0,128,27368,0,0,16,0
photosensitivitywarning-parchment-background,27463,2876,512,512,0,512,0,512,27348,0,0,6,0
vas-charlist-arrow-line-beam-2x,27464,2850,88,186,1,89,791,977,27369,0,0,0,0
vas-charlist-arrow-line-glow-2x,27465,2850,88,186,91,179,791,977,27370,0,0,0,0
vas-charlist-arrow-line-glow2-2x,27466,2850,88,186,189,277,603,789,27371,0,0,0,0
vas-charlist-arrow-line-shine-2x,27467,2850,88,186,189,277,791,977,27372,0,0,0,0
vas-charlist-arrow-line-solo-2x,27468,2850,88,186,279,367,603,789,27373,0,0,0,0
vas-flipbook-arrow-2x,27469,2850,480,600,1,481,1,601,27374,0,0,0,0
vas-charlist-arrow-line-beam,27470,2849,44,93,1,45,398,491,27369,0,0,0,0
vas-charlist-arrow-line-glow,27471,2849,44,93,47,91,398,491,27370,0,0,0,0
vas-charlist-arrow-line-glow2,27472,2849,44,93,96,140,303,396,27371,0,0,0,0
vas-charlist-arrow-line-shine,27473,2849,44,93,96,140,398,491,27372,0,0,0,0
vas-charlist-arrow-line-solo,27474,2849,44,93,142,186,303,396,27373,0,0,0,0
vas-flipbook-arrow,27475,2849,240,300,1,241,1,301,27374,0,0,0,0
talents-sheen-heroclassicon,27476,1970,171,75,1615,1786,1,76,27375,0,0,0,0
talents-sheen-node,27477,1970,87,138,887,974,705,843,27376,0,0,0,0
vas-icon-checkmark-glw,27478,2849,61,55,305,366,206,261,27377,0,0,0,0
vas-number-bg-glw,27479,2849,93,93,1,94,303,396,27378,0,0,0,0
vas-selection-glw,27480,2849,281,47,595,876,50,97,27379,0,0,0,0
vas-tickradial-glw,27481,2849,28,28,954,982,17,45,27380,0,0,0,0
vas-icon-checkmark-glw-2x,27482,2850,122,110,605,727,405,515,27377,0,0,0,0
vas-number-bg-glw-2x,27483,2850,186,186,1,187,603,789,27378,0,0,0,0
vas-selection-glw-2x,27484,2850,561,94,1185,1746,97,191,27379,0,0,0,0
vas-tickradial-glw-2x,27485,2850,56,56,1748,1804,1,57,27380,0,0,0,0
gearupdate-arrow-bullet-point-2x,27504,2878,74,76,725,799,173,249,27381,0,0,0,0
gearupdate-bg-2x,27505,2878,722,1192,1,723,1,1193,27382,0,0,0,0
gearupdate-frame-active-2x,27506,2878,84,84,909,993,1,85,27383,0,0,0,0
gearupdate-frame-done-2x,27507,2878,84,84,909,993,87,171,27384,0,0,0,0
gearupdate-glow-filigree-2x,27508,2878,702,258,1,703,1195,1453,27385,0,0,0,0
gearupdate-header-bg-2x,27509,2878,568,80,1,569,1633,1713,27386,0,0,0,0
gearupdate-line-item-bg-2x,27510,2878,574,74,1,575,1715,1789,27387,0,0,0,0
gearupdate-main-icon-2x,27511,2878,182,170,725,907,1,171,27388,0,0,0,0
gearupdate-minimized-bg-2x,27512,2878,724,176,1,725,1455,1631,27389,0,0,0,0
gearupdate-arrow-bullet-point ,27513,2877,37,38,457,494,45,83,27390,0,0,0,0
gearupdate-bg,27514,2877,361,596,1,362,1,597,27382,0,0,0,0
gearupdate-frame-active,27515,2877,42,42,457,499,1,43,27383,0,0,0,0
gearupdate-frame-done,27516,2877,42,42,364,406,88,130,27384,0,0,0,0
gearupdate-glow-filigree,27517,2877,351,129,1,352,599,728,27385,0,0,0,0
gearupdate-header-bg,27518,2877,284,40,1,285,820,860,27386,0,0,0,0
gearupdate-line-item-bg,27519,2877,287,37,1,288,862,899,27387,0,0,0,0
gearupdate-main-icon,27520,2877,91,85,364,455,1,86,27388,0,0,0,0
gearupdate-minimized-bg,27521,2877,362,88,1,363,730,818,27389,0,0,0,0
echoes-icon-active,27522,2879,56,56,1,57,1,57,27230,0,0,0,0
echoes-icon-inactive,27523,2879,56,56,59,115,1,57,27231,0,0,0,0
glues-characterselect-tophud-bg-divider-dis,27524,2726,2,44,1021,1023,252,296,27391,0,0,0,0
glues-characterselect-tophud-left-bg,27525,2726,212,51,388,600,576,627,27392,0,0,0,0
glues-characterselect-tophud-left-dis-bg,27526,2726,212,51,602,814,576,627,27393,0,0,0,0
glues-characterselect-tophud-middle-bg,27527,2726,30,51,993,1023,128,179,27394,0,0,0,0
glues-characterselect-tophud-middle-dis-bg,27528,2726,30,51,992,1022,576,627,27395,0,0,0,0
glues-characterselect-tophud-right-bg,27529,2726,212,51,192,404,639,690,27396,0,0,0,0
glues-characterselect-tophud-right-dis-bg,27530,2726,212,51,406,618,639,690,27397,0,0,0,0
glues-characterselect-tophud-bg-divider-dis-2x,27531,2727,4,88,2039,2043,91,179,27391,0,0,0,0
glues-characterselect-tophud-left-bg-2x,27532,2727,424,102,771,1195,1063,1165,27392,0,0,0,0
glues-characterselect-tophud-left-dis-bg-2x,27533,2727,424,102,1197,1621,1063,1165,27393,0,0,0,0
glues-characterselect-tophud-middle-bg-2x,27534,2727,60,102,315,375,1887,1989,27394,0,0,0,0
glues-characterselect-tophud-middle-dis-bg-2x,27535,2727,60,102,499,559,1911,2013,27395,0,0,0,0
glues-characterselect-tophud-right-bg-2x,27536,2727,424,102,1623,2047,1063,1165,27396,0,0,0,0
glues-characterselect-tophud-right-dis-bg-2x,27537,2727,424,102,381,805,1187,1289,27397,0,0,0,0
ui-questpoiimportant-questbang-minimap-turnin-2x,27538,2562,64,72,131,195,75,147,27398,0,0,0,0
ui-questpoiimportant-questbang-minimap-turnin,27539,2484,32,36,67,99,39,75,27398,0,0,0,0
ui-questpoilegendary-questbang-minimap-turnin-2x,27540,2660,64,64,131,195,67,131,27399,0,0,0,0
ui-questpoilegendary-questbang-minimap-turnin,27541,2423,32,32,67,99,35,67,27399,0,0,0,0
ui-questpoirecurring-questbang-minimap-turnin-2x,27542,2628,64,64,131,195,67,131,27400,0,0,0,0
ui-questpoirecurring-questbang-minimap-turnin,27543,2627,32,32,67,99,35,67,27400,0,0,0,0
ui-questpoiwrapper-questbang-minimap-turnin-2x,27544,2630,64,64,131,195,67,131,27401,0,0,0,0
ui-questpoiwrapper-questbang-minimap-turnin,27545,2629,32,32,67,99,35,67,27401,0,0,0,0
talents-node-choice-newglow,27546,1970,176,168,279,455,547,715,27402,0,0,0,0
auctionhouse-icon-buyallarrow,27547,1495,30,30,973,1003,259,289,27403,15,15,0,0
evergreen-scenario-barfill,27548,2771,231,9,0,231,1,10,27405,0,0,4,0
evergreen-scenario-frame,27549,2771,253,80,1,254,265,345,27406,0,0,0,0
evergreen-scenario-titlebg,27550,2771,350,165,1,351,12,177,27407,0,0,0,0
evergreen-scenario-barfill-2x,27551,2772,462,18,0,462,1,19,27405,0,0,4,0
evergreen-scenario-frame-2x,27552,2772,505,160,1,506,523,683,27406,0,0,0,0
evergreen-scenario-titlebg-2x,27553,2772,700,330,1,701,21,351,27407,0,0,0,0
talents-heroclass-choicepopup-background,27554,2779,962,809,1,963,1,810,27408,0,0,0,0
vignettekillboss-pressed-supertracked,27555,647,64,64,533,597,197,261,27409,32,32,0,0
vignettekillboss-pressed,27556,647,64,64,467,531,197,261,27410,32,32,0,0
vignettekillboss-supertracked,27557,647,64,64,599,663,197,261,27411,32,32,0,0
vignettekillboss,27558,647,64,64,401,465,197,261,27412,32,32,0,0
vas-inputbox-2x,27559,2850,50,50,1806,1856,1,51,27413,0,0,0,0
vas-inputbox,27562,2849,25,25,984,1009,17,42,27413,0,0,0,0
delves-curios-icon-border,27564,2880,64,64,1,65,1,65,27417,0,0,0,0
spellbook-item-needtrainer-iconframe-backplate,27565,2696,137,131,875,1012,134,265,27418,0,0,0,0
spellbook-item-needtrainer-passive-backplate,27566,2696,113,115,1,114,806,921,27419,0,0,0,0
spellbook-item-needtrainer-shadow,27567,2696,270,270,603,873,1,271,27420,0,0,0,0
spellbook-item-petautocast-corners,27568,2696,90,90,577,667,313,403,27421,0,0,0,0
spellbook-item-petautocast-mask,27569,2881,64,64,0,64,0,64,27422,0,0,16,0
perks-theme-hallowsend-tl-box,27570,2882,220,290,1,221,337,627,27423,0,0,0,0
perks-theme-hallowsend-tl-top,27571,2882,801,161,1,802,1,162,27424,0,0,0,0
perks-theme-hallowsend-tp-bottombig,27572,2882,527,171,1,528,164,335,27425,0,0,0,0
perks-theme-hallowsend-tp-bottomsmall,27573,2882,360,76,223,583,447,523,27426,0,0,0,0
perks-theme-hallowsend-tp-topbig,27574,2882,527,108,223,750,337,445,27427,0,0,0,0
perks-theme-hallowsend-tp-topsmall,27575,2882,360,133,530,890,164,297,27428,0,0,0,0
talents-heroclass-mage-spellslinger,27576,2777,200,200,607,807,203,403,27429,0,0,0,0
talents-heroclass-priest-archon,27577,2777,200,200,809,1009,607,807,27430,0,0,0,0
generic-majorfactions-emissary-empty,27590,2262,128,128,131,259,1,129,27431,0,0,0,0
talents-heroclass-rogue-deathstalker,27591,2777,200,200,1011,1211,203,403,27432,0,0,0,0
talents-heroclass-rogue-fatebound,27592,2777,200,200,1011,1211,405,605,27433,0,0,0,0
thewarwithin-majorfactions-storm-background,27594,2883,820,578,1,821,1,579,27434,0,0,0,0
ui-storm-headerfill,27595,2884,182,220,803,985,1,221,27435,0,0,0,0
ui-storm-headerorb-level0,27596,2884,182,220,771,953,567,787,27436,0,0,0,0
ui-storm-headerorb,27597,2884,182,220,693,875,265,485,27437,0,0,0,0
ui-storm-highlight-bottom,27598,2884,768,263,1,769,567,830,27438,0,0,0,0
ui-storm-highlight-middle,27599,2884,800,262,1,801,1,263,27439,0,0,0,0
ui-storm-highlight-top,27600,2884,690,300,1,691,265,565,27440,0,0,0,0
ui-storm-reward-slate,27601,2884,470,140,1,471,832,972,27441,0,0,0,0
ui-storm-rewardframe,27602,2884,128,128,877,1005,265,393,27442,0,0,0,0
ui-frame-thewarwithin-embellishmentbottom,27603,2837,186,29,284,470,1150,1179,27443,0,0,0,0
ui-frame-thewarwithin-embellishmentleft,27604,2837,91,52,847,938,88,140,27444,0,0,0,0
ui-frame-thewarwithin-embellishmentright,27605,2837,91,52,847,938,142,194,27445,0,0,0,0
majorfactions_icons_candle512,27606,2885,512,512,1,513,1,513,27446,0,0,0,0
majorfactions_icons_flame512,27607,2885,512,512,515,1027,1,513,27447,0,0,0,0
majorfactions_icons_storm512,27608,2885,512,512,1029,1541,1,513,27448,0,0,0,0
majorfactions_icons_web512,27609,2885,512,512,1,513,515,1027,27449,0,0,0,0
glues-characterselect-listrealm-bg-2x,27610,2727,562,46,1345,1907,445,491,27457,0,0,0,0
majorfaction-celebration-thewarwithin-bottomglowline,27611,2886,255,38,131,386,274,312,27451,0,0,0,0
majorfaction-celebration-thewarwithin-candle,27612,2886,242,95,1,243,1,96,27580,0,0,0,0
majorfaction-celebration-thewarwithin-content-ring,27613,2886,128,128,1,129,274,402,27453,0,0,0,0
majorfaction-celebration-thewarwithin-flame,27614,2886,242,95,245,487,1,96,27581,0,0,0,0
majorfaction-celebration-thewarwithin-storm,27615,2886,242,95,1,243,98,193,27582,0,0,0,0
majorfaction-celebration-thewarwithin-web,27616,2886,242,95,245,487,98,193,27583,0,0,0,0
majorfaction-celebration-toastbg,27617,2886,275,77,1,276,195,272,21132,0,0,0,0
glues-characterselect-listrealm-bg,27618,2726,281,23,675,956,225,248,27457,0,0,0,0
delve-entrance-background-the-underkeep,27619,2846,584,384,587,1171,1545,1929,27365,0,0,0,0
ui_bg_npcreward,27620,1933,62,62,340,402,841,903,27458,0,0,0,0
ui-candle-headerfill,27621,2887,182,220,803,985,1,221,27459,0,0,0,0
ui-candle-headerorb-level0,27622,2887,182,220,771,953,567,787,27460,0,0,0,0
ui-candle-headerorb,27623,2887,182,220,693,875,265,485,27461,0,0,0,0
ui-candle-highlight-bottom,27624,2887,768,263,1,769,567,830,27462,0,0,0,0
ui-candle-highlight-middle,27625,2887,800,262,1,801,1,263,27463,0,0,0,0
ui-candle-highlight-top,27626,2887,690,300,1,691,265,565,27464,0,0,0,0
ui-candle-reward-slate,27627,2887,470,140,1,471,832,972,27465,0,0,0,0
ui-candle-rewardframe,27628,2887,128,128,877,1005,265,393,27466,0,0,0,0
thewarwithin-majorfactions-candle-background,27629,2888,820,578,1,821,1,579,27467,0,0,0,0
thewarwithin-majorfactions-flame-background,27630,2889,820,578,1,821,1,579,27468,0,0,0,0
ui-flame-headerfill,27631,2890,182,220,803,985,1,221,27469,0,0,0,0
ui-flame-headerorb-level0,27632,2890,182,220,771,953,567,787,27470,0,0,0,0
ui-flame-headerorb,27633,2890,182,220,693,875,265,485,27471,0,0,0,0
ui-flame-highlight-bottom,27634,2890,768,263,1,769,567,830,27472,0,0,0,0
ui-flame-highlight-middle,27635,2890,800,262,1,801,1,263,27473,0,0,0,0
ui-flame-highlight-top,27636,2890,690,300,1,691,265,565,27474,0,0,0,0
ui-flame-reward-slate,27637,2890,470,140,1,471,832,972,27475,0,0,0,0
ui-flame-rewardframe,27638,2890,128,128,877,1005,265,393,27476,0,0,0,0
thewarwithin-majorfactions-web-background,27639,2891,820,578,1,821,1,579,27477,0,0,0,0
ui-web-headerfill,27640,2892,182,220,803,985,1,221,27478,0,0,0,0
ui-web-headerorb-level0,27641,2892,182,220,771,953,567,787,27479,0,0,0,0
ui-web-headerorb,27642,2892,182,220,693,875,265,485,27480,0,0,0,0
ui-web-highlight-bottom,27643,2892,768,263,1,769,567,830,27481,0,0,0,0
ui-web-highlight-middle,27644,2892,800,262,1,801,1,263,27482,0,0,0,0
ui-web-highlight-top,27645,2892,690,300,1,691,265,565,27483,0,0,0,0
ui-web-reward-slate,27646,2892,470,140,1,471,832,972,27484,0,0,0,0
ui-web-rewardframe,27647,2892,128,128,877,1005,265,393,27485,0,0,0,0
worldquest-capstone-questmarker-epic-toast,27650,743,64,64,202,266,362,426,27488,0,0,0,0
thewarwithin-landingpage-header-horizontal-rule,27651,2893,636,27,1,637,487,514,27489,0,0,0,0
thewarwithin-landingpage-radial-candle,27652,2893,96,96,511,607,325,421,27490,0,0,0,0
thewarwithin-landingpage-radial-flame,27653,2893,96,96,609,705,325,421,27491,0,0,0,0
thewarwithin-landingpage-radial-frame,27654,2893,96,96,707,803,325,421,27492,0,0,0,0
thewarwithin-landingpage-radial-storm,27655,2893,96,96,805,901,325,421,27493,0,0,0,0
thewarwithin-landingpage-radial-web,27656,2893,96,96,903,999,325,421,27494,0,0,0,0
thewarwithin-landingpage-renownbutton-candle,27657,2893,508,160,1,509,1,161,27495,0,0,0,0
thewarwithin-landingpage-renownbutton-flame,27658,2893,508,160,511,1019,1,161,27496,0,0,0,0
thewarwithin-landingpage-renownbutton-locked,27659,2893,508,160,1,509,163,323,27497,0,0,0,0
thewarwithin-landingpage-renownbutton-storm,27660,2893,508,160,511,1019,163,323,27498,0,0,0,0
thewarwithin-landingpage-renownbutton-web,27661,2893,508,160,1,509,325,485,27499,0,0,0,0
thewarwithin-landingpage-background-fadeoverlay-bottom,27662,2894,390,83,393,783,553,636,27500,0,0,0,0
thewarwithin-landingpage-background-fadeoverlay-top,27663,2894,390,164,1,391,553,717,27501,0,0,0,0
thewarwithin-landingpage-background,27664,2894,785,550,1,786,1,551,27502,0,0,0,0
ui-frame-thewarwithin-embellishmenttop,27665,2837,186,29,493,679,1118,1147,27503,0,0,0,0
vignetteevent-pressed-supertracked,27666,647,64,64,137,201,791,855,27504,32,32,0,0
vignetteevent-pressed,27667,647,64,64,137,201,725,789,27505,32,32,0,0
vignetteevent-supertracked,27668,647,64,64,137,201,857,921,27506,32,32,0,0
128-redbutton-delete-disabled,27669,2895,128,128,1,129,131,259,27507,0,0,0,0
128-redbutton-delete-highlight,27670,2895,128,128,1,129,261,389,27508,0,0,0,0
128-redbutton-delete-pressed,27671,2895,128,128,131,259,1,129,27509,0,0,0,0
128-redbutton-delete,27672,2895,128,128,1,129,1,129,27510,0,0,0,0
questlog-questtypeicon-delves,27673,2429,18,18,1,19,65,83,27511,0,0,0,0
ui-eventpoi-horn-big,27685,2897,32,32,1,33,35,67,27514,0,0,0,0
ui-eventpoi-spreadthelight,27687,2897,32,32,35,67,35,67,27516,0,0,0,0
ui-eventpoi-theatretroupe,27688,2897,32,32,69,101,35,67,27517,0,0,0,0
ui-eventpoi-worldsoulmemory,27689,2897,32,32,35,67,69,101,27518,0,0,0,0
shop-card-generic-green,27695,2898,568,463,1,569,1,464,27524,0,0,0,0
shop-card-generic-bluesky,27700,2899,568,463,1,569,1,464,27521,0,0,0,0
shop-card-generic-darkred,27701,2900,568,463,1,569,1,464,27522,0,0,0,0
shop-card-generic-forest,27702,2901,568,463,1,569,1,464,27523,0,0,0,0
shop-card-generic-purpletrees,27703,2902,568,463,1,569,1,464,27525,0,0,0,0
shop-card-generic-snowy,27704,2903,568,463,1,569,1,464,27526,0,0,0,0
shop-card-generic-water,27705,2904,568,463,1,569,1,464,27528,0,0,0,0
shop-card-generic-tradingpost,27706,2905,568,463,1,569,1,464,27527,0,0,0,0
talents-heroclass-hunter-sentinel,27707,2777,200,200,405,605,809,1009,27529,0,0,0,0
talents-heroclass-warlock-soulharvester,27708,2777,200,200,1819,2019,1,201,27530,0,0,0,0
splash-1100-botleft,27709,2906,137,371,374,511,587,958,27531,0,0,0,0
splash-1100-right,27710,2906,510,584,1,511,1,585,27532,0,0,0,0
splash-1100-topleft,27711,2906,371,434,1,372,587,1021,27533,0,0,0,0
ui-questpoicampaign-innerglow-2x,27712,2907,64,64,1,65,131,195,11847,0,0,0,0
ui-questpoicampaign-outerglow-2x,27713,2907,128,128,1,129,1,129,11848,0,0,0,0
ui-questpoicampaign-questbang-2x,27714,2907,64,64,131,195,1,65,11861,0,0,0,0
ui-questpoicampaign-questbangturnin-2x,27715,2907,64,64,131,195,67,131,11862,0,0,0,0
ui-questpoicampaign-questnumber-2x,27716,2907,64,64,131,195,133,197,11856,0,0,0,0
ui-questpoicampaign-questnumber-pressed-2x,27717,2907,64,64,197,261,1,65,11854,0,0,0,0
ui-questpoicampaign-questnumber-pressed-supertracked-2x,27718,2907,64,64,197,261,67,131,11853,0,0,0,0
ui-questpoicampaign-questnumber-supertracked-2x,27719,2907,64,64,197,261,133,197,11855,0,0,0,0
ui-eventpoi-horn-big-2x,27720,2908,64,64,133,197,1,65,27514,0,0,0,0
ui-eventpoi-horn-small-corner-2x,27721,2908,64,64,1,65,67,131,27539,0,0,0,0
ui-eventpoi-spreadthelight-2x,27722,2908,64,64,1,65,133,197,27516,0,0,0,0
ui-eventpoi-theatretroupe-2x,27723,2908,64,64,67,131,67,131,27517,0,0,0,0
ui-eventpoi-worldsoulmemory-2x,27724,2908,64,64,133,197,67,131,27518,0,0,0,0
ui-eventpoi-horn-small-corner,27725,2897,32,32,1,33,69,101,27539,0,0,0,0
worldquest-questmarker-dragon-silver,27736,743,64,64,268,332,296,360,27550,32,32,0,0
bonus-objective-star,27737,743,32,32,479,511,223,255,27551,16,16,0,0
rare-elite-star,27738,743,32,32,479,511,257,289,27552,16,16,0,0
evergreen-weeklyrewards-category-dungeons,27739,2910,422,177,1137,1559,516,693,27553,0,0,0,0
evergreen-weeklyrewards-category-raids,27740,2910,405,172,1,406,1379,1551,27554,0,0,0,0
evergreen-weeklyrewards-category-world,27741,2910,400,165,1,401,1553,1718,27555,0,0,0,0
evergreen-weeklyrewards-divider,27742,2910,1057,7,856,1913,1464,1471,27556,0,0,0,0
evergreen-weeklyrewards-frame-back,27743,2910,1134,712,1,1135,1,713,27557,0,0,0,0
evergreen-weeklyrewards-frame-selectbutton,27744,2910,209,31,1,210,1974,2005,27558,0,0,0,0
evergreen-weeklyrewards-frame-topdecor,27745,2910,229,103,625,854,1447,1550,27559,0,0,0,0
evergreen-weeklyrewards-frame,27746,2910,1175,662,1,1176,715,1377,27560,0,0,0,0
evergreen-weeklyrewards-header,27747,2910,735,15,856,1591,1447,1462,27561,0,0,0,0
evergreen-weeklyrewards-reward-coin,27749,2910,445,50,871,1316,1379,1429,27563,0,0,0,0
evergreen-weeklyrewards-reward-locked,27750,2910,218,125,1,219,1720,1845,27564,0,0,0,0
evergreen-weeklyrewards-reward-selected-sideglow,27751,2910,260,163,1678,1938,715,878,27565,0,0,0,0
evergreen-weeklyrewards-reward-selected,27752,2910,214,121,408,622,1571,1692,27566,0,0,0,0
evergreen-weeklyrewards-reward-unlocked,27753,2910,218,125,1,219,1847,1972,27567,0,0,0,0
evergreen-weeklyrewards-frame-back-shadow,27754,2910,513,513,1137,1650,1,514,27568,0,0,0,0
evergreen-weeklyrewards-reward-itemframe,27755,2910,156,51,1678,1834,1325,1376,27569,0,0,0,0
delves-scenario-heart-icon,27756,2842,32,32,267,299,49,81,27570,0,0,0,0
delves-scenario-treasure-available,27757,2842,45,45,315,360,1,46,27571,0,0,0,0
delves-scenario-treasure-unavailable,27758,2842,45,45,362,407,1,46,27572,0,0,0,0
delves-scenario-heart-icon-2x,27759,2843,64,64,516,580,95,159,27570,0,0,0,0
delves-scenario-treasure-available-2x,27760,2843,90,90,610,700,1,91,27571,0,0,0,0
delves-scenario-treasure-unavailable,27761,2843,90,90,702,792,1,91,27572,0,0,0,0
delves-scenario-trackerheader,27762,2842,256,83,1,257,87,170,27578,0,0,0,0
delves-scenario-trackerheader-2x,27763,2843,513,168,1,514,1,169,27578,0,0,0,0
questlog-quest-glow-yellow,27764,2736,295,50,160,455,40,90,27584,0,0,0,0
questlog-quest-glow-yellow-2x,27765,2738,590,100,1,591,698,798,27584,0,0,0,0
cursor_attack_128,27766,2913,128,128,1,129,1,129,27585,0,0,0,0
cursor_attack_32,27767,2913,32,32,261,293,67,99,27586,0,0,0,0
cursor_attack_48,27768,2913,48,48,393,441,1,49,27587,0,0,0,0
cursor_attack_64,27769,2913,64,64,261,325,1,65,27588,0,0,0,0
cursor_attack_96,27770,2913,96,96,1,97,131,227,27589,0,0,0,0
cursor_unableattack_128,27771,2913,128,128,131,259,1,129,27590,0,0,0,0
cursor_unableattack_32,27772,2913,32,32,261,293,101,133,27591,0,0,0,0
cursor_unableattack_48,27773,2913,48,48,443,491,1,49,27592,0,0,0,0
cursor_unableattack_64,27774,2913,64,64,327,391,1,65,27593,0,0,0,0
cursor_unableattack_96,27775,2913,96,96,131,227,131,227,27594,0,0,0,0
thewarwithin-scenario-barfill,27776,2914,231,9,0,231,1,10,27595,0,0,4,0
thewarwithin-scenario-black-background,27777,2914,330,1,1,331,402,403,27596,0,0,0,0
thewarwithin-scenario-filigree-bottom,27778,2914,50,17,456,506,12,29,27597,0,0,0,0
thewarwithin-scenario-filigree-top,27779,2914,101,19,353,454,12,31,27598,0,0,0,0
thewarwithin-scenario-frame,27780,2914,249,76,1,250,179,255,27599,0,0,0,0
thewarwithin-scenario-line-bottom,27781,2914,350,5,1,351,388,393,27600,0,0,0,0
thewarwithin-scenario-line-top-glowing,27782,2914,350,6,1,351,380,386,27601,0,0,0,0
thewarwithin-scenario-line-top,27783,2914,350,5,1,351,395,400,27602,0,0,0,0
thewarwithin-scenario-pattern-background,27784,2914,302,50,1,303,328,378,27603,0,0,0,0
thewarwithin-scenario-titlebg,27785,2914,350,165,1,351,12,177,27604,0,0,0,0
thewarwithin-scenario-barfill-2x,27788,2915,462,18,0,462,1,19,27595,0,0,4,0
thewarwithin-scenario-black-background-2x,27789,2915,660,2,1,661,787,789,27596,0,0,0,0
thewarwithin-scenario-filigree-bottom-2x,27790,2915,100,33,906,1006,21,54,27597,0,0,0,0
thewarwithin-scenario-filigree-top-2x,27791,2915,201,37,703,904,21,58,27598,0,0,0,0
thewarwithin-scenario-frame-2x,27792,2915,497,152,1,498,353,505,27599,0,0,0,0
thewarwithin-scenario-line-bottom-2x,27793,2915,700,10,1,701,763,773,27600,0,0,0,0
thewarwithin-scenario-line-top-2x,27794,2915,700,10,1,701,775,785,27602,0,0,0,0
thewarwithin-scenario-line-top-glowing-2x,27795,2915,700,12,1,701,749,761,27601,0,0,0,0
thewarwithin-scenario-pattern-background-2x,27796,2915,604,100,1,605,647,747,27603,0,0,0,0
thewarwithin-scenario-titlebg-2x,27797,2915,700,330,1,701,21,351,27604,0,0,0,0
evergreen-weeklyrewards-reward-fx-backglow,27800,2910,168,115,1855,2023,1162,1277,27619,0,0,0,0
evergreen-weeklyrewards-reward-selected-edgeglow,27801,2910,498,499,1178,1676,715,1214,27620,0,0,0,0
evergreen-weeklyrewards-reward-selected-outerglow,27802,2910,234,141,1678,1912,880,1021,27621,0,0,0,0
evergreen-weeklyrewards-reward-unlocked-fx-overlay,27803,2910,230,137,1678,1908,1023,1160,27622,0,0,0,0
evergreen-weeklyrewards-reward-unlocked-fx-sparkle01,27804,2910,65,67,1561,1626,516,583,27623,0,0,0,0
evergreen-weeklyrewards-reward-unlocked-fx-sparkle02,27805,2910,62,66,1911,1973,1,67,27624,0,0,0,0
evergreen-weeklyrewards-reward-unlocked-fx-sparkle03,27806,2910,62,69,1561,1623,585,654,27625,0,0,0,0
evergreen-weeklyrewards-reward-unlocked-fx-swirl,27807,2910,175,161,1678,1853,1162,1323,27626,0,0,0,0
shop-card-full-july2024-180day,27808,2916,568,463,1,569,1,464,27627,0,0,0,0
shop-card-full-july2024-6month,27809,2916,568,463,1,569,466,929,27628,0,0,0,0
shop-card-full-july2024-12month,27810,2917,568,463,1,569,1,464,27629,0,0,0,0
shop-card-full-july2024-365day,27811,2917,568,463,1,569,466,929,27630,0,0,0,0
evergreen-weeklyrewards-reward-unlocked-fx-overlay-mask,27812,2918,512,512,0,512,0,512,27631,0,0,16,0
evergreen-weeklyrewards-reward-selected-edgeglow_mask,27813,2919,256,256,0,256,0,256,27632,0,0,16,0
delves-scenario-flag,27814,2842,34,39,409,443,1,40,27633,0,0,0,0
delves-scenario-flag-2x,27815,2843,68,78,794,862,1,79,27633,0,0,0,0
evergreen-weeklyrewards-reward-coin-selected,27823,2910,461,66,408,869,1379,1445,27635,0,0,0,0
cursor_questturnin_128,27824,2920,128,128,1,129,1,129,27636,0,0,0,0
cursor_questturnin_32,27825,2920,32,32,131,163,329,361,27637,0,0,0,0
cursor_questturnin_48,27826,2920,48,48,1,49,457,505,27638,0,0,0,0
cursor_questturnin_64,27827,2920,64,64,229,293,131,195,27639,0,0,0,0
cursor_questturnin_96,27828,2920,96,96,391,487,1,97,27640,0,0,0,0
cursor_quest_128,27829,2920,128,128,131,259,1,129,27641,0,0,0,0
cursor_quest_32,27830,2920,32,32,131,163,363,395,27642,0,0,0,0
cursor_quest_48,27831,2920,48,48,51,99,457,505,27643,0,0,0,0
cursor_quest_64,27832,2920,64,64,295,359,131,195,27644,0,0,0,0
cursor_quest_96,27833,2920,96,96,1,97,261,357,27645,0,0,0,0
cursor_unablequestturnin_128,27834,2920,128,128,261,389,1,129,27646,0,0,0,0
cursor_unablequestturnin_32,27835,2920,32,32,131,163,397,429,27647,0,0,0,0
cursor_unablequestturnin_48,27836,2920,48,48,131,179,229,277,27648,0,0,0,0
cursor_unablequestturnin_64,27837,2920,64,64,361,425,131,195,27649,0,0,0,0
cursor_unablequestturnin_96,27838,2920,96,96,1,97,359,455,27650,0,0,0,0
cursor_unablequest_128,27839,2920,128,128,1,129,131,259,27651,0,0,0,0
cursor_unablequest_32,27840,2920,32,32,131,163,431,463,27652,0,0,0,0
cursor_unablequest_48,27841,2920,48,48,131,179,279,327,27653,0,0,0,0
cursor_unablequest_64,27842,2920,64,64,427,491,131,195,27654,0,0,0,0
cursor_unablequest_96,27843,2920,96,96,131,227,131,227,27655,0,0,0,0
ui-eventpoi-awakeningthemachine,27855,2897,32,32,1,33,1,33,27667,0,0,0,0
ui-eventpoi-awakeningthemachine-2x,27856,2908,64,64,1,65,1,65,27667,0,0,0,0
evergreen-weeklyrewards-reward-coin-unselected,27857,2910,442,47,1318,1760,1379,1426,27668,0,0,0,0
evergreen-weeklyrewards-reward-unselected,27858,2910,215,122,408,623,1447,1569,27669,0,0,0,0
greatvault-anim-unlocked-fx,27860,2925,1440,1800,1,1441,1,1801,27671,0,0,0,0
worldquest-icon-boss-zhcn,27864,743,32,32,372,404,362,394,27666,16,16,0,0
stormblue-extrabutton,27865,2256,256,128,1,257,1,129,21578,0,0,0,0
stormpurple-extrabutton,27866,2256,256,128,1,257,131,259,21579,0,0,0,0
stormwhite-extrabutton,27867,2256,256,128,1,257,261,389,27675,0,0,0,0
stormyellow-extrabutton,27868,2256,256,128,259,515,1,129,21581,0,0,0,0
greatvault-blur-dis,27869,2925,147,150,207,354,1803,1953,27676,0,0,0,0
greatvault-blur-normal,27870,2925,147,150,356,503,1803,1953,27677,0,0,0,0
greatvault-centerplate-dis,27871,2925,74,77,356,430,1955,2032,27678,0,0,0,0
greatvault-fx-circglow,27872,2925,271,271,1728,1999,1,272,27679,0,0,0,0
greatvault-fx-gold1,27873,2925,113,106,505,618,1937,2043,27680,0,0,0,0
greatvault-fx-gold2,27874,2925,128,82,207,335,1955,2037,27681,0,0,0,0
greatvault-fx-gold3,27875,2925,152,113,658,810,1803,1916,27682,0,0,0,0
greatvault-fx-particles1,27876,2925,151,132,505,656,1803,1935,27683,0,0,0,0
greatvault-fx-particles2,27877,2925,204,180,1,205,1803,1983,27684,0,0,0,0
greatvault-fx-wind,27878,2925,283,273,1443,1726,1,274,27685,0,0,0,0
greatvault-handles-dis,27879,2925,105,108,658,763,1918,2026,27686,0,0,0,0
greatvault-keyhole-outline-glow,27880,2925,33,47,38,71,1985,2032,27687,0,0,0,0
greatvault-keyhole-start1,27881,2925,35,50,1,36,1985,2035,27688,0,0,0,0
greatvault-whole-normal,27882,2925,105,108,812,917,1803,1911,27689,0,0,0,0
greatvault-anim-upgrade-fx,27883,2933,1980,1680,1,1981,1,1681,27690,0,0,0,0
evergreen-weeklyrewards-category-pvp,27887,2910,421,152,1178,1599,1216,1368,27694,0,0,0,0
delves-companion-shadow,27888,2832,328,127,569,897,1,128,27695,0,0,0,0
ui-ej-thewarwithin,27889,2934,786,425,1,787,1,426,27696,0,0,0,0
dragonriding-barbershop-icon-delvesairship,27891,2070,128,128,707,835,1,129,27697,0,0,0,0
delves-scenario-affix-mask,27892,2842,18,17,315,333,48,65,27698,0,0,0,0
delves-scenario-affix-ring,27893,2842,46,46,267,313,1,47,27699,0,0,0,0
delves-scenario-affix-mask-2x,27894,2843,35,35,610,645,93,128,27698,0,0,0,0
delves-scenario-affix-ring-2x,27895,2843,92,92,516,608,1,93,27699,0,0,0,0
renown-candle,27896,647,36,36,261,297,985,1021,27702,0,0,0,0
renown-flame,27897,647,36,36,299,335,263,299,27703,0,0,0,0
renown-storm,27898,647,36,36,337,373,263,299,27704,0,0,0,0
renown-web,27899,647,36,36,375,411,263,299,27705,0,0,0,0
shop-card-full-cosmic-weapons-cache,27903,2936,568,463,1,569,1,464,27709,0,0,0,0
ui-frame-bossportrait-9slice-2x,27904,2781,432,380,1,433,1013,1393,27710,0,0,0,0
ui-frame-bossportrait-devider-2x,27905,2781,400,74,1,401,1395,1469,27711,0,0,0,0
ui-frame-bossportrait-tile-2x,27906,2781,24,36,0,24,49,85,27712,0,0,4,0
ui-frame-bossportrait-9slice,27907,2780,216,190,1,217,511,701,27710,0,0,0,0
ui-frame-bossportrait-devider,27908,2780,200,37,1,201,703,740,27724,0,0,0,0
ui-frame-bossportrait-tile,27909,2780,12,18,0,12,26,44,27712,0,0,4,0
shop-card-full-traveling-repair-bear,27910,2937,568,463,1,569,1,464,27714,0,0,0,0
thewarwithin-scenario-trackerheader-2x,27913,2915,497,152,500,997,353,505,27713,0,0,0,0
thewarwithin-scenario-trackerheader,27914,2914,249,76,252,501,179,255,27713,0,0,0,0
thewarwithin-scenario-trackerheader-final-filigree,27915,2914,242,69,1,243,257,326,27718,0,0,0,0
thewarwithin-scenario-trackerheader-final-filigree-2x,27916,2915,483,138,1,484,507,645,27605,0,0,0,0
evergreen-scenario-trackerheader-2x,27917,2772,505,160,508,1013,523,683,27719,0,0,0,0
evergreen-scenario-trackerheader-final-filigree-2x,27918,2772,528,168,1,529,353,521,27720,0,0,0,0
evergreen-scenario-trackerheader-final-filigree,27919,2771,264,84,1,265,179,263,27720,0,0,0,0
evergreen-scenario-trackerheader,27920,2771,253,80,256,509,265,345,27719,0,0,0,0
splash-1100release-botleft,27921,2940,137,371,374,511,587,958,28365,0,0,0,0
splash-1100release-right,27922,2940,510,584,1,511,1,585,28366,0,0,0,0
splash-1100release-topleft,27923,2940,371,434,1,372,587,1021,28367,0,0,0,0
splash-11001-botleft,27924,2941,137,371,374,511,587,958,27721,0,0,0,0
splash-11001-right,27925,2941,510,584,1,511,1,585,27722,0,0,0,0
splash-11001-topleft,27926,2941,371,434,1,372,587,1021,27723,0,0,0,0
gficon-chest-evergreen-greatvault-collect,27927,2910,257,226,1652,1909,1,227,27728,0,0,0,0
gficon-chest-evergreen-greatvault-complete,27928,2910,257,226,1652,1909,229,455,27729,0,0,0,0
gficon-chest-evergreen-greatvault-incomplete,27929,2910,257,226,1652,1909,457,683,27730,0,0,0,0
cursor_openhand_128,27930,2942,128,128,1,129,1,129,24241,0,0,0,0
cursor_openhand_32,27931,2942,32,32,261,293,67,99,24242,0,0,0,0
cursor_openhand_48,27932,2942,48,48,393,441,1,49,24243,0,0,0,0
cursor_openhand_64,27933,2942,64,64,261,325,1,65,24244,0,0,0,0
cursor_openhand_96,27934,2942,96,96,1,97,131,227,24245,0,0,0,0
cursor_unableopenhand_128,27935,2942,128,128,131,259,1,129,24246,0,0,0,0
cursor_unableopenhand_32,27936,2942,32,32,261,293,101,133,24247,0,0,0,0
cursor_unableopenhand_48,27937,2942,48,48,443,491,1,49,24248,0,0,0,0
cursor_unableopenhand_64,27938,2942,64,64,327,391,1,65,24249,0,0,0,0
cursor_unableopenhand_96,27939,2942,96,96,131,227,131,227,24250,0,0,0,0
shop-card-full-cn-reborn-bundle-heroic,27940,2943,568,463,1,569,1,464,27731,0,0,0,0
shop-card-full-cn-warpath-pack,27941,2943,568,463,571,1139,1,464,27732,0,0,0,0
shop-card-full-cn-yearly-deluxe,27942,2943,568,463,1141,1709,1,464,27733,0,0,0,0
completiondialog-twwpact-background,27943,2944,770,598,1,771,1,599,27734,0,0,0,0
completiondialog-twwpact-divider,27944,2944,670,111,1,671,601,712,27735,0,0,0,0
completiondialog-twwpact-pact-icon,27945,2944,82,82,773,855,1,83,27736,0,0,0,0
completiondialog-twwpact-patron-icon,27946,2944,68,61,857,925,1,62,27737,0,0,0,0
completiondialog-twwpact-rumor-icon,27947,2944,58,58,927,985,1,59,27738,0,0,0,0
ui-lfg-roleicon-dps-micro-groupfinder,27948,2462,21,21,2003,2024,1,22,27739,0,0,0,0
ui-lfg-roleicon-generic-micro-groupfinder,27949,2462,21,21,2026,2047,1,22,27740,0,0,0,0
ui-lfg-roleicon-healer-micro-groupfinder,27950,2462,21,21,2003,2024,24,45,27741,0,0,0,0
ui-lfg-roleicon-leader-micro-groupfinder,27951,2462,21,21,2026,2047,24,45,27742,0,0,0,0
ui-lfg-roleicon-rangeddps-micro-groupfinder,27952,2462,21,21,2003,2024,47,68,27743,0,0,0,0
ui-lfg-roleicon-tank-micro-groupfinder,27953,2462,21,21,2026,2047,47,68,27744,0,0,0,0
talents-heroclass-monk-masterofharmony,27954,2777,200,200,1213,1413,809,1009,27745,0,0,0,0
talents-heroclass-warlock-hellcaller,27955,2777,200,200,1415,1615,203,403,27746,0,0,0,0
gm-icon-assist-hover,27960,2703,40,40,275,315,908,948,27747,0,0,0,0
gm-icon-assist-pressed,27961,2703,40,40,275,315,950,990,27748,0,0,0,0
gm-icon-assistactive-hover,27962,2703,40,40,317,357,950,990,27749,0,0,0,0
gm-icon-assistactive-pressed,27963,2703,40,40,359,399,908,948,27750,0,0,0,0
gm-icon-assiston-hover,27964,2703,40,40,359,399,950,990,27751,0,0,0,0
gm-icon-countdown-hover,27965,2703,40,40,497,537,1,41,27752,0,0,0,0
gm-icon-countdown-pressed,27966,2703,40,40,539,579,1,41,27753,0,0,0,0
gm-icon-difficulty-heroic-hover,27967,2703,40,40,665,705,1,41,27754,0,0,0,0
gm-icon-difficulty-heroic-pressed,27968,2703,40,40,707,747,1,41,27755,0,0,0,0
gm-icon-difficulty-heroicselected-hover,27969,2703,40,40,833,873,1,41,27756,0,0,0,0
gm-icon-difficulty-heroicselected-pressed,27970,2703,40,40,875,915,1,41,27757,0,0,0,0
gm-icon-difficulty-mythic-hover,27971,2703,40,40,497,537,43,83,27758,0,0,0,0
gm-icon-difficulty-mythic-pressed,27972,2703,40,40,539,579,43,83,27759,0,0,0,0
gm-icon-difficulty-mythicselected-hover,27973,2703,40,40,665,705,43,83,27760,0,0,0,0
gm-icon-difficulty-mythicselected-pressed,27974,2703,40,40,707,747,43,83,27761,0,0,0,0
gm-icon-difficulty-normal-hover,27975,2703,40,40,833,873,43,83,27762,0,0,0,0
gm-icon-difficulty-normal-pressed,27976,2703,40,40,875,915,43,83,27763,0,0,0,0
gm-icon-difficulty-normalselected-hover,27977,2703,40,40,497,537,85,125,27764,0,0,0,0
gm-icon-difficulty-normalselected-pressed,27978,2703,40,40,539,579,85,125,27765,0,0,0,0
gm-icon-menu-hover,27979,2703,40,40,623,663,85,125,27766,0,0,0,0
gm-icon-menu-pressed,27980,2703,40,40,665,705,85,125,27767,0,0,0,0
gm-icon-readycheck-hover,27981,2703,40,40,749,789,85,125,27768,0,0,0,0
gm-icon-readycheck-pressed,27982,2703,40,40,791,831,85,125,27769,0,0,0,0
gm-icon-roles-hover,27983,2703,40,40,875,915,85,125,27770,0,0,0,0
gm-icon-roles-pressed,27984,2703,40,40,917,957,85,125,27771,0,0,0,0
gm-icon-settings-hover,27985,2703,40,40,497,537,127,167,27772,0,0,0,0
gm-icon-settings-pressed,27986,2703,40,40,539,579,127,167,27773,0,0,0,0
gm-icon-visible-hover,27987,2703,40,40,623,663,127,167,27774,0,0,0,0
gm-icon-visible-pressed,27988,2703,40,40,665,705,127,167,27775,0,0,0,0
gm-icon-visibledis-hover,27989,2703,40,40,749,789,127,167,27776,0,0,0,0
gm-icon-visibledis-pressed,27990,2703,40,40,791,831,127,167,27777,0,0,0,0
gm-tab-bg,27991,2703,28,28,225,253,995,1023,27778,0,0,0,0
gm-tab-default,27992,2703,50,19,161,211,1001,1020,27779,0,0,0,0
gm-tab-selected,27993,2703,50,21,1,51,987,1008,27780,0,0,0,0
gm-icon-assist-hover-2x,27994,2702,80,80,447,527,1897,1977,27747,0,0,0,0
gm-icon-assist-pressed-2x,27995,2702,80,80,545,625,1809,1889,27748,0,0,0,0
gm-icon-assistactive-hover-2x,27996,2702,80,80,627,707,1809,1889,27749,0,0,0,0
gm-icon-assistactive-pressed-2x,27997,2702,80,80,627,707,1891,1971,27750,0,0,0,0
gm-icon-assiston-hover-2x,27998,2702,80,80,791,871,1809,1889,27751,0,0,0,0
gm-icon-countdown-hover-2x,27999,2702,80,80,791,871,1891,1971,27752,0,0,0,0
gm-icon-countdown-pressed-2x,28000,2702,80,80,985,1065,1,81,27753,0,0,0,0
gm-icon-difficulty-heroic-hover-2x,28001,2702,80,80,1231,1311,1,81,27754,0,0,0,0
gm-icon-difficulty-heroic-pressed-2x,28002,2702,80,80,1313,1393,1,81,27755,0,0,0,0
gm-icon-difficulty-heroicselected-hover-2x,28003,2702,80,80,1559,1639,1,81,27756,0,0,0,0
gm-icon-difficulty-heroicselected-pressed-2x,28004,2702,80,80,1641,1721,1,81,27757,0,0,0,0
gm-icon-difficulty-mythic-hover-2x,28005,2702,80,80,1887,1967,1,81,27758,0,0,0,0
gm-icon-difficulty-mythic-pressed-2x,28006,2702,80,80,985,1065,83,163,27759,0,0,0,0
gm-icon-difficulty-mythicselected-hover-2x,28007,2702,80,80,1231,1311,83,163,27760,0,0,0,0
gm-icon-difficulty-mythicselected-pressed-2x,28008,2702,80,80,1313,1393,83,163,27761,0,0,0,0
gm-icon-difficulty-normal-hover-2x,28009,2702,80,80,1559,1639,83,163,27762,0,0,0,0
gm-icon-difficulty-normal-pressed-2x,28010,2702,80,80,1641,1721,83,163,27763,0,0,0,0
gm-icon-difficulty-normalselected-hover-2x,28011,2702,80,80,1887,1967,83,163,27764,0,0,0,0
gm-icon-difficulty-normalselected-pressed-2x,28012,2702,80,80,985,1065,165,245,27765,0,0,0,0
gm-icon-menu-hover-2x,28013,2702,80,80,1149,1229,165,245,27766,0,0,0,0
gm-icon-menu-pressed-2x,28014,2702,80,80,1231,1311,165,245,27767,0,0,0,0
gm-icon-readycheck-hover-2x,28015,2702,80,80,1395,1475,165,245,27768,0,0,0,0
gm-icon-readycheck-pressed-2x,28016,2702,80,80,1477,1557,165,245,27769,0,0,0,0
gm-icon-roles-hover-2x,28017,2702,80,80,1641,1721,165,245,27770,0,0,0,0
gm-icon-roles-pressed-2x,28018,2702,80,80,1723,1803,165,245,27771,0,0,0,0
gm-icon-settings-hover-2x,28019,2702,80,80,1887,1967,165,245,27772,0,0,0,0
gm-icon-settings-pressed-2x,28020,2702,80,80,985,1065,247,327,27773,0,0,0,0
gm-icon-visible-hover-2x,28021,2702,80,80,1149,1229,247,327,27774,0,0,0,0
gm-icon-visible-pressed-2x,28022,2702,80,80,1231,1311,247,327,27775,0,0,0,0
gm-icon-visibledis-hover-2x,28023,2702,80,80,1395,1475,247,327,27776,0,0,0,0
gm-icon-visibledis-pressed-2x,28024,2702,80,80,1477,1557,247,327,27777,0,0,0,0
gm-tab-bg-2x,28025,2702,56,56,447,503,1979,2035,27778,0,0,0,0
gm-tab-default-2x,28026,2702,100,38,791,891,1973,2011,27779,0,0,0,0
gm-tab-selected-2x,28027,2702,100,42,315,415,1992,2034,27780,0,0,0,0
streamcinematic-warwithin-large-down,28028,2707,246,135,249,495,686,821,27781,0,0,0,0
streamcinematic-warwithin-large-up,28029,2707,246,135,249,495,823,958,27782,0,0,0,0
streamcinematic-warwithin2-large-down,28030,2707,246,135,497,743,686,821,27783,0,0,0,0
streamcinematic-warwithin2-large-up,28031,2707,246,135,745,991,686,821,27784,0,0,0,0
shop-card-full-annual-essence-gift-pack,28032,2945,568,463,1,569,1,464,27785,0,0,0,0
crosshair_unablewrapperturnin_128,28033,2946,128,128,1,129,1,129,27786,0,0,0,0
crosshair_unablewrapperturnin_32,28034,2946,32,32,131,163,329,361,27787,0,0,0,0
crosshair_unablewrapperturnin_48,28035,2946,48,48,1,49,457,505,27788,0,0,0,0
crosshair_unablewrapperturnin_64,28036,2946,64,64,229,293,131,195,27789,0,0,0,0
crosshair_unablewrapperturnin_96,28037,2946,96,96,391,487,1,97,27790,0,0,0,0
crosshair_unablewrapper_128,28038,2946,128,128,131,259,1,129,27791,0,0,0,0
crosshair_unablewrapper_32,28039,2946,32,32,131,163,363,395,27792,0,0,0,0
crosshair_unablewrapper_48,28040,2946,48,48,51,99,457,505,27793,0,0,0,0
crosshair_unablewrapper_64,28041,2946,64,64,295,359,131,195,27794,0,0,0,0
crosshair_unablewrapper_96,28042,2946,96,96,1,97,261,357,27795,0,0,0,0
crosshair_wrapperturnin_128,28043,2946,128,128,261,389,1,129,27796,0,0,0,0
crosshair_wrapperturnin_32,28044,2946,32,32,131,163,397,429,27797,0,0,0,0
crosshair_wrapperturnin_48,28045,2946,48,48,131,179,229,277,27798,0,0,0,0
crosshair_wrapperturnin_64,28046,2946,64,64,361,425,131,195,27799,0,0,0,0
crosshair_wrapperturnin_96,28047,2946,96,96,1,97,359,455,27800,0,0,0,0
crosshair_wrapper_128,28048,2946,128,128,1,129,131,259,27801,0,0,0,0
crosshair_wrapper_32,28049,2946,32,32,131,163,431,463,27802,0,0,0,0
crosshair_wrapper_48,28050,2946,48,48,131,179,279,327,27803,0,0,0,0
crosshair_wrapper_64,28051,2946,64,64,427,491,131,195,27804,0,0,0,0
crosshair_wrapper_96,28052,2946,96,96,131,227,131,227,27805,0,0,0,0
crosshair_recurringturnin_128,28053,2947,128,128,1,129,1,129,27806,0,0,0,0
crosshair_recurringturnin_32,28054,2947,32,32,131,163,329,361,27807,0,0,0,0
crosshair_recurringturnin_48,28055,2947,48,48,1,49,457,505,27808,0,0,0,0
crosshair_recurringturnin_64,28056,2947,64,64,229,293,131,195,27809,0,0,0,0
crosshair_recurringturnin_96,28057,2947,96,96,391,487,1,97,27810,0,0,0,0
crosshair_recurring_128,28058,2947,128,128,131,259,1,129,27811,0,0,0,0
crosshair_recurring_32,28059,2947,32,32,131,163,363,395,27812,0,0,0,0
crosshair_recurring_48,28060,2947,48,48,51,99,457,505,27813,0,0,0,0
crosshair_recurring_64,28061,2947,64,64,295,359,131,195,27814,0,0,0,0
crosshair_recurring_96,28062,2947,96,96,1,97,261,357,27815,0,0,0,0
crosshair_unablerecurringturnin_128,28063,2947,128,128,261,389,1,129,27816,0,0,0,0
crosshair_unablerecurringturnin_32,28064,2947,32,32,131,163,397,429,27817,0,0,0,0
crosshair_unablerecurringturnin_48,28065,2947,48,48,131,179,229,277,27818,0,0,0,0
crosshair_unablerecurringturnin_64,28066,2947,64,64,361,425,131,195,27819,0,0,0,0
crosshair_unablerecurringturnin_96,28067,2947,96,96,1,97,359,455,27820,0,0,0,0
crosshair_unablerecurring_128,28068,2947,128,128,1,129,131,259,27821,0,0,0,0
crosshair_unablerecurring_32,28069,2947,32,32,131,163,431,463,27822,0,0,0,0
crosshair_unablerecurring_48,28070,2947,48,48,131,179,279,327,27823,0,0,0,0
crosshair_unablerecurring_64,28071,2947,64,64,427,491,131,195,27824,0,0,0,0
crosshair_unablerecurring_96,28072,2947,96,96,131,227,131,227,27825,0,0,0,0
crosshair_questturnin_128,28073,2948,128,128,1,129,1,129,27826,0,0,0,0
crosshair_questturnin_32,28074,2948,32,32,131,163,329,361,27827,0,0,0,0
crosshair_questturnin_48,28075,2948,48,48,1,49,457,505,27828,0,0,0,0
crosshair_questturnin_64,28076,2948,64,64,229,293,131,195,27829,0,0,0,0
crosshair_questturnin_96,28077,2948,96,96,391,487,1,97,27830,0,0,0,0
crosshair_quest_128,28078,2948,128,128,131,259,1,129,27831,0,0,0,0
crosshair_quest_32,28079,2948,32,32,131,163,363,395,27832,0,0,0,0
crosshair_quest_48,28080,2948,48,48,51,99,457,505,27833,0,0,0,0
crosshair_quest_64,28081,2948,64,64,295,359,131,195,27834,0,0,0,0
crosshair_quest_96,28082,2948,96,96,1,97,261,357,27835,0,0,0,0
crosshair_unablequestturnin_128,28083,2948,128,128,261,389,1,129,27836,0,0,0,0
crosshair_unablequestturnin_32,28084,2948,32,32,131,163,397,429,27837,0,0,0,0
crosshair_unablequestturnin_48,28085,2948,48,48,131,179,229,277,27838,0,0,0,0
crosshair_unablequestturnin_64,28086,2948,64,64,361,425,131,195,27839,0,0,0,0
crosshair_unablequestturnin_96,28087,2948,96,96,1,97,359,455,27840,0,0,0,0
crosshair_unablequest_128,28088,2948,128,128,1,129,131,259,27841,0,0,0,0
crosshair_unablequest_32,28089,2948,32,32,131,163,431,463,27842,0,0,0,0
crosshair_unablequest_48,28090,2948,48,48,131,179,279,327,27843,0,0,0,0
crosshair_unablequest_64,28091,2948,64,64,427,491,131,195,27844,0,0,0,0
crosshair_unablequest_96,28092,2948,96,96,131,227,131,227,27845,0,0,0,0
crosshair_legendaryquestturnin_128,28093,2949,128,128,1,129,1,129,27846,0,0,0,0
crosshair_legendaryquestturnin_32,28094,2949,32,32,131,163,329,361,27847,0,0,0,0
crosshair_legendaryquestturnin_48,28095,2949,48,48,1,49,457,505,27848,0,0,0,0
crosshair_legendaryquestturnin_64,28096,2949,64,64,229,293,131,195,27849,0,0,0,0
crosshair_legendaryquestturnin_96,28097,2949,96,96,391,487,1,97,27850,0,0,0,0
crosshair_legendaryquest_128,28098,2949,128,128,131,259,1,129,27851,0,0,0,0
crosshair_legendaryquest_32,28099,2949,32,32,131,163,363,395,27852,0,0,0,0
crosshair_legendaryquest_48,28100,2949,48,48,51,99,457,505,27853,0,0,0,0
crosshair_legendaryquest_64,28101,2949,64,64,295,359,131,195,27854,0,0,0,0
crosshair_legendaryquest_96,28102,2949,96,96,1,97,261,357,27855,0,0,0,0
crosshair_unablelegendaryquestturnin_128,28103,2949,128,128,261,389,1,129,27856,0,0,0,0
crosshair_unablelegendaryquestturnin_32,28104,2949,32,32,131,163,397,429,27857,0,0,0,0
crosshair_unablelegendaryquestturnin_48,28105,2949,48,48,131,179,229,277,27858,0,0,0,0
crosshair_unablelegendaryquestturnin_64,28106,2949,64,64,361,425,131,195,27859,0,0,0,0
crosshair_unablelegendaryquestturnin_96,28107,2949,96,96,1,97,359,455,27860,0,0,0,0
crosshair_unablelegendaryquest_128,28108,2949,128,128,1,129,131,259,27861,0,0,0,0
crosshair_unablelegendaryquest_32,28109,2949,32,32,131,163,431,463,27862,0,0,0,0
crosshair_unablelegendaryquest_48,28110,2949,48,48,131,179,279,327,27863,0,0,0,0
crosshair_unablelegendaryquest_64,28111,2949,64,64,427,491,131,195,27864,0,0,0,0
crosshair_unablelegendaryquest_96,28112,2949,96,96,131,227,131,227,27865,0,0,0,0
crosshair_importantturnin_128,28113,2950,128,128,1,129,1,129,27866,0,0,0,0
crosshair_importantturnin_32,28114,2950,32,32,131,163,329,361,27867,0,0,0,0
crosshair_importantturnin_48,28115,2950,48,48,1,49,457,505,27868,0,0,0,0
crosshair_importantturnin_64,28116,2950,64,64,229,293,131,195,27869,0,0,0,0
crosshair_importantturnin_96,28117,2950,96,96,391,487,1,97,27870,0,0,0,0
crosshair_important_128,28118,2950,128,128,131,259,1,129,27871,0,0,0,0
crosshair_important_32,28119,2950,32,32,131,163,363,395,27872,0,0,0,0
crosshair_important_48,28120,2950,48,48,51,99,457,505,27873,0,0,0,0
crosshair_important_64,28121,2950,64,64,295,359,131,195,27874,0,0,0,0
crosshair_important_96,28122,2950,96,96,1,97,261,357,27875,0,0,0,0
crosshair_unableimportantturnin_128,28123,2950,128,128,261,389,1,129,27876,0,0,0,0
crosshair_unableimportantturnin_32,28124,2950,32,32,131,163,397,429,27877,0,0,0,0
crosshair_unableimportantturnin_48,28125,2950,48,48,131,179,229,277,27878,0,0,0,0
crosshair_unableimportantturnin_64,28126,2950,64,64,361,425,131,195,27879,0,0,0,0
crosshair_unableimportantturnin_96,28127,2950,96,96,1,97,359,455,27880,0,0,0,0
crosshair_unableimportant_128,28128,2950,128,128,1,129,131,259,27881,0,0,0,0
crosshair_unableimportant_32,28129,2950,32,32,131,163,431,463,27882,0,0,0,0
crosshair_unableimportant_48,28130,2950,48,48,131,179,279,327,27883,0,0,0,0
crosshair_unableimportant_64,28131,2950,64,64,427,491,131,195,27884,0,0,0,0
crosshair_unableimportant_96,28132,2950,96,96,131,227,131,227,27885,0,0,0,0
crosshair_campaignquestturnin_128,28133,2951,128,128,1,129,1,129,27886,0,0,0,0
crosshair_campaignquestturnin_32,28134,2951,32,32,131,163,329,361,27887,0,0,0,0
crosshair_campaignquestturnin_48,28135,2951,48,48,1,49,457,505,27888,0,0,0,0
crosshair_campaignquestturnin_64,28136,2951,64,64,229,293,131,195,27889,0,0,0,0
crosshair_campaignquestturnin_96,28137,2951,96,96,391,487,1,97,27890,0,0,0,0
crosshair_campaignquest_128,28138,2951,128,128,131,259,1,129,27891,0,0,0,0
crosshair_campaignquest_32,28139,2951,32,32,131,163,363,395,27892,0,0,0,0
crosshair_campaignquest_48,28140,2951,48,48,51,99,457,505,27893,0,0,0,0
crosshair_campaignquest_64,28141,2951,64,64,295,359,131,195,27894,0,0,0,0
crosshair_campaignquest_96,28142,2951,96,96,1,97,261,357,27895,0,0,0,0
crosshair_unablecampaignquestturnin_128,28143,2951,128,128,261,389,1,129,27896,0,0,0,0
crosshair_unablecampaignquestturnin_32,28144,2951,32,32,131,163,397,429,27897,0,0,0,0
crosshair_unablecampaignquestturnin_48,28145,2951,48,48,131,179,229,277,27898,0,0,0,0
crosshair_unablecampaignquestturnin_64,28146,2951,64,64,361,425,131,195,27899,0,0,0,0
crosshair_unablecampaignquestturnin_96,28147,2951,96,96,1,97,359,455,27900,0,0,0,0
crosshair_unablecampaignquest_128,28148,2951,128,128,1,129,131,259,27901,0,0,0,0
crosshair_unablecampaignquest_32,28149,2951,32,32,131,163,431,463,27902,0,0,0,0
crosshair_unablecampaignquest_48,28150,2951,48,48,131,179,279,327,27903,0,0,0,0
crosshair_unablecampaignquest_64,28151,2951,64,64,427,491,131,195,27904,0,0,0,0
crosshair_unablecampaignquest_96,28152,2951,96,96,131,227,131,227,27905,0,0,0,0
gm-icon-difficulty-heroic-disabled,28163,2703,40,40,623,663,1,41,27916,0,0,0,0
gm-icon-difficulty-mythic-disabled,28164,2703,40,40,959,999,1,41,27917,0,0,0,0
gm-icon-difficulty-normal-disabled,28165,2703,40,40,791,831,43,83,27918,0,0,0,0
gm-icon-difficulty-heroic-disabled-2x,28166,2702,80,80,1149,1229,1,81,27916,0,0,0,0
gm-icon-difficulty-mythic-disabled-2x,28167,2702,80,80,1805,1885,1,81,27917,0,0,0,0
gm-icon-difficulty-normal-disabled-2x,28168,2702,80,80,1477,1557,83,163,27918,0,0,0,0
crosshair_mail_128,28169,2953,128,128,1,129,1,129,27919,0,0,0,0
crosshair_mail_32,28170,2953,32,32,261,293,67,99,27920,0,0,0,0
crosshair_mail_48,28171,2953,48,48,393,441,1,49,27921,0,0,0,0
crosshair_mail_64,28172,2953,64,64,261,325,1,65,27922,0,0,0,0
crosshair_mail_96,28173,2953,96,96,1,97,131,227,27923,0,0,0,0
crosshair_unablemail_128,28174,2953,128,128,131,259,1,129,27924,0,0,0,0
crosshair_unablemail_32,28175,2953,32,32,261,293,101,133,27925,0,0,0,0
crosshair_unablemail_48,28176,2953,48,48,443,491,1,49,27926,0,0,0,0
crosshair_unablemail_64,28177,2953,64,64,327,391,1,65,27927,0,0,0,0
crosshair_unablemail_96,28178,2953,96,96,131,227,131,227,27928,0,0,0,0
cursor_taxi_128,28179,2954,128,128,1,129,1,129,27929,0,0,0,0
cursor_taxi_32,28180,2954,32,32,261,293,67,99,27930,0,0,0,0
cursor_taxi_48,28181,2954,48,48,393,441,1,49,27931,0,0,0,0
cursor_taxi_64,28182,2954,64,64,261,325,1,65,27932,0,0,0,0
cursor_taxi_96,28183,2954,96,96,1,97,131,227,27933,0,0,0,0
cursor_unabletaxi_128,28184,2954,128,128,131,259,1,129,27934,0,0,0,0
cursor_unabletaxi_32,28185,2954,32,32,261,293,101,133,27935,0,0,0,0
cursor_unabletaxi_48,28186,2954,48,48,443,491,1,49,27936,0,0,0,0
cursor_unabletaxi_64,28187,2954,64,64,327,391,1,65,27937,0,0,0,0
cursor_unabletaxi_96,28188,2954,96,96,131,227,131,227,27938,0,0,0,0
crosshair_taxi_128,28189,2955,128,128,1,129,1,129,27939,0,0,0,0
crosshair_taxi_32,28190,2955,32,32,261,293,67,99,27940,0,0,0,0
crosshair_taxi_48,28191,2955,48,48,393,441,1,49,27941,0,0,0,0
crosshair_taxi_64,28192,2955,64,64,261,325,1,65,27942,0,0,0,0
crosshair_taxi_96,28193,2955,96,96,1,97,131,227,27943,0,0,0,0
crosshair_unabletaxi_128,28194,2955,128,128,131,259,1,129,27944,0,0,0,0
crosshair_unabletaxi_32,28195,2955,32,32,261,293,101,133,27945,0,0,0,0
crosshair_unabletaxi_48,28196,2955,48,48,443,491,1,49,27946,0,0,0,0
crosshair_unabletaxi_64,28197,2955,64,64,327,391,1,65,27947,0,0,0,0
crosshair_unabletaxi_96,28198,2955,96,96,131,227,131,227,27948,0,0,0,0
crosshair_trainer_128,28199,2956,128,128,1,129,1,129,27949,0,0,0,0
crosshair_trainer_32,28200,2956,32,32,261,293,67,99,27950,0,0,0,0
crosshair_trainer_48,28201,2956,48,48,393,441,1,49,27951,0,0,0,0
crosshair_trainer_64,28202,2956,64,64,261,325,1,65,27952,0,0,0,0
crosshair_trainer_96,28203,2956,96,96,1,97,131,227,27953,0,0,0,0
crosshair_unabletrainer_128,28204,2956,128,128,131,259,1,129,27954,0,0,0,0
crosshair_unabletrainer_32,28205,2956,32,32,261,293,101,133,27955,0,0,0,0
crosshair_unabletrainer_48,28206,2956,48,48,443,491,1,49,27956,0,0,0,0
crosshair_unabletrainer_64,28207,2956,64,64,327,391,1,65,27957,0,0,0,0
crosshair_unabletrainer_96,28208,2956,96,96,131,227,131,227,27958,0,0,0,0
crosshair_buy_128,28209,2957,128,128,1,129,1,129,27959,0,0,0,0
crosshair_buy_32,28210,2957,32,32,261,293,67,99,27960,0,0,0,0
crosshair_buy_48,28211,2957,48,48,393,441,1,49,27961,0,0,0,0
crosshair_buy_64,28212,2957,64,64,261,325,1,65,27962,0,0,0,0
crosshair_buy_96,28213,2957,96,96,1,97,131,227,27963,0,0,0,0
crosshair_unablebuy_128,28214,2957,128,128,131,259,1,129,27964,0,0,0,0
crosshair_unablebuy_32,28215,2957,32,32,261,293,101,133,27965,0,0,0,0
crosshair_unablebuy_48,28216,2957,48,48,443,491,1,49,27966,0,0,0,0
crosshair_unablebuy_64,28217,2957,64,64,327,391,1,65,27967,0,0,0,0
crosshair_unablebuy_96,28218,2957,96,96,131,227,131,227,27968,0,0,0,0
crosshair_interact_128,28219,2958,128,128,1,129,1,129,27969,0,0,0,0
crosshair_interact_32,28220,2958,32,32,261,293,67,99,27970,0,0,0,0
crosshair_interact_48,28221,2958,48,48,393,441,1,49,27971,0,0,0,0
crosshair_interact_64,28222,2958,64,64,261,325,1,65,27972,0,0,0,0
crosshair_interact_96,28223,2958,96,96,1,97,131,227,27973,0,0,0,0
crosshair_unableinteract_128,28224,2958,128,128,131,259,1,129,27974,0,0,0,0
crosshair_unableinteract_32,28225,2958,32,32,261,293,101,133,27975,0,0,0,0
crosshair_unableinteract_48,28226,2958,48,48,443,491,1,49,27976,0,0,0,0
crosshair_unableinteract_64,28227,2958,64,64,327,391,1,65,27977,0,0,0,0
crosshair_unableinteract_96,28228,2958,96,96,131,227,131,227,27978,0,0,0,0
crosshair_pickup_128,28229,2959,128,128,1,129,1,129,27979,0,0,0,0
crosshair_pickup_32,28230,2959,32,32,261,293,67,99,27980,0,0,0,0
crosshair_pickup_48,28231,2959,48,48,393,441,1,49,27981,0,0,0,0
crosshair_pickup_64,28232,2959,64,64,261,325,1,65,27982,0,0,0,0
crosshair_pickup_96,28233,2959,96,96,1,97,131,227,27983,0,0,0,0
crosshair_unablepickup_128,28234,2959,128,128,131,259,1,129,27984,0,0,0,0
crosshair_unablepickup_32,28235,2959,32,32,261,293,101,133,27985,0,0,0,0
crosshair_unablepickup_48,28236,2959,48,48,443,491,1,49,27986,0,0,0,0
crosshair_unablepickup_64,28237,2959,64,64,327,391,1,65,27987,0,0,0,0
crosshair_unablepickup_96,28238,2959,96,96,131,227,131,227,27988,0,0,0,0
crosshair_questinteract_128,28239,2960,128,128,1,129,1,129,27989,0,0,0,0
crosshair_questinteract_32,28240,2960,32,32,261,293,67,99,27990,0,0,0,0
crosshair_questinteract_48,28241,2960,48,48,393,441,1,49,27991,0,0,0,0
crosshair_questinteract_64,28242,2960,64,64,261,325,1,65,27992,0,0,0,0
crosshair_questinteract_96,28243,2960,96,96,1,97,131,227,27993,0,0,0,0
crosshair_unablequestinteract_128,28244,2960,128,128,131,259,1,129,27994,0,0,0,0
crosshair_unablequestinteract_32,28245,2960,32,32,261,293,101,133,27995,0,0,0,0
crosshair_unablequestinteract_48,28246,2960,48,48,443,491,1,49,27996,0,0,0,0
crosshair_unablequestinteract_64,28247,2960,64,64,327,391,1,65,27997,0,0,0,0
crosshair_unablequestinteract_96,28248,2960,96,96,131,227,131,227,27998,0,0,0,0
delves-companion-progress-fill-blue,28249,2832,166,166,569,735,130,296,27999,0,0,0,0
crosshair_attack_128,28250,2961,128,128,1,129,1,129,28000,0,0,0,0
crosshair_attack_32,28251,2961,32,32,261,293,67,99,28001,0,0,0,0
crosshair_attack_48,28252,2961,48,48,393,441,1,49,28002,0,0,0,0
crosshair_attack_64,28253,2961,64,64,261,325,1,65,28003,0,0,0,0
crosshair_attack_96,28254,2961,96,96,1,97,131,227,28004,0,0,0,0
crosshair_unableattack_128,28255,2961,128,128,131,259,1,129,28005,0,0,0,0
crosshair_unableattack_32,28256,2961,32,32,261,293,101,133,28006,0,0,0,0
crosshair_unableattack_48,28257,2961,48,48,443,491,1,49,28007,0,0,0,0
crosshair_unableattack_64,28258,2961,64,64,327,391,1,65,28008,0,0,0,0
crosshair_unableattack_96,28259,2961,96,96,131,227,131,227,28009,0,0,0,0
crosshair_openhand_128,28260,2962,128,128,1,129,1,129,28010,0,0,0,0
crosshair_openhand_32,28261,2962,32,32,261,293,67,99,28011,0,0,0,0
crosshair_openhand_48,28262,2962,48,48,393,441,1,49,28012,0,0,0,0
crosshair_openhand_64,28263,2962,64,64,261,325,1,65,28013,0,0,0,0
crosshair_openhand_96,28264,2962,96,96,1,97,131,227,28014,0,0,0,0
crosshair_unableopenhand_128,28265,2962,128,128,131,259,1,129,28015,0,0,0,0
crosshair_unableopenhand_32,28266,2962,32,32,261,293,101,133,28016,0,0,0,0
crosshair_unableopenhand_48,28267,2962,48,48,443,491,1,49,28017,0,0,0,0
crosshair_unableopenhand_64,28268,2962,64,64,327,391,1,65,28018,0,0,0,0
crosshair_unableopenhand_96,28269,2962,96,96,131,227,131,227,28019,0,0,0,0
crosshair_openhand_128,28280,2963,128,128,1,129,1,129,28010,0,0,0,0
crosshair_openhand_32,28281,2963,32,32,261,293,67,99,28011,0,0,0,0
crosshair_openhand_48,28282,2963,48,48,393,441,1,49,28012,0,0,0,0
crosshair_openhand_64,28283,2963,64,64,261,325,1,65,28013,0,0,0,0
crosshair_openhand_96,28284,2963,96,96,1,97,131,227,28014,0,0,0,0
crosshair_unableopenhand_128,28285,2963,128,128,131,259,1,129,28015,0,0,0,0
crosshair_unableopenhand_32,28286,2963,32,32,261,293,101,133,28016,0,0,0,0
crosshair_unableopenhand_48,28287,2963,48,48,443,491,1,49,28017,0,0,0,0
crosshair_unableopenhand_64,28288,2963,64,64,327,391,1,65,28018,0,0,0,0
crosshair_unableopenhand_96,28289,2963,96,96,131,227,131,227,28019,0,0,0,0
crosshair_openhandglow_128,28290,2964,128,128,1,129,1,129,28020,0,0,0,0
crosshair_openhandglow_32,28291,2964,32,32,261,293,67,99,28021,0,0,0,0
crosshair_openhandglow_48,28292,2964,48,48,393,441,1,49,28022,0,0,0,0
crosshair_openhandglow_64,28293,2964,64,64,261,325,1,65,28023,0,0,0,0
crosshair_openhandglow_96,28294,2964,96,96,1,97,131,227,28024,0,0,0,0
crosshair_unableopenhandglow_128,28295,2964,128,128,131,259,1,129,28025,0,0,0,0
crosshair_unableopenhandglow_32,28296,2964,32,32,261,293,101,133,28026,0,0,0,0
crosshair_unableopenhandglow_48,28297,2964,48,48,443,491,1,49,28027,0,0,0,0
crosshair_unableopenhandglow_64,28298,2964,64,64,327,391,1,65,28028,0,0,0,0
crosshair_unableopenhandglow_96,28299,2964,96,96,131,227,131,227,28029,0,0,0,0
cursor_picklock_128,28300,2965,128,128,1,129,1,129,28030,0,0,0,0
cursor_picklock_32,28301,2965,32,32,261,293,67,99,28031,0,0,0,0
cursor_picklock_48,28302,2965,48,48,393,441,1,49,28032,0,0,0,0
cursor_picklock_64,28303,2965,64,64,261,325,1,65,28033,0,0,0,0
cursor_picklock_96,28304,2965,96,96,1,97,131,227,28034,0,0,0,0
cursor_unablepicklock_128,28305,2965,128,128,131,259,1,129,28035,0,0,0,0
cursor_unablepicklock_32,28306,2965,32,32,261,293,101,133,28036,0,0,0,0
cursor_unablepicklock_48,28307,2965,48,48,443,491,1,49,28037,0,0,0,0
cursor_unablepicklock_64,28308,2965,64,64,327,391,1,65,28038,0,0,0,0
cursor_unablepicklock_96,28309,2965,96,96,131,227,131,227,28039,0,0,0,0
crosshair_picklock_128,28310,2966,128,128,1,129,1,129,28040,0,0,0,0
crosshair_picklock_32,28311,2966,32,32,261,293,67,99,28041,0,0,0,0
crosshair_picklock_48,28312,2966,48,48,393,441,1,49,28042,0,0,0,0
crosshair_picklock_64,28313,2966,64,64,261,325,1,65,28043,0,0,0,0
crosshair_picklock_96,28314,2966,96,96,1,97,131,227,28044,0,0,0,0
crosshair_unablepicklock_128,28315,2966,128,128,131,259,1,129,28045,0,0,0,0
crosshair_unablepicklock_32,28316,2966,32,32,261,293,101,133,28046,0,0,0,0
crosshair_unablepicklock_48,28317,2966,48,48,443,491,1,49,28047,0,0,0,0
crosshair_unablepicklock_64,28318,2966,64,64,327,391,1,65,28048,0,0,0,0
crosshair_unablepicklock_96,28319,2966,96,96,131,227,131,227,28049,0,0,0,0
crosshair_lock_128,28320,2967,128,128,1,129,1,129,28050,0,0,0,0
crosshair_lock_32,28321,2967,32,32,261,293,67,99,28051,0,0,0,0
crosshair_lock_48,28322,2967,48,48,393,441,1,49,28052,0,0,0,0
crosshair_lock_64,28323,2967,64,64,261,325,1,65,28053,0,0,0,0
crosshair_lock_96,28324,2967,96,96,1,97,131,227,28054,0,0,0,0
crosshair_unablelock_128,28325,2967,128,128,131,259,1,129,28055,0,0,0,0
crosshair_unablelock_32,28326,2967,32,32,261,293,101,133,28056,0,0,0,0
crosshair_unablelock_48,28327,2967,48,48,443,491,1,49,28057,0,0,0,0
crosshair_unablelock_64,28328,2967,64,64,327,391,1,65,28058,0,0,0,0
crosshair_unablelock_96,28329,2967,96,96,131,227,131,227,28059,0,0,0,0
campaign_rocket,28330,2822,608,138,1,609,701,839,28060,0,0,0,0
questbg-rocket,28331,2968,299,407,1,300,1,408,28061,0,0,0,0
shop-card-full-ghastly-charger,28332,2969,568,463,1,569,1,464,28062,0,0,0,0
crosshair_lootall_128,28333,2970,128,128,1,129,1,129,28063,0,0,0,0
crosshair_lootall_32,28334,2970,32,32,261,293,67,99,28064,0,0,0,0
crosshair_lootall_48,28335,2970,48,48,393,441,1,49,28065,0,0,0,0
crosshair_lootall_64,28336,2970,64,64,261,325,1,65,28066,0,0,0,0
crosshair_lootall_96,28337,2970,96,96,1,97,131,227,28067,0,0,0,0
crosshair_unablelootall_128,28338,2970,128,128,131,259,1,129,28068,0,0,0,0
crosshair_unablelootall_32,28339,2970,32,32,261,293,101,133,28069,0,0,0,0
crosshair_unablelootall_48,28340,2970,48,48,443,491,1,49,28070,0,0,0,0
crosshair_unablelootall_64,28341,2970,64,64,327,391,1,65,28071,0,0,0,0
crosshair_unablelootall_96,28342,2970,96,96,131,227,131,227,28072,0,0,0,0
crosshair_point_128,28353,2972,128,128,1,129,1,129,28083,0,0,0,0
crosshair_point_32,28354,2972,32,32,261,293,67,99,28084,0,0,0,0
crosshair_point_48,28355,2972,48,48,393,441,1,49,28085,0,0,0,0
crosshair_point_64,28356,2972,64,64,261,325,1,65,28086,0,0,0,0
crosshair_point_96,28357,2972,96,96,1,97,131,227,28087,0,0,0,0
crosshair_unablepoint_128,28358,2972,128,128,131,259,1,129,28088,0,0,0,0
crosshair_unablepoint_32,28359,2972,32,32,261,293,101,133,28089,0,0,0,0
crosshair_unablepoint_48,28360,2972,48,48,443,491,1,49,28090,0,0,0,0
crosshair_unablepoint_64,28361,2972,64,64,327,391,1,65,28091,0,0,0,0
crosshair_unablepoint_96,28362,2972,96,96,131,227,131,227,28092,0,0,0,0
crosshair_enchant_128,28363,2973,128,128,1,129,1,129,28093,0,0,0,0
crosshair_enchant_32,28364,2973,32,32,261,293,67,99,28094,0,0,0,0
crosshair_enchant_48,28365,2973,48,48,393,441,1,49,28095,0,0,0,0
crosshair_enchant_64,28366,2973,64,64,261,325,1,65,28096,0,0,0,0
crosshair_enchant_96,28367,2973,96,96,1,97,131,227,28097,0,0,0,0
crosshair_unableenchant_128,28368,2973,128,128,131,259,1,129,28098,0,0,0,0
crosshair_unableenchant_32,28369,2973,32,32,261,293,101,133,28099,0,0,0,0
crosshair_unableenchant_48,28370,2973,48,48,443,491,1,49,28100,0,0,0,0
crosshair_unableenchant_64,28371,2973,64,64,327,391,1,65,28101,0,0,0,0
crosshair_unableenchant_96,28372,2973,96,96,131,227,131,227,28102,0,0,0,0
crosshair_cast_128,28373,2971,128,128,1,129,1,129,28103,0,0,0,0
crosshair_cast_32,28374,2971,32,32,261,293,67,99,28104,0,0,0,0
crosshair_cast_48,28375,2971,48,48,393,441,1,49,28105,0,0,0,0
crosshair_cast_64,28376,2971,64,64,261,325,1,65,28106,0,0,0,0
crosshair_cast_96,28377,2971,96,96,1,97,131,227,28107,0,0,0,0
crosshair_unablecast_128,28378,2971,128,128,131,259,1,129,28108,0,0,0,0
crosshair_unablecast_32,28379,2971,32,32,261,293,101,133,28109,0,0,0,0
crosshair_unablecast_48,28380,2971,48,48,443,491,1,49,28110,0,0,0,0
crosshair_unablecast_64,28381,2971,64,64,327,391,1,65,28111,0,0,0,0
crosshair_unablecast_96,28382,2971,96,96,131,227,131,227,28112,0,0,0,0
crosshair_repairnpc_128,28393,2975,128,128,1,129,1,129,28123,0,0,0,0
crosshair_repairnpc_32,28394,2975,32,32,261,293,67,99,28124,0,0,0,0
crosshair_repairnpc_48,28395,2975,48,48,393,441,1,49,28125,0,0,0,0
crosshair_repairnpc_64,28396,2975,64,64,261,325,1,65,28126,0,0,0,0
crosshair_repairnpc_96,28397,2975,96,96,1,97,131,227,28127,0,0,0,0
crosshair_unablerepairnpc_128,28398,2975,128,128,131,259,1,129,28128,0,0,0,0
crosshair_unablerepairnpc_32,28399,2975,32,32,261,293,101,133,28129,0,0,0,0
crosshair_unablerepairnpc_48,28400,2975,48,48,443,491,1,49,28130,0,0,0,0
crosshair_unablerepairnpc_64,28401,2975,64,64,327,391,1,65,28131,0,0,0,0
crosshair_unablerepairnpc_96,28402,2975,96,96,131,227,131,227,28132,0,0,0,0
cursor_repair_128,28403,2976,128,128,1,129,1,129,28133,0,0,0,0
cursor_repair_32,28404,2976,32,32,261,293,67,99,28134,0,0,0,0
cursor_repair_48,28405,2976,48,48,393,441,1,49,28135,0,0,0,0
cursor_repair_64,28406,2976,64,64,261,325,1,65,28136,0,0,0,0
cursor_repair_96,28407,2976,96,96,1,97,131,227,28137,0,0,0,0
cursor_unablerepair_128,28408,2976,128,128,131,259,1,129,28138,0,0,0,0
cursor_unablerepair_32,28409,2976,32,32,261,293,101,133,28139,0,0,0,0
cursor_unablerepair_48,28410,2976,48,48,443,491,1,49,28140,0,0,0,0
cursor_unablerepair_64,28411,2976,64,64,327,391,1,65,28141,0,0,0,0
cursor_unablerepair_96,28412,2976,96,96,131,227,131,227,28142,0,0,0,0
crosshair_repair_128,28413,2977,128,128,1,129,1,129,28143,0,0,0,0
crosshair_repair_32,28414,2977,32,32,261,293,67,99,28144,0,0,0,0
crosshair_repair_48,28415,2977,48,48,393,441,1,49,28145,0,0,0,0
crosshair_repair_64,28416,2977,64,64,261,325,1,65,28146,0,0,0,0
crosshair_repair_96,28417,2977,96,96,1,97,131,227,28147,0,0,0,0
crosshair_unablerepair_128,28418,2977,128,128,131,259,1,129,28148,0,0,0,0
crosshair_unablerepair_32,28419,2977,32,32,261,293,101,133,28149,0,0,0,0
crosshair_unablerepair_48,28420,2977,48,48,443,491,1,49,28150,0,0,0,0
crosshair_unablerepair_64,28421,2977,64,64,327,391,1,65,28151,0,0,0,0
crosshair_unablerepair_96,28422,2977,96,96,131,227,131,227,28152,0,0,0,0
cursor_transmogrify_128,28423,2978,128,128,1,129,1,129,28153,0,0,0,0
cursor_transmogrify_128,28424,2978,0,0,1,1,229,229,28153,0,0,0,0
cursor_transmogrify_32,28425,2978,32,32,261,293,67,99,28154,0,0,0,0
cursor_transmogrify_48,28426,2978,48,48,393,441,1,49,28155,0,0,0,0
cursor_transmogrify_64,28427,2978,64,64,261,325,1,65,28156,0,0,0,0
cursor_transmogrify_96,28428,2978,96,96,1,97,131,227,28157,0,0,0,0
cursor_unabletransmogrify_128,28429,2978,128,128,131,259,1,129,28158,0,0,0,0
cursor_unabletransmogrify_32,28430,2978,32,32,261,293,101,133,28159,0,0,0,0
cursor_unabletransmogrify_48,28431,2978,48,48,443,491,1,49,28160,0,0,0,0
cursor_unabletransmogrify_64,28432,2978,64,64,327,391,1,65,28161,0,0,0,0
cursor_unabletransmogrify_96,28433,2978,96,96,131,227,131,227,28162,0,0,0,0
crosshair_transmogrify_128,28434,2979,128,128,1,129,1,129,28163,0,0,0,0
crosshair_transmogrify_32,28435,2979,32,32,261,293,67,99,28164,0,0,0,0
crosshair_transmogrify_48,28436,2979,48,48,393,441,1,49,28165,0,0,0,0
crosshair_transmogrify_64,28437,2979,64,64,261,325,1,65,28166,0,0,0,0
crosshair_transmogrify_96,28438,2979,96,96,1,97,131,227,28167,0,0,0,0
crosshair_unabletransmogrify_128,28439,2979,128,128,131,259,1,129,28168,0,0,0,0
crosshair_unabletransmogrify_32,28440,2979,32,32,261,293,101,133,28169,0,0,0,0
crosshair_unabletransmogrify_48,28441,2979,48,48,443,491,1,49,28170,0,0,0,0
crosshair_unabletransmogrify_64,28442,2979,64,64,327,391,1,65,28171,0,0,0,0
crosshair_unabletransmogrify_96,28443,2979,96,96,131,227,131,227,28172,0,0,0,0
activities-bar-fill-bonus,28466,1939,660,31,1250,1910,865,896,28194,0,0,0,0
questlog-questtypeicon-account-2x,28492,2984,36,36,139,175,1,37,23781,0,0,0,0
questlog-questtypeicon-alliance-2x,28493,2984,36,36,177,213,1,37,23782,0,0,0,0
questlog-questtypeicon-class-2x,28494,2984,36,36,215,251,1,37,23783,0,0,0,0
questlog-questtypeicon-clockorange-2x,28495,2984,44,44,1,45,1,45,24341,0,0,0,0
questlog-questtypeicon-clockyellow-2x,28496,2984,44,44,47,91,1,45,24342,0,0,0,0
questlog-questtypeicon-daily-2x,28497,2984,36,36,1,37,47,83,23784,0,0,0,0
questlog-questtypeicon-delves-2x,28498,2984,36,36,1,37,85,121,27511,0,0,0,0
questlog-questtypeicon-dungeon-2x,28499,2984,36,36,1,37,123,159,23785,0,0,0,0
questlog-questtypeicon-group-2x,28500,2984,36,36,1,37,161,197,23786,0,0,0,0
questlog-questtypeicon-heroic-2x,28501,2984,36,36,1,37,199,235,23787,0,0,0,0
questlog-questtypeicon-horde-2x,28502,2984,36,36,39,75,47,83,23788,0,0,0,0
questlog-questtypeicon-important-2x,28503,2984,36,36,39,75,85,121,24343,0,0,0,0
questlog-questtypeicon-importantturnin-2x,28504,2984,36,36,39,75,123,159,24344,0,0,0,0
questlog-questtypeicon-legendary-2x,28505,2984,36,36,39,75,161,197,23789,0,0,0,0
questlog-questtypeicon-legendaryturnin-2x,28506,2984,36,36,39,75,199,235,23790,0,0,0,0
questlog-questtypeicon-lock-2x,28507,2984,36,36,77,113,47,83,23791,0,0,0,0
questlog-questtypeicon-monthly-2x,28508,2984,36,36,115,151,47,83,23792,0,0,0,0
questlog-questtypeicon-pvp-2x,28509,2984,36,36,153,189,47,83,23793,0,0,0,0
questlog-questtypeicon-quest-2x,28510,2984,36,36,191,227,47,83,23794,0,0,0,0
questlog-questtypeicon-questfailed-2x,28511,2984,36,36,77,113,85,121,23795,0,0,0,0
questlog-questtypeicon-raid-2x,28512,2984,36,36,77,113,123,159,23796,0,0,0,0
questlog-questtypeicon-repeatable-2x,28513,2984,36,36,77,113,161,197,26090,0,0,0,0
questlog-questtypeicon-repeatableturnin-2x,28514,2984,36,36,77,113,199,235,26091,0,0,0,0
questlog-questtypeicon-scenario-2x,28515,2984,36,36,115,151,85,121,23797,0,0,0,0
questlog-questtypeicon-story-2x,28516,2984,36,36,153,189,85,121,23798,0,0,0,0
questlog-questtypeicon-weekly-2x,28517,2984,36,36,191,227,85,121,23799,0,0,0,0
questlog-questtypeicon-wrapper-2x,28518,2984,36,36,115,151,123,159,25478,0,0,0,0
questlog-questtypeicon-wrapperturnin-2x,28519,2984,36,36,115,151,161,197,25479,0,0,0,0
questlog-storylineicon-2x,28520,2984,44,44,93,137,1,45,25930,0,0,0,0
streamcinematic-generic-large-down,28521,2707,246,135,1,247,412,547,28213,0,0,0,0
streamcinematic-generic-large-up,28522,2707,246,135,249,495,412,547,28214,0,0,0,0
ui-worldmaparrow-2x,28524,2986,64,64,1,65,1,65,28217,0,0,0,0
cursor_innkeeper_128,28525,2987,128,128,1,129,1,129,28218,0,0,0,0
cursor_innkeeper_32,28526,2987,32,32,261,293,67,99,28219,0,0,0,0
cursor_innkeeper_48,28527,2987,48,48,393,441,1,49,28220,0,0,0,0
cursor_innkeeper_64,28528,2987,64,64,261,325,1,65,28221,0,0,0,0
cursor_innkeeper_96,28529,2987,96,96,1,97,131,227,28222,0,0,0,0
cursor_unableinnkeeper_128,28530,2987,128,128,131,259,1,129,28223,0,0,0,0
cursor_unableinnkeeper_32,28531,2987,32,32,261,293,101,133,28224,0,0,0,0
cursor_unableinnkeeper_48,28532,2987,48,48,443,491,1,49,28225,0,0,0,0
cursor_unableinnkeeper_64,28533,2987,64,64,327,391,1,65,28226,0,0,0,0
cursor_unableinnkeeper_96,28534,2987,96,96,131,227,131,227,28227,0,0,0,0
crosshair_innkeeper_128,28535,2988,128,128,1,129,1,129,28228,0,0,0,0
crosshair_innkeeper_32,28536,2988,32,32,261,293,67,99,28229,0,0,0,0
crosshair_innkeeper_48,28537,2988,48,48,393,441,1,49,28230,0,0,0,0
crosshair_innkeeper_64,28538,2988,64,64,261,325,1,65,28231,0,0,0,0
crosshair_innkeeper_96,28539,2988,96,96,1,97,131,227,28232,0,0,0,0
crosshair_unableinnkeeper_128,28540,2988,128,128,131,259,1,129,28233,0,0,0,0
crosshair_unableinnkeeper_32,28541,2988,32,32,261,293,101,133,28234,0,0,0,0
crosshair_unableinnkeeper_48,28542,2988,48,48,443,491,1,49,28235,0,0,0,0
crosshair_unableinnkeeper_64,28543,2988,64,64,327,391,1,65,28236,0,0,0,0
crosshair_unableinnkeeper_96,28544,2988,96,96,131,227,131,227,28237,0,0,0,0
perks-theme-20thanniversary-tl-box,28565,2991,222,292,1,223,341,633,28238,0,0,0,0
perks-theme-20thanniversary-tl-top,28566,2991,802,163,1,803,1,164,28239,0,0,0,0
perks-theme-20thanniversary-tp-bottombig,28567,2991,529,173,1,530,166,339,28240,0,0,0,0
perks-theme-20thanniversary-tp-bottomsmall,28568,2991,362,79,225,587,453,532,28241,0,0,0,0
perks-theme-20thanniversary-tp-topbig,28569,2991,529,110,225,754,341,451,28242,0,0,0,0
perks-theme-20thanniversary-tp-topsmall,28570,2991,362,135,532,894,166,301,28243,0,0,0,0
perks-theme-loveisintheair-tl-box,28571,2992,220,290,1,221,337,627,28244,0,0,0,0
perks-theme-loveisintheair-tl-top,28572,2992,801,161,1,802,1,162,28245,0,0,0,0
perks-theme-loveisintheair-tp-bottombig,28573,2992,527,171,1,528,164,335,28246,0,0,0,0
perks-theme-loveisintheair-tp-bottomsmall,28574,2992,360,77,223,583,447,524,28247,0,0,0,0
perks-theme-loveisintheair-tp-topbig,28575,2992,527,108,223,750,337,445,28248,0,0,0,0
perks-theme-loveisintheair-tp-topsmall,28576,2992,360,133,530,890,164,297,28249,0,0,0,0
campaign-questlog-lorebackground-accessibility,28577,1566,307,510,1,308,513,1023,28250,0,0,0,0
campaign-questlog-lorebackground-accessibility2,28578,1566,307,510,310,617,1,511,28251,0,0,0,0
campaign-questlog-lorebackground-accessibility3,28579,1566,307,510,310,617,513,1023,28252,0,0,0,0
campaign-questlog-lorebackground-accessibility4,28580,1566,307,510,619,926,1,511,28253,0,0,0,0
campaign-questlog-loredivider-accessibility,28581,1566,285,58,619,904,641,699,28254,0,0,0,0
campaign-questlog-lorebackground-accessibility-2x,28582,2773,614,1020,1,615,1023,2043,28255,0,0,0,0
campaign-questlog-lorebackground-accessibility2-2x,28583,2773,614,1020,617,1231,1,1021,28256,0,0,0,0
campaign-questlog-lorebackground-accessibility3-2x,28584,2773,614,1020,617,1231,1023,2043,28257,0,0,0,0
campaign-questlog-lorebackground-accessibility4-2x,28585,2773,614,1020,1233,1847,1,1021,28258,0,0,0,0
campaign-questlog-loredivider-accessibility-2x,28586,2773,570,116,1233,1803,1275,1391,28259,0,0,0,0
cursor_crosshairs_128,28587,2993,128,128,1,129,1,129,28260,0,0,0,0
cursor_crosshairs_32,28588,2993,32,32,261,293,67,99,28261,0,0,0,0
cursor_crosshairs_48,28589,2993,48,48,393,441,1,49,28262,0,0,0,0
cursor_crosshairs_64,28590,2993,64,64,261,325,1,65,28263,0,0,0,0
cursor_crosshairs_96,28591,2993,96,96,1,97,131,227,28264,0,0,0,0
cursor_unablecrosshairs_128,28592,2993,128,128,131,259,1,129,28265,0,0,0,0
cursor_unablecrosshairs_32,28593,2993,32,32,261,293,101,133,28266,0,0,0,0
cursor_unablecrosshairs_48,28594,2993,48,48,443,491,1,49,28267,0,0,0,0
cursor_unablecrosshairs_64,28595,2993,64,64,327,391,1,65,28268,0,0,0,0
cursor_unablecrosshairs_96,28596,2993,96,96,131,227,131,227,28269,0,0,0,0
crosshair_crosshairs_128,28597,2994,128,128,1,129,1,129,28270,0,0,0,0
crosshair_crosshairs_32,28598,2994,32,32,261,293,67,99,28271,0,0,0,0
crosshair_crosshairs_48,28599,2994,48,48,393,441,1,49,28272,0,0,0,0
crosshair_crosshairs_64,28600,2994,64,64,261,325,1,65,28273,0,0,0,0
crosshair_crosshairs_96,28601,2994,96,96,1,97,131,227,28274,0,0,0,0
crosshair_unablecrosshairs_128,28602,2994,128,128,131,259,1,129,28275,0,0,0,0
crosshair_unablecrosshairs_32,28603,2994,32,32,261,293,101,133,28276,0,0,0,0
crosshair_unablecrosshairs_48,28604,2994,48,48,443,491,1,49,28277,0,0,0,0
crosshair_unablecrosshairs_64,28605,2994,64,64,327,391,1,65,28278,0,0,0,0
crosshair_unablecrosshairs_96,28606,2994,96,96,131,227,131,227,28279,0,0,0,0
crosshair_directions_128,28607,2995,128,128,1,129,1,129,28280,0,0,0,0
crosshair_directions_32,28608,2995,32,32,261,293,67,99,28281,0,0,0,0
crosshair_directions_48,28609,2995,48,48,393,441,1,49,28282,0,0,0,0
crosshair_directions_64,28610,2995,64,64,261,325,1,65,28283,0,0,0,0
crosshair_directions_96,28611,2995,96,96,1,97,131,227,28284,0,0,0,0
crosshair_unabledirections_128,28612,2995,128,128,131,259,1,129,28285,0,0,0,0
crosshair_unabledirections_32,28613,2995,32,32,261,293,101,133,28286,0,0,0,0
crosshair_unabledirections_48,28614,2995,48,48,443,491,1,49,28287,0,0,0,0
crosshair_unabledirections_64,28615,2995,64,64,327,391,1,65,28288,0,0,0,0
crosshair_unabledirections_96,28616,2995,96,96,131,227,131,227,28289,0,0,0,0
cursor_directions_128,28617,2996,128,128,1,129,1,129,28290,0,0,0,0
cursor_directions_32,28618,2996,32,32,261,293,67,99,28291,0,0,0,0
cursor_directions_48,28619,2996,48,48,393,441,1,49,28292,0,0,0,0
cursor_directions_64,28620,2996,64,64,261,325,1,65,28293,0,0,0,0
cursor_directions_96,28621,2996,96,96,1,97,131,227,28294,0,0,0,0
cursor_unabledirections_128,28622,2996,128,128,131,259,1,129,28295,0,0,0,0
cursor_unabledirections_32,28623,2996,32,32,261,293,101,133,28296,0,0,0,0
cursor_unabledirections_48,28624,2996,48,48,443,491,1,49,28297,0,0,0,0
cursor_unabledirections_64,28625,2996,64,64,327,391,1,65,28298,0,0,0,0
cursor_unabledirections_96,28626,2996,96,96,131,227,131,227,28299,0,0,0,0
crosshair_speak_128,28627,2997,128,128,1,129,1,129,28300,0,0,0,0
crosshair_speak_32,28628,2997,32,32,261,293,67,99,28301,0,0,0,0
crosshair_speak_48,28629,2997,48,48,393,441,1,49,28302,0,0,0,0
crosshair_speak_64,28630,2997,64,64,261,325,1,65,28303,0,0,0,0
crosshair_speak_96,28631,2997,96,96,1,97,131,227,28304,0,0,0,0
crosshair_unablespeak_128,28632,2997,128,128,131,259,1,129,28305,0,0,0,0
crosshair_unablespeak_32,28633,2997,32,32,261,293,101,133,28306,0,0,0,0
crosshair_unablespeak_48,28634,2997,48,48,443,491,1,49,28307,0,0,0,0
crosshair_unablespeak_64,28635,2997,64,64,327,391,1,65,28308,0,0,0,0
crosshair_unablespeak_96,28636,2997,96,96,131,227,131,227,28309,0,0,0,0
cursor_speak_128,28637,2998,128,128,1,129,1,129,28310,0,0,0,0
cursor_speak_32,28638,2998,32,32,261,293,67,99,28311,0,0,0,0
cursor_speak_48,28639,2998,48,48,393,441,1,49,28312,0,0,0,0
cursor_speak_64,28640,2998,64,64,261,325,1,65,28313,0,0,0,0
cursor_speak_96,28641,2998,96,96,1,97,131,227,28314,0,0,0,0
cursor_unablespeak_128,28642,2998,128,128,131,259,1,129,28315,0,0,0,0
cursor_unablespeak_48,28643,2998,48,48,443,491,1,49,28316,0,0,0,0
cursor_unablespeak_64,28644,2998,64,64,327,391,1,65,28317,0,0,0,0
cursor_unablespeak_96,28645,2998,96,96,131,227,131,227,28318,0,0,0,0
splash-1105-2-botleft,28654,2999,137,371,374,511,587,958,28327,0,0,0,0
splash-1105-2-right,28655,2999,510,584,1,511,1,585,28328,0,0,0,0
splash-1105-2-topleft,28656,2999,371,434,1,372,587,1021,28329,0,0,0,0
plunderstorm-pickup-arrow,28657,2683,42,74,660,702,1918,1992,28330,0,0,0,0
plunderstorm-pickup-bg,28658,2683,424,90,1401,1825,561,651,28331,0,0,0,0
plunderstorm-pickup-mouseclick-left,28659,2683,82,92,1951,2033,1,93,28332,0,0,0,0
plunderstorm-pickup-mouseclick-right,28660,2683,82,92,1951,2033,95,187,28333,0,0,0,0
cursor_stablemaster_128,28689,3000,128,128,1,129,1,129,28336,0,0,0,0
cursor_stablemaster_32,28690,3000,32,32,261,293,67,99,28337,0,0,0,0
cursor_stablemaster_48,28691,3000,48,48,393,441,1,49,28338,0,0,0,0
cursor_stablemaster_64,28692,3000,64,64,261,325,1,65,28339,0,0,0,0
cursor_stablemaster_96,28693,3000,96,96,1,97,131,227,28340,0,0,0,0
cursor_unablestablemaster_128,28694,3000,128,128,131,259,1,129,28341,0,0,0,0
cursor_unablestablemaster_32,28695,3000,32,32,261,293,101,133,28342,0,0,0,0
cursor_unablestablemaster_48,28696,3000,48,48,443,491,1,49,28343,0,0,0,0
cursor_unablestablemaster_64,28697,3000,64,64,327,391,1,65,28344,0,0,0,0
cursor_unablestablemaster_96,28698,3000,96,96,131,227,131,227,28345,0,0,0,0
crosshair_stablemaster_128,28699,3001,128,128,1,129,1,129,28346,0,0,0,0
crosshair_stablemaster_32,28700,3001,32,32,261,293,67,99,28347,0,0,0,0
crosshair_stablemaster_48,28701,3001,48,48,393,441,1,49,28348,0,0,0,0
crosshair_stablemaster_64,28702,3001,64,64,261,325,1,65,28349,0,0,0,0
crosshair_stablemaster_96,28703,3001,96,96,1,97,131,227,28350,0,0,0,0
crosshair_unablestablemaster_128,28704,3001,128,128,131,259,1,129,28351,0,0,0,0
crosshair_unablestablemaster_32,28705,3001,32,32,261,293,101,133,28352,0,0,0,0
crosshair_unablestablemaster_48,28706,3001,48,48,443,491,1,49,28353,0,0,0,0
crosshair_unablestablemaster_64,28707,3001,64,64,327,391,1,65,28354,0,0,0,0
crosshair_unablestablemaster_96,28708,3001,96,96,131,227,131,227,28355,0,0,0,0
128-redbutton-visibilityoff-disabled,28709,2895,128,128,131,259,261,389,28356,0,0,0,0
128-redbutton-visibilityoff-highlight,28710,2895,128,128,261,389,1,129,28357,0,0,0,0
128-redbutton-visibilityoff-pressed,28711,2895,128,128,261,389,131,259,28358,0,0,0,0
128-redbutton-visibilityoff,28712,2895,128,128,131,259,131,259,28359,0,0,0,0
128-redbutton-visibilityon-disabled,28713,2895,128,128,391,519,1,129,28360,0,0,0,0
128-redbutton-visibilityon-highlight,28714,2895,128,128,391,519,131,259,28361,0,0,0,0
128-redbutton-visibilityon-pressed,28715,2895,128,128,391,519,261,389,28362,0,0,0,0
128-redbutton-visibilityon,28716,2895,128,128,261,389,261,389,28363,0,0,0,0
ui-eventpoi-cave,28717,2897,32,32,69,101,1,33,28364,0,0,0,0
ui-eventpoi-cave-2x,28718,2908,64,64,67,131,1,65,28364,0,0,0,0
subsupgrade-banner-currentexpansion-bg,28719,3002,287,364,1,288,1,365,28368,0,0,0,0
subsupgrade-banner-currentexpansion-short-bg,28720,3002,287,190,1,288,733,923,28369,0,0,0,0
subsupgrade-banner-generic-bg,28721,3002,287,364,1,288,367,731,28370,0,0,0,0
subsupgrade-banner-generic-short-bg,28722,3002,287,190,598,885,1,191,28371,0,0,0,0
subsupgrade-banner-itemframe,28723,3002,42,42,1,43,966,1008,28372,0,0,0,0
subsupgrade-banner-trial-bg,28724,3002,172,39,1,173,925,964,28373,0,0,0,0
subsupgrade-banner-currentexpansion-bg-2x,28725,3003,574,728,1,575,1,729,28368,0,0,0,0
subsupgrade-banner-currentexpansion-short-bg-2x,28726,3003,574,380,1,575,1461,1841,28369,0,0,0,0
subsupgrade-banner-generic-bg-2x,28727,3003,574,728,1,575,731,1459,28370,0,0,0,0
subsupgrade-banner-generic-short-bg-2x,28728,3003,574,380,1191,1765,1,381,28371,0,0,0,0
subsupgrade-banner-itemframe-2x,28729,3003,84,84,1,85,1923,2007,28372,0,0,0,0
subsupgrade-banner-trial-bg-2x,28730,3003,344,78,1,345,1843,1921,28373,0,0,0,0
glues-characterselect-button-collapseexpand-down-small-disabled,28731,2726,29,29,993,1022,181,210,28374,0,0,0,0
glues-characterselect-button-collapseexpand-small-hover,28732,2726,29,29,317,346,987,1016,28375,0,0,0,0
glues-characterselect-button-collapseexpand-small-pressed,28733,2726,29,29,350,379,692,721,28376,0,0,0,0
glues-characterselect-button-collapseexpand-small,28734,2726,29,29,317,346,956,985,28377,0,0,0,0
glues-characterselect-button-collapseexpand-up-small-disabled,28735,2726,29,29,350,379,723,752,28378,0,0,0,0
glues-characterselect-icon-arrowdown-small-hover,28736,2726,29,29,350,379,785,814,28379,0,0,0,0
glues-characterselect-icon-arrowdown-small-pressed,28737,2726,29,29,350,379,816,845,28380,0,0,0,0
glues-characterselect-icon-arrowdown-small,28738,2726,29,29,350,379,754,783,28381,0,0,0,0
glues-characterselect-icon-arrowup-small-hover,28739,2726,29,29,350,379,878,907,28382,0,0,0,0
glues-characterselect-icon-arrowup-small-pressed,28740,2726,29,29,350,379,909,938,28383,0,0,0,0
glues-characterselect-icon-arrowup-small,28741,2726,29,29,350,379,847,876,28384,0,0,0,0
glues-characterselect-button-collapseexpand-down-small-disabled-2x,28742,2727,58,58,1987,2045,987,1045,28374,0,0,0,0
glues-characterselect-button-collapseexpand-small-2x,28743,2727,58,58,725,783,1935,1993,28377,0,0,0,0
glues-characterselect-button-collapseexpand-small-hover-2x,28744,2727,58,58,791,849,1291,1349,28375,0,0,0,0
glues-characterselect-button-collapseexpand-small-pressed-2x,28745,2727,58,58,791,849,1351,1409,28376,0,0,0,0
glues-characterselect-button-collapseexpand-up-small-disabled-2x,28746,2727,58,58,791,849,1411,1469,28378,0,0,0,0
glues-characterselect-icon-arrowdown-small-2x,28747,2727,58,58,791,849,1471,1529,28381,0,0,0,0
glues-characterselect-icon-arrowdown-small-hover-2x,28748,2727,58,58,791,849,1531,1589,28379,0,0,0,0
glues-characterselect-icon-arrowdown-small-pressed-2x,28749,2727,58,58,791,849,1591,1649,28380,0,0,0,0
glues-characterselect-icon-arrowup-small-2x,28750,2727,58,58,791,849,1651,1709,28384,0,0,0,0
glues-characterselect-icon-arrowup-small-hover-2x,28751,2727,58,58,791,849,1711,1769,28382,0,0,0,0
glues-characterselect-icon-arrowup-small-pressed-2x,28752,2727,58,58,791,849,1771,1829,28383,0,0,0,0
subsupgrade-banner-currentexpansion-logo,28753,3002,306,230,290,596,1,231,28385,0,0,0,0
subsupgrade-banner-generic-logo,28754,3002,247,106,290,537,233,339,28386,0,0,0,0
subsupgrade-banner-currentexpansion-logo-2x,28755,3003,612,460,577,1189,1,461,28385,0,0,0,0
subsupgrade-banner-generic-logo-2x,28756,3003,494,212,577,1071,463,675,28386,0,0,0,0
stablemaster,28757,647,32,32,513,545,783,815,5079,0,0,0,0
tokens-changefaction-regular-2x,28758,2848,112,112,259,371,229,341,27246,0,0,0,0
glues-characterselect-icon-appearancechange-hover,28759,2726,58,58,128,186,635,693,28387,0,0,0,0
glues-characterselect-icon-appearancechange,28760,2726,58,58,947,1005,349,407,28388,0,0,0,0
glues-characterselect-icon-factionchange-hover,28761,2726,58,58,1,59,955,1013,28389,0,0,0,0
glues-characterselect-icon-factionchange,28762,2726,58,58,128,186,695,753,28390,0,0,0,0
glues-characterselect-icon-racechange-hover,28763,2726,58,58,121,179,955,1013,28391,0,0,0,0
glues-characterselect-icon-racechange,28764,2726,58,58,61,119,955,1013,28392,0,0,0,0
glues-characterselect-icon-appearancechange-2x,28765,2727,116,116,253,369,1257,1373,28388,0,0,0,0
glues-characterselect-icon-appearancechange-hover-2x,28766,2727,116,116,253,369,1375,1491,28387,0,0,0,0
glues-characterselect-icon-factionchange-2x,28767,2727,116,116,381,497,1291,1407,28390,0,0,0,0
glues-characterselect-icon-factionchange-hover-2x,28768,2727,116,116,381,497,1409,1525,28389,0,0,0,0
glues-characterselect-icon-racechange-2x,28769,2727,116,116,381,497,1527,1643,28392,0,0,0,0
glues-characterselect-icon-racechange-hover-2x,28770,2727,116,116,381,497,1645,1761,28391,0,0,0,0
pricestrikethrough-gray,28996,1918,31,9,533,564,843,852,28573,0,0,0,0
ui-eventpoi-ballons-2x,28999,2908,64,64,67,131,133,197,28575,0,0,0,0
ui-eventpoi-ballons,29000,2897,32,32,35,67,1,33,28575,0,0,0,0
shop-card-full-year-of-azeroth-2024-12month,29004,3015,568,463,1,569,1,464,28579,0,0,0,0
shop-card-full-year-of-azeroth-2024-365day,29005,3015,568,463,1,569,466,929,28580,0,0,0,0
shop-card-full-winter-witch,29006,3016,568,463,1,569,1,464,28581,0,0,0,0
chromiemap,29027,647,36,36,203,239,914,950,28706,0,0,0,0
delves-scenario-frame-2x,29135,2843,513,168,1,514,171,339,27576,0,0,0,0
gm-icon-assist-disabled,29137,2703,40,40,833,873,127,167,28850,0,0,0,0
gm-icon-assist-disabled-2x,29138,2702,80,80,1559,1639,247,327,28850,0,0,0,0
shop-card-full-reven-ibelin-charity-pet,29175,3032,568,463,1,569,1,464,28887,0,0,0,0
shop-card-full-anniversary-brutosaur,29176,3033,568,463,1,569,1,464,28888,0,0,0,0
shop-card-full-warcraft30th,29177,3035,568,463,1,569,1,464,28889,0,0,0,0
plunderstorm-icon-kills,29189,2683,65,65,323,388,1505,1570,28901,0,0,0,0
plunderstorm-icon-plundercoins,29190,2683,65,65,323,388,1572,1637,28902,0,0,0,0
plunderstorm-icon-trophy,29191,2683,65,65,323,388,1639,1704,28903,0,0,0,0
plunderstorm-toast-bg-matchcomplete,29192,2683,796,376,1,797,672,1048,28904,0,0,0,0
plunderstorm-toast-bg-queue,29193,2683,796,359,799,1595,672,1031,28905,0,0,0,0
plunderstorm-toast-bg-statdetails,29194,2683,796,669,1,797,1,670,28906,0,0,0,0
plunderstorm-toast-bottomdecal-line,29195,2683,638,2,799,1437,1037,1039,28907,0,0,0,0
plunderstorm-toast-bottomdecal,29196,2683,73,29,1919,1992,998,1027,28908,0,0,0,0
plunderstorm-toast-divider,29197,2683,503,1,799,1302,1041,1042,28909,0,0,0,0
plunderstorm-toast-swords-line,29198,2683,662,2,799,1461,1033,1035,28910,0,0,0,0
plunderstorm-toast-swords,29199,2683,234,105,1,235,1899,2004,28911,0,0,0,0
cursor_unablevehichlecursor_128,29274,2989,128,128,1,129,1,129,28981,0,0,0,0
cursor_unablevehichlecursor_32,29275,2989,32,32,261,293,67,99,28982,0,0,0,0
cursor_unablevehichlecursor_48,29276,2989,48,48,393,441,1,49,28983,0,0,0,0
cursor_unablevehichlecursor_64,29277,2989,64,64,261,325,1,65,28984,0,0,0,0
cursor_unablevehichlecursor_96,29278,2989,96,96,1,97,131,227,28985,0,0,0,0
cursor_vehichlecursor_128,29279,2989,128,128,131,259,1,129,28986,0,0,0,0
cursor_vehichlecursor_32,29280,2989,32,32,261,293,101,133,28987,0,0,0,0
cursor_vehichlecursor_48,29281,2989,48,48,443,491,1,49,28988,0,0,0,0
cursor_vehichlecursor_64,29282,2989,64,64,327,391,1,65,28989,0,0,0,0
cursor_vehichlecursor_96,29283,2989,96,96,131,227,131,227,28990,0,0,0,0
crosshair_unablevehichlecursor_128,29284,2990,128,128,1,129,1,129,28991,0,0,0,0
crosshair_unablevehichlecursor_32,29285,2990,32,32,261,293,67,99,28992,0,0,0,0
crosshair_unablevehichlecursor_48,29286,2990,48,48,393,441,1,49,28993,0,0,0,0
crosshair_unablevehichlecursor_64,29287,2990,64,64,261,325,1,65,28994,0,0,0,0
crosshair_unablevehichlecursor_96,29288,2990,96,96,1,97,131,227,28995,0,0,0,0
crosshair_vehichlecursor_128,29289,2990,128,128,131,259,1,129,28996,0,0,0,0
crosshair_vehichlecursor_32,29290,2990,32,32,261,293,101,133,28997,0,0,0,0
crosshair_vehichlecursor_48,29291,2990,48,48,443,491,1,49,28998,0,0,0,0
crosshair_vehichlecursor_64,29292,2990,64,64,327,391,1,65,28999,0,0,0,0
crosshair_vehichlecursor_96,29293,2990,96,96,131,227,131,227,29000,0,0,0,0
cursor_unablespeak_32,29294,2998,32,32,261,293,101,133,29001,0,0,0,0
cursor_repairnpc_128,29295,2974,128,128,1,129,1,129,28118,0,0,0,0
cursor_repairnpc_32,29296,2974,32,32,261,293,67,99,28119,0,0,0,0
cursor_repairnpc_48,29297,2974,48,48,393,441,1,49,28120,0,0,0,0
cursor_repairnpc_64,29298,2974,64,64,261,325,1,65,28121,0,0,0,0
cursor_repairnpc_96,29299,2974,96,96,1,97,131,227,28122,0,0,0,0
cursor_unablerepairnpc_128,29300,2974,128,128,131,259,1,129,29002,0,0,0,0
cursor_unablerepairnpc_32,29301,2974,32,32,261,293,101,133,29003,0,0,0,0
cursor_unablerepairnpc_48,29302,2974,48,48,443,491,1,49,29004,0,0,0,0
cursor_unablerepairnpc_64,29303,2974,64,64,327,391,1,65,29005,0,0,0,0
cursor_unablerepairnpc_96,29304,2974,96,96,131,227,131,227,29006,0,0,0,0
common-dropdown-a-button-disabled-shadowless,29305,2634,27,27,175,202,115,142,29007,0,0,0,0
common-dropdown-a-button-hover-shadowless,29306,2634,27,27,175,202,144,171,29008,0,0,0,0
common-dropdown-a-button-open-shadowless,29307,2634,27,27,175,202,173,200,29009,0,0,0,0
common-dropdown-a-button-pressed-shadowless,29308,2634,27,27,175,202,202,229,29010,0,0,0,0
common-dropdown-a-button-pressedhover-shadowless,29309,2634,27,27,204,231,57,84,29011,0,0,0,0
common-dropdown-a-button-shadowless,29310,2634,27,27,204,231,86,113,29012,0,0,0,0
common-dropdown-a-button-disabled-shadowless-2x,29311,2658,54,54,353,407,345,399,29007,0,0,0,0
common-dropdown-a-button-hover-shadowless-2x,29312,2658,54,54,409,463,345,399,29008,0,0,0,0
common-dropdown-a-button-open-shadowless-2x,29313,2658,54,54,353,407,401,455,29009,0,0,0,0
common-dropdown-a-button-pressed-shadowless-2x,29314,2658,54,54,353,407,457,511,29010,0,0,0,0
common-dropdown-a-button-pressedhover-shadowless-2x,29315,2658,54,54,409,463,401,455,29011,0,0,0,0
common-dropdown-a-button-shadowless-2x,29316,2658,54,54,409,463,457,511,29012,0,0,0,0
plunderstorm-glues-queueselector-training-selected,29317,2680,152,152,539,691,1391,1543,29013,76,76,0,0
plunderstorm-glues-queueselector-training,29318,2680,152,152,539,691,1545,1697,29014,76,76,0,0
plunderstorm-icon-plundercoins-big,29319,2683,70,70,323,393,1433,1503,29015,0,0,0,0
plunderstorm-pvpqueue-background,29320,2683,392,381,1,393,1050,1431,29016,0,0,0,0
plunderstorm-pvpqueue-catergory-icon,29321,2683,104,104,1919,2023,892,996,29017,0,0,0,0
plunderstorm-pvpqueue-sidebar-background,29322,2683,160,375,717,877,1596,1971,29018,0,0,0,0
ui-frame-neutral-disablesubtitle,29323,1255,207,30,1,208,959,989,29019,0,0,0,0
ui-frame-neutral-subtitle,29324,1255,207,30,1,208,991,1021,29020,0,0,0,0
ping_groundmarker_bg_threat,29344,2501,58,58,61,119,959,1017,29040,0,0,0,0
ping_groundmarker_pin_threat,29345,2501,4,114,421,425,887,1001,29041,0,0,0,0
ping_groundmarker_stroke_threat,29346,2501,58,58,121,179,779,837,29042,0,0,0,0
ping_groundmarker_bg_threat-2x,29347,2507,116,116,119,235,1905,2021,29040,0,0,0,0
ping_groundmarker_pin_threat-2x,29348,2507,8,228,785,793,1745,1973,29041,0,0,0,0
ping_groundmarker_stroke_threat-2x,29349,2507,116,116,237,353,1551,1667,29042,0,0,0,0
plunderstorm-map-zonegreen,29364,3044,183,183,1,184,1,184,29056,0,0,0,0
plunderstorm-map-zonered,29365,3044,183,183,556,739,1,184,29057,0,0,0,0
plunderstorm-map-zoneyellow,29366,3044,183,183,1,184,741,924,29058,0,0,0,0
plunderstorm-map-zonegreen-hover,29367,3044,183,183,186,369,1,184,29059,0,0,0,0
plunderstorm-map-zonegreen-pressed,29368,3044,183,183,371,554,1,184,29060,0,0,0,0
plunderstorm-map-zonered-hover,29369,3044,183,183,741,924,1,184,29061,0,0,0,0
plunderstorm-map-zonered-pressed,29370,3044,183,183,1,184,186,369,29062,0,0,0,0
plunderstorm-map-zoneselected,29371,3044,183,183,1,184,371,554,29063,0,0,0,0
plunderstorm-map-zoneyellow-hover,29372,3044,183,183,186,369,186,369,29064,0,0,0,0
plunderstorm-map-zoneyellow-pressed,29373,3044,183,183,371,554,186,369,29065,0,0,0,0
plunderstorm-menu-cannon-hover,29392,3046,160,160,1,161,251,411,29067,0,0,0,0
plunderstorm-menu-cannon-selected-hover,29393,3046,160,160,163,323,251,411,29068,0,0,0,0
plunderstorm-menu-cannon-selected,29394,3046,160,160,163,323,89,249,29069,0,0,0,0
plunderstorm-menu-cannon,29395,3046,160,160,1,161,89,249,29070,0,0,0,0
plunderstorm-menu-customize-hover,29396,3046,84,84,497,581,1,85,29071,0,0,0,0
plunderstorm-menu-customize-selected-hover,29397,3046,84,84,669,753,1,85,29072,0,0,0,0
plunderstorm-menu-customize-selected,29398,3046,84,84,583,667,1,85,29073,0,0,0,0
plunderstorm-menu-customize,29399,3046,84,84,411,495,1,85,29074,0,0,0,0
plunderstorm-menu-shop-hover,29400,3046,84,84,841,925,1,85,29075,0,0,0,0
plunderstorm-menu-shop-selected-hover,29401,3046,84,84,1,85,413,497,29076,0,0,0,0
plunderstorm-menu-shop-selected,29402,3046,84,84,927,1011,1,85,29077,0,0,0,0
plunderstorm-menu-shop,29403,3046,84,84,755,839,1,85,29078,0,0,0,0
plunderstorm-menu-swords-hover,29404,3046,160,160,325,485,251,411,29079,0,0,0,0
plunderstorm-menu-swords-selected-hover,29405,3046,160,160,487,647,251,411,29080,0,0,0,0
plunderstorm-menu-swords-selected,29406,3046,160,160,487,647,89,249,29081,0,0,0,0
plunderstorm-menu-swords,29407,3046,160,160,325,485,89,249,29082,0,0,0,0
plunderstorm-top-menu-frame,29408,3046,408,86,1,409,1,87,29083,0,0,0,0
shop-card-full-anniversary-brutosaur-bundle,29411,3049,568,463,1,569,1,464,29086,0,0,0,0
plunderstorm-map-icongreen-hover,29412,3044,85,85,926,1011,88,173,29088,0,0,0,0
plunderstorm-map-icongreen-pressed,29413,3044,85,85,1,86,926,1011,29089,0,0,0,0
plunderstorm-map-icongreen,29414,3044,85,85,926,1011,1,86,29090,0,0,0,0
plunderstorm-map-icongreenselected-hover,29415,3044,85,85,556,641,186,271,29091,0,0,0,0
plunderstorm-map-icongreenselected,29416,3044,85,85,88,173,926,1011,29092,0,0,0,0
plunderstorm-map-iconred-hover,29417,3044,85,85,643,728,186,271,29093,0,0,0,0
plunderstorm-map-iconred-pressed,29418,3044,85,85,643,728,273,358,29094,0,0,0,0
plunderstorm-map-iconred,29419,3044,85,85,556,641,273,358,29095,0,0,0,0
plunderstorm-map-iconredselected-hover,29420,3044,85,85,730,815,273,358,29096,0,0,0,0
plunderstorm-map-iconredselected,29421,3044,85,85,730,815,186,271,29097,0,0,0,0
plunderstorm-map-iconyellow-hover,29422,3044,85,85,817,902,273,358,29098,0,0,0,0
plunderstorm-map-iconyellow-pressed,29423,3044,85,85,904,989,186,271,29099,0,0,0,0
plunderstorm-map-iconyellow,29424,3044,85,85,817,902,186,271,29100,0,0,0,0
plunderstorm-map-iconyellowselected-hover,29425,3044,85,85,186,271,371,456,29101,0,0,0,0
plunderstorm-map-iconyellowselected,29426,3044,85,85,904,989,273,358,29102,0,0,0,0
plunderstorm-map-zoneselected-hover,29427,3044,183,183,1,184,556,739,29103,0,0,0,0
glues-gamemode-bg,29795,2726,77,77,192,269,852,929,29335,0,0,0,0
glues-gamemode-glw-bottom,29796,2726,189,96,1,190,537,633,29336,0,0,0,0
glues-gamemode-glw-top,29797,2726,151,53,1,152,860,913,29337,0,0,0,0
glues-gamemode-selectarrow,29798,2726,50,50,957,1007,446,496,29338,0,0,0,0
glues-gamemode-bg-2x,29799,2727,154,154,159,313,1887,2041,29335,0,0,0,0
glues-gamemode-glw-bottom-2x,29800,2727,378,192,1,379,1063,1255,29336,0,0,0,0
glues-gamemode-glw-top-2x,29801,2727,302,106,1,303,1701,1807,29337,0,0,0,0
glues-gamemode-selectarrow-2x,29802,2727,100,100,1907,2007,883,983,29338,0,0,0,0
splash-1107-1-botleft,29841,3075,137,371,374,511,587,958,29574,0,0,0,0
splash-1107-1-right,29842,3075,510,584,1,511,1,585,29575,0,0,0,0
splash-1107-1-topleft,29843,3075,371,434,1,372,587,1021,29576,0,0,0,0
glues-gamemode-txtbg,29887,2726,163,38,1,164,915,953,29409,0,0,0,0
glues-gamemode-txtbg-2x,29888,2727,326,76,1,327,1809,1885,29409,0,0,0,0
glues-characterselect-icon-arrowdown-disabled-2x,29938,2727,64,64,725,789,1357,1421,29461,0,0,0,0
glues-characterselect-icon-arrowdown-disabled,29939,2726,32,32,272,304,986,1018,29461,0,0,0,0
plunderstorm-new-dot-lg,29941,2683,40,40,1359,1399,527,567,29463,0,0,0,0
plunderstorm-new-dot-sm,29942,2683,34,34,1359,1393,569,603,29464,0,0,0,0
shop-card-full-panda-teleport,30177,3103,568,463,1,569,1,464,29612,0,0,0,0
shop-bundle-365sub-apac,30186,3105,568,463,1,569,1,464,29620,0,0,0,0
shop-bundle-12mosub,30187,3106,568,463,1,569,1,464,29621,0,0,0,0
shop-card-full-1107-365daysub-cn,30259,3112,568,463,1,569,1,464,29658,0,0,0,0
shop-card-full-1107-180daysbundle_apac,30273,3117,568,463,1,569,1,464,29672,0,0,0,0
shop-card-full-1107-6monthsbundle,30275,3119,568,463,1,569,1,464,29674,0,0,0,0
shop-card-full-180daysbundle-cn,30448,3122,568,463,1,569,1,464,29792,0,0,0,0
