CommittedName,ID,UiTextureAtlasID,Width,Height,CommittedLeft,CommittedRight,CommittedTop,CommittedBottom,UiTextureAtlasElementID,OverrideWidth,OverrideHeight,CommittedFlags,UiCanvasID
MainPet-PetFamilyFrame,2009,88,34,34,881,915,987,1021,7931,0,0,0,0
Timer-Frame,2010,88,339,17,521,860,671,688,7932,0,0,0,0
MainPet-HealthBarBG,2011,88,155,47,743,898,767,814,7933,0,0,0,0
Timer-BG,2012,88,473,27,521,994,644,671,7934,0,0,0,0
BackupPet-DeadFrame,2014,88,47,47,943,990,853,900,7935,0,0,0,0
MainPet-HealthBarFrame,2015,88,155,47,217,372,880,927,7936,0,0,0,0
Start-VersusSplash,2016,88,217,212,0,217,644,856,7937,0,0,0,0
BackupPet-Frame,2017,88,47,47,950,997,970,1017,7938,0,0,0,0
BattleHUD-Top,2019,88,574,118,0,574,395,513,7939,0,0,0,0
BattleBar-ButtonBG-EndCap,2021,88,24,78,27,51,856,934,7940,0,0,0,0
BattleBar-SwapPetFrame-DeadIcon,2022,88,33,33,915,948,987,1020,7941,0,0,0,0
MainPet-HealthBarFill,2023,88,145,37,406,551,913,950,7942,0,0,0,0
BattleBar-EndCap,2024,88,127,125,551,678,853,978,7943,0,0,0,0
BattleBar-Button-Highlight,2026,88,93,93,788,881,918,1011,7944,0,0,0,0
BattleBar-SwapPetFrame,2029,88,192,86,551,743,767,853,7945,0,0,0,0
Timer-Fill,2030,88,339,17,521,860,688,705,7946,0,0,0,0
BattleBar-SwapPetIcon,2031,88,44,42,724,768,962,1004,7947,0,0,0,0
MainPet-Frame,2034,88,110,109,678,788,853,962,7948,0,0,0,0
BattleBar-Countdown-Shadow,2035,88,53,52,950,1003,918,970,7949,0,0,0,0
BattleBar-ButtonBG-Divider,2036,88,27,81,0,27,856,937,7950,0,0,0,0
BattleBar-SwapPetShadow,2037,88,145,146,406,551,767,913,7951,0,0,0,0
BattleBar-SwapPetFrame-Highlight,2038,88,169,42,217,386,927,969,7952,0,0,0,0
MainPet-PetFamilyActivate,2040,88,46,46,678,724,962,1008,7953,0,0,0,0
MainPet-LevelBubble,2041,88,24,24,997,1021,970,994,7954,0,0,0,0
BattleHUD-Versus,2042,88,155,65,788,943,853,918,7955,0,0,0,0
_BattleBar-ButtonBGMid,2043,88,256,78,0,256,124,202,7961,0,0,4,0
_BattleBar-Mid,2044,88,256,124,0,256,0,124,7962,0,0,4,0
BackArrow-Brown,2102,103,9,17,486,495,877,894,7963,0,0,0,0
MapCornerShadow-Left,2105,103,182,30,290,472,845,875,7966,0,0,0,0
MapCornerShadow-Right,2106,103,46,53,290,336,899,952,7967,0,0,0,0
NoQuestsBackground,2107,103,287,464,1,288,1,465,7968,0,0,0,0
OptionsIcon-Brown,2108,103,16,16,468,484,877,893,7969,0,0,0,0
QuestCollapse-Hide-Down,2109,103,32,32,290,322,954,986,7970,0,0,0,0
QuestCollapse-Hide-Up,2110,103,32,32,390,422,899,931,7971,0,0,0,0
QuestCollapse-Show-Down,2111,103,32,32,338,370,978,1010,7972,0,0,0,0
QuestCollapse-Show-Up,2112,103,32,32,338,370,944,976,7973,0,0,0,0
QuestDetails-RewardsBottomOverlay,2113,103,287,46,290,577,797,843,7974,0,0,0,0
QuestDetails-RewardsOverlay,2114,103,287,275,290,577,467,742,7975,0,0,0,0
QuestDetails-TopOverlay,2115,103,287,51,290,577,744,795,7976,0,0,0,0
QuestDetailsBackgrounds,2116,103,287,464,1,288,467,931,7977,0,0,0,0
QuestionMarkContinent-Icon,2117,103,20,27,265,285,962,989,7978,0,0,0,0
QuestionMarkContinent-IconHighlight,2118,103,20,27,265,285,933,960,7979,0,0,0,0
QuestLogBackground,2119,103,287,464,290,577,1,465,7980,0,0,0,0
StoryHeader-BG,2120,103,262,77,1,263,933,1010,7981,0,0,0,0
StoryHeader-CheevoIcon,2121,103,50,43,338,388,899,942,7982,0,0,0,0
StoryHeader-Shadow,2122,103,252,9,1,253,1012,1021,7983,0,0,0,0
TaskPOI-Icon,2123,103,19,19,447,466,877,896,7984,0,0,0,0
TaskPOI-IconHighlight,2124,103,19,19,426,445,877,896,7985,0,0,0,0
TaskPOI-IconSelect,2125,103,19,19,265,284,991,1010,7986,0,0,0,0
UI-OuterBorderButtonPatch,2126,103,18,22,390,408,967,989,7987,0,0,0,0
UI-SquareButtonBrown-Down,2127,103,32,32,390,422,933,965,7988,0,0,0,0
UI-SquareButtonBrown-Up,2128,103,32,32,290,322,988,1020,7989,0,0,0,0
QuestItemBorder-Small,2130,103,134,20,290,424,877,897,7990,0,0,0,0
QuestItemBorder,2131,103,102,30,474,576,845,875,7991,0,0,0,0
Talent-Separator,2158,110,68,50,1,69,375,425,8076,0,0,0,0
Talent-BottomLeftCurlies,2159,110,65,55,124,189,104,159,8077,0,0,0,0
Talent-Highlight,2160,110,200,53,1,201,226,279,8078,0,0,0,0
Talent-TopRightCurlies,2161,110,64,55,191,255,104,159,8079,0,0,0,0
Talent-TopLeftCurlies,2162,110,63,55,191,254,161,216,8080,0,0,0,0
Talent-Background,2164,110,32,43,0,32,1,44,8082,0,0,4,0
Talent-Selection,2165,110,190,45,1,191,281,326,8083,0,0,0,0
Talent-RingWithDot,2166,110,121,120,1,122,104,224,8084,0,0,0,0
Talent-BottomRightCurlies,2167,110,65,55,124,189,161,216,8085,0,0,0,0
PetJournal-BattleSlot-Active,2168,111,404,106,1,405,174,280,7964,0,0,0,0
PetJournal-BattleSlot-Locked,2169,111,404,106,1,405,282,388,7965,0,0,0,0
PetJournal-PetCard-BG,2170,111,408,171,1,409,1,172,7992,0,0,0,0
PetJournal-BattleSlotFrame-Corner,2172,112,17,17,238,255,98,115,7993,0,0,0,0
PetJournal-ExpBar-Left,2173,112,11,11,238,249,130,141,7994,0,0,0,0
PetJournal-BattleSlotTitle-Right,2175,112,40,40,1,41,330,370,7995,0,0,0,0
PetJournal-ExpBar-Background,2176,112,11,11,238,249,117,128,7996,0,0,0,0
PetJournal-PetBattleAchievementGlow,2177,112,235,49,1,236,98,147,7997,0,0,0,0
PetJournal-HealthBar-Left,2179,112,11,7,167,178,214,221,7998,0,0,0,0
PetJournal-PetCard-Abilities,2180,112,57,105,1,58,223,328,7999,0,0,0,0
PetJournal-BattleSlot-AbilityBorder,2182,112,33,33,1,34,372,405,8000,0,0,0,0
PetJournal-ExpBar-Divider,2183,112,7,7,238,245,149,156,8001,0,0,0,0
PetJournal-ExpBar-Right,2184,112,11,11,154,165,205,216,8002,0,0,0,0
PetJournal-BattleSlot-IconBorder,2185,112,53,54,141,194,149,203,8003,0,0,0,0
PetJournal-LevelBubble,2187,112,21,21,36,57,372,393,8005,0,0,0,0
PetJournal-ExpBar-Mid,2188,112,11,11,141,152,205,216,8006,0,0,0,0
PetJournal-PetBattleAchievementBG,2189,112,50,22,196,246,191,213,8007,0,0,0,0
PetJournal-BattleSlot-Shadow,2191,112,138,72,1,139,149,221,8009,0,0,0,0
PetJournal-BattleSlotTitle-Left,2192,112,40,40,196,236,149,189,8010,0,0,0,0
PetJournal-HealthBar-Mid,2193,112,11,7,180,191,205,212,8011,0,0,0,0
PetJournal-HealthBar-Right,2194,112,11,7,180,191,214,221,8012,0,0,0,0
PetJournal-HealthBar-Background,2195,112,11,7,167,178,205,212,8013,0,0,0,0
_BattleSlotTitle-BG,2198,112,64,24,0,64,43,67,8016,0,0,4,0
_BattleSlotFrame-Top,2199,112,64,16,0,64,69,85,8017,0,0,4,0
_BattleSlotFrame-Divider,2200,112,64,9,0,64,87,96,8018,0,0,4,0
_BattleSlotTitle-Mid,2201,112,64,40,0,64,1,41,8019,0,0,4,0
MountJournalIcons-Alliance,2233,114,46,44,1,47,1,45,7956,0,0,0,0
MountJournalIcons-Horde,2234,114,46,44,49,95,1,45,7957,0,0,0,0
_Talent-blue-glow,2240,110,16,16,0,16,46,62,8042,0,0,4,0
_Talent-Bottom-Tile,2241,110,64,5,0,64,97,102,8043,0,0,4,0
_Talent-Top-Tile,2242,110,64,13,0,64,82,95,8044,0,0,4,0
bluemenu-Ring,2245,116,102,103,1,103,1,104,8081,0,0,0,0
petlist-buttonbackground,2246,117,209,46,1,210,193,239,8087,0,0,0,0
petlist-buttonhighlight,2247,117,209,46,212,421,193,239,8088,0,0,0,0
petlist-buttonselect,2248,117,209,46,1,210,241,287,8089,0,0,0,0
PetJournal-FavoritesIcon,2249,118,25,25,1,26,1,26,8086,0,0,0,0
NewCharacter-Alliance,2257,120,112,58,1,113,1,59,8045,0,0,0,0
NewCharacter-Horde,2258,120,112,58,1,113,61,119,8046,0,0,0,0
Garr_InfoBox-Corner,2266,121,128,128,1,129,277,405,8023,0,0,0,0
Garr_InfoBoxBorder-BigBottomCorner,2267,121,44,46,187,231,277,323,8024,0,0,0,0
Garr_InfoBoxBorder-Corner,2268,121,30,30,90,120,407,437,8025,0,0,0,0
Garr_InfoBoxBorder-FiligreeCorner,2269,121,87,101,1,88,407,508,8026,0,0,0,0
Garr_WoodFrameCorner,2304,121,54,54,131,185,277,331,8055,0,0,0,0
_Garr_InfoBox-Top,2307,121,256,135,0,256,1,136,8057,0,0,4,0
_Garr_InfoBoxBorder-BigBottom,2308,121,256,34,0,256,138,172,8058,0,0,4,0
_Garr_InfoBoxBorder-Top,2309,121,256,18,0,256,257,275,8059,0,0,4,0
_Garr_WoodFrameTile-Bottom,2310,121,256,28,0,256,174,202,8060,0,0,4,0
_Garr_WoodFrameTile-Top,2311,121,256,28,0,256,204,232,8061,0,0,4,0
_Garr_XPBar_Mid,2312,121,32,21,0,32,234,255,8062,0,0,4,0
!Garr_InfoBox-Left,2316,122,135,256,1,136,0,256,8004,0,0,2,0
!Garr_InfoBoxBorder-Left,2317,122,18,256,168,186,0,256,8008,0,0,2,0
!Garr_WoodFrameTile-Left,2318,122,28,256,138,166,0,256,8014,0,0,2,0
Garr_BuildingIconRing_,2319,123,36,37,93,129,349,386,8015,0,0,0,0
Garr_BuildingPlacementExplosion,2320,123,97,63,1,98,443,506,8020,0,0,0,0
Garr_CostBar,2321,123,175,44,341,516,126,170,8021,0,0,0,0
Garr_FollowerPortrait_Bg,2322,123,58,58,351,409,453,511,8022,0,0,0,0
Garr_FollowerPortrait_Ring,2323,123,58,58,476,534,232,290,8027,0,0,0,0
Garr_FollowerPortrait_TimerBG,2324,123,45,45,961,1006,1,46,8028,0,0,0,0
Garr_FollowerPortrait_TimerFill,2325,123,45,45,961,1006,48,93,8029,0,0,0,0
Garr_LevelBadge_1,2326,123,58,49,531,589,173,222,8030,0,0,0,0
Garr_LevelBadge_2,2327,123,58,49,591,649,173,222,8031,0,0,0,0
Garr_LevelBadge_3,2328,123,58,49,651,709,173,222,8032,0,0,0,0
Garr_LevelUpgradeArrow,2329,123,33,39,93,126,388,427,8033,0,0,0,0
Garr_LevelUpgradeLocked,2330,123,33,39,814,847,126,165,8034,0,0,0,0
Garr_ListButton-Highlight,2331,123,208,45,751,959,48,93,8035,0,0,0,0
Garr_ListButton-Selection,2332,123,208,45,131,339,126,171,8036,0,0,0,0
Garr_ListButton,2333,123,208,45,751,959,1,46,8037,0,0,0,0
Garr_ListTab-Highlight,2334,123,77,36,608,685,126,162,8038,0,0,0,0
Garr_ListTab-Select,2335,123,91,50,384,475,173,223,8039,0,0,0,0
Garr_ListTab,2336,123,91,50,291,382,173,223,8040,0,0,0,0
Garr_MaterialIcon,2337,123,12,11,606,618,63,74,8041,0,0,0,0
Garr_MonumentLocked,2338,123,58,58,476,534,292,350,8065,0,0,0,0
Garr_MonumentOpen,2339,123,58,58,476,534,352,410,8066,0,0,0,0
Garr_PlanIcon-List,2340,123,38,38,566,604,63,101,8067,0,0,0,0
Garr_PlansRequiredIcon,2341,123,90,92,1,91,349,441,8068,0,0,0,0
Garr_Plot_Glow_3,2342,123,108,70,131,239,376,446,8069,0,0,0,0
Garr_Plot_Glow_2,2343,123,108,70,131,239,304,374,8070,0,0,0,0
Garr_Plot_Glow_1,2344,123,108,70,131,239,232,302,8071,0,0,0,0
Garr_Plot_Glow_4,2345,123,108,70,241,349,232,302,8072,0,0,0,0
Garr_Specialization_FrameLeft,2346,123,52,57,477,529,173,230,8073,0,0,0,0
Garr_Specialization_FrameMid,2347,123,43,57,919,962,173,230,8074,0,0,0,0
Garr_Specialization_IconBorder,2348,123,45,45,767,812,126,171,8075,0,0,0,0
Garr_Specialization_IconSelected,2349,123,49,49,964,1013,173,222,8047,0,0,0,0
Garr_TownHallBanner_Left,2351,123,36,33,849,885,126,159,8048,0,0,0,0
Garr_TownHallBanner_LevelFiligree,2352,123,88,38,518,606,126,164,8049,0,0,0,0
Garr_TownHallBanner_Mid,2353,123,78,34,687,765,126,160,8050,0,0,0,0
Garr_TownHallBanner_Right,2354,123,36,33,887,923,126,159,8051,0,0,0,0
Garr_TreasureIcon,2355,123,66,63,351,417,306,369,8052,0,0,0,0
Garr_XPBar_Left,2356,123,32,21,635,667,92,113,8053,0,0,0,0
Garr_XPBar_Nub,2357,123,11,11,620,631,63,74,8054,0,0,0,0
Garr_Map_Shadowmoon1_A,2369,125,672,468,1,673,1,469,8056,0,0,0,0
Garr_Map_Shadowmoon2_A,2370,126,672,468,1,673,1,469,8063,0,0,0,0
Garr_Map_Shadowmoon3_A,2371,127,672,468,1,673,1,469,8064,0,0,0,0
Garr_Plot_Shadowmoon_A_4,2372,128,108,70,111,219,73,143,8090,0,0,0,0
Garr_Plot_Shadowmoon_A_1,2373,128,108,70,1,109,1,71,8091,0,0,0,0
Garr_Plot_Shadowmoon_A_2,2374,128,108,70,111,219,1,71,8092,0,0,0,0
Garr_Plot_Shadowmoon_A_3,2375,128,108,70,1,109,73,143,8093,0,0,0,0
Garr_InfoBox-BackgroundTile,2376,129,256,256,0,256,0,256,7958,0,0,6,0
Garr_WoodFrame-BackgroundTile,2378,130,256,256,0,256,0,256,7959,0,0,6,0
Garr_InfoBox-CornerShadow,2379,121,8,8,90,98,439,447,7960,0,0,0,0
GarrBuilding_Default_Info,2382,124,250,162,1,251,165,327,8119,0,0,0,0
GarrBuilding_Default_Map,2383,124,108,80,269,377,1,81,8120,0,0,0,0
GarrBuilding_EmptyPlot_1_A_Info,2384,124,266,162,1,267,1,163,8121,0,0,0,0
GarrBuilding_Armory_1_A_Info,2398,134,250,162,1,251,1,163,8128,0,0,0,0
GarrBuilding_Armory_2_A_Info,2399,135,250,162,1,251,1,163,8129,0,0,0,0
GarrBuilding_Armory_3_A_Info,2400,136,250,162,1,251,1,163,8130,0,0,0,0
GarrBuilding_Armory_1_A_Map,2404,140,108,83,1,109,1,84,8094,0,0,0,0
GarrBuilding_Armory_2_A_Map,2405,141,108,86,1,109,1,87,8095,0,0,0,0
GarrBuilding_Armory_3_A_Map,2406,142,108,103,1,109,1,104,8096,0,0,0,0
GarrBuilding_Alchemy_1_A_Info,2407,143,250,162,1,251,1,163,8097,0,0,0,0
GarrBuilding_Alchemy_2_A_Info,2408,144,250,162,1,251,1,163,8098,0,0,0,0
GarrBuilding_Alchemy_3_A_Info,2409,145,250,162,1,251,1,163,8099,0,0,0,0
GarrBuilding_Alchemy_1_A_Map,2410,146,108,81,1,109,1,82,8100,0,0,0,0
GarrBuilding_Alchemy_2_A_Map,2411,147,108,82,1,109,1,83,8101,0,0,0,0
GarrBuilding_Alchemy_3_A_Map,2412,148,108,91,1,109,1,92,8102,0,0,0,0
DruidEclipse-LunarCover,2413,149,60,35,1,61,76,111,8115,0,0,0,0
DruidEclipse-SolarCover,2414,149,74,32,112,186,40,72,8116,0,0,0,0
DruidEclipse-Arrow,2415,149,24,24,188,212,40,64,8103,0,0,0,0
DruidEclipse-BaseBar,2416,149,140,37,1,141,1,38,8104,0,0,0,0
DruidEclipse-BaseMoon,2417,149,23,23,214,237,40,63,8105,0,0,0,0
DruidEclipse-BaseSun,2418,149,23,23,152,175,76,99,8106,0,0,0,0
DruidEclipse-Diamond,2419,149,24,22,202,226,76,98,8107,0,0,0,0
DruidEclipse-Line,2420,149,12,22,239,251,40,62,8108,0,0,0,0
DruidEclipse-LunarBar,2421,149,110,37,143,253,1,38,8109,0,0,0,0
DruidEclipse-LunarMoon,2422,149,42,45,108,150,76,121,8110,0,0,0,0
DruidEclipse-LunarSun,2423,149,23,23,152,175,101,124,8111,0,0,0,0
DruidEclipse-SolarBar,2424,149,109,34,1,110,40,74,8112,0,0,0,0
DruidEclipse-SolarMoon,2425,149,23,23,177,200,76,99,8113,0,0,0,0
DruidEclipse-SolarSun,2426,149,43,45,63,106,76,121,8114,0,0,0,0
Garr_BuildIcon,2427,123,46,46,241,287,463,509,8131,0,0,0,0
Garr_BuildingConfirmation,2428,123,271,123,1,272,1,124,8132,0,0,0,0
Garr_BuildingIconTimerBG,2429,123,34,34,925,959,126,160,8133,0,0,0,0
Garr_BuildingIconTimerFill,2430,123,34,34,961,995,126,160,8134,0,0,0,0
Garr_BuildingTimerBG,2431,123,50,50,711,761,173,223,8135,0,0,0,0
Garr_BuildingTimerFill,2432,123,50,50,763,813,173,223,8136,0,0,0,0
Garr_BuildingTimerGlow,2433,123,72,72,241,313,389,461,8137,0,0,0,0
Garr_BuildingUpgradeExplosion,2434,123,97,63,131,228,448,511,8138,0,0,0,0
Garr_LevelBadgeGlow,2435,123,96,91,1,97,256,347,8139,0,0,0,0
Garr_NotificationGlow,2437,123,359,60,274,633,1,61,8140,0,0,0,0
Garr_UpgradeBanner,2439,123,114,89,635,749,1,90,8142,0,0,0,0
Garr_UpgradeIcon,2440,123,46,46,425,471,314,360,8143,0,0,0,0
Garr_UpgradeIconTimerBG,2441,123,34,34,311,345,304,338,8144,0,0,0,0
Garr_UpgradeIconTimerFill,2442,123,34,34,311,345,340,374,8145,0,0,0,0
Garr_UpgradeTimerBG,2443,123,50,50,815,865,173,223,8146,0,0,0,0
Garr_UpgradeTimerFill,2444,123,50,50,867,917,173,223,8147,0,0,0,0
Garr_UpgradeTimerGlow,2445,123,72,72,351,423,232,304,8148,0,0,0,0
Garr_Toast,2446,150,317,82,1,318,85,167,8149,0,0,0,0
Garr_BuildingShadowOverlay,2447,123,128,128,1,129,126,254,8141,0,0,0,0
GarrMission_Bg-DarkEdgeCorner,2454,152,46,256,269,315,642,898,8192,0,0,0,0
GarrMission_CounterCheck,2469,152,25,22,505,530,289,311,8207,0,0,0,0
GarrMission_EncounterAbilityBorder,2470,152,32,32,691,723,435,467,8208,0,0,0,0
GarrMission_EncounterBar-BG,2471,152,32,13,646,678,289,302,8209,0,0,0,0
GarrMission_EncounterBar-End,2472,152,17,17,714,731,289,306,8210,0,0,0,0
GarrMission_EncounterBar-Fill,2473,152,32,13,680,712,289,302,8211,0,0,0,0
GarrMission_EncounterBar-PortraitRing,2474,152,64,61,892,956,811,872,8212,0,0,0,0
GarrMission_EncounterBar-Spark,2475,152,27,27,845,872,435,462,8213,0,0,0,0
GarrMission_EncounterBar-Xbg,2476,152,93,96,433,526,920,1016,8214,0,0,0,0
GarrMission_EncounterBar-Xleft,2477,152,93,96,655,748,774,870,8215,0,0,0,0
GarrMission_FollowerAbilityRollout,2479,152,243,75,1,244,885,960,8216,0,0,0,0
GarrMission_FollowerPartyBox_Lg,2484,152,232,72,433,665,628,700,8221,0,0,0,0
GarrMission_FollowerPartyBox_Sm,2485,152,169,72,433,602,774,846,8222,0,0,0,0
GarrMission_ItemFrame,2487,152,109,41,914,1023,702,743,8224,0,0,0,0
GarrMission_LevelUpBanner,2488,152,140,70,433,573,848,918,8225,0,0,0,0
GarrMission_LocationCover-Side,2491,152,49,230,365,414,642,872,8228,0,0,0,0
GarrMission_ParchmentHeader-End,2498,152,65,41,948,1013,941,982,8234,0,0,0,0
GarrMission_PartyBuffsBG,2499,152,256,33,505,761,254,287,8235,0,0,0,0
GarrMission_PortraitRing,2501,152,59,62,958,1017,811,873,8237,0,0,0,0
GarrMission_PortraitRing_Empty,2502,152,59,62,826,885,941,1003,8238,0,0,0,0
GarrMission_PortraitRing_Enemy,2503,152,53,53,967,1020,395,448,8239,0,0,0,0
GarrMission_PortraitRing_LevelBorder,2504,152,58,24,861,919,287,311,8240,0,0,0,0
GarrMission_RareGlowBG,2505,152,128,35,826,954,774,809,8241,0,0,0,0
GarrMission_RewardsBanner-Desaturate,2507,152,233,70,433,666,702,772,8243,0,0,0,0
GarrMission_RewardsBanner,2508,152,233,70,667,900,628,698,8244,0,0,0,0
GarrMission_RewardsBG-Desaturate,2509,152,502,154,505,1007,1,155,8245,0,0,0,0
GarrMission_RewardsBG,2510,152,502,154,1,503,1,155,8246,0,0,0,0
GarrMission_RewardsBorder-Corner-Desaturate,2511,152,64,64,750,814,930,994,8247,0,0,0,0
GarrMission_RewardsBorder-Corner,2512,152,64,64,365,429,940,1004,8248,0,0,0,0
GarrMission_Silhouettes-1Alliance,2517,152,266,284,1,267,313,597,8249,0,0,0,0
GarrMission_Silhouettes-1Horde,2518,152,266,284,1,267,599,883,8250,0,0,0,0
GarrMission_SingleModelBG,2521,152,162,170,269,431,470,640,8253,0,0,0,0
GarrMission_StartMissionFrame,2522,152,215,39,1,216,962,1001,8254,0,0,0,0
_GarrMission_Bg-BottomEdge,2532,153,256,251,0,256,1,252,8348,0,0,4,0
_GarrMission_Bg-BottomEdgeSmall,2533,153,256,42,0,256,507,549,8349,0,0,4,0
_GarrMission_LocationCover-Bottom,2534,153,256,38,0,256,638,676,8350,0,0,4,0
_GarrMission_ParchmentHeader-Mid,2539,153,128,41,0,128,595,636,8355,0,0,4,0
_GarrMission_RewardsBorder-Top-Desaturate,2540,153,64,25,0,64,780,805,8356,0,0,4,0
_GarrMission_RewardsBorder-Top,2541,153,64,25,0,64,753,778,8357,0,0,4,0
_GarrMission_TopBorder-Highlight,2542,153,32,10,0,32,866,876,8358,0,0,4,0
_GarrMission_TopBorder-Select,2543,153,32,10,0,32,878,888,8359,0,0,4,0
_GarrMission_TopBorder,2544,153,32,10,0,32,854,864,8360,0,0,4,0
_GarrMission_XPBar-BG,2545,153,32,6,0,32,902,908,8361,0,0,4,0
_GarrMission_XPBar-Fill,2546,153,32,6,0,32,910,916,8362,0,0,4,0
_Garr_InfoBoxBorderMission-Top,2547,153,256,18,0,256,834,852,8363,0,0,4,0
!GarrMission_Bg-Edge,2549,154,46,256,138,184,0,256,8265,0,0,2,0
!GarrMission_RewardsBorder-Left-Desaturate,2550,154,30,64,266,296,0,64,8266,0,0,2,0
!GarrMission_RewardsBorder-Left,2551,154,30,64,234,264,0,64,8267,0,0,2,0
!Garr_InfoBoxBorderMission-Left,2553,154,18,256,330,348,0,256,8269,0,0,2,0
Garr_InfoBoxMission-BackgroundTile,2554,155,256,256,0,256,0,256,8270,0,0,6,0
GarrMission_FollowerListButton,2566,156,232,56,35,267,801,857,8263,0,0,0,0
GarrMission_FollowerListButton-Highlight,2567,156,232,56,235,467,564,620,8273,0,0,0,0
GarrMission_FollowerListButton-Select,2568,156,232,56,1,233,564,620,8274,0,0,0,0
GarrMission_FollowerPageHeaderBG,2569,156,32,77,1,33,801,878,8275,0,0,0,0
GarrMission_IconLevelBG,2570,156,120,65,338,458,719,784,8276,0,0,0,0
GarrMission_ListGlow-Highlight,2571,156,400,50,1,401,667,717,8277,0,0,0,0
GarrMission_ListGlow-Select,2572,156,400,50,1,401,375,425,8278,0,0,0,0
GarrMission_PlayerLootFrame,2576,156,49,49,462,511,504,553,8279,0,0,0,0
GarrMission_RareOverlay,2577,156,128,35,381,509,312,347,8280,0,0,0,0
GarrMission_TopBorderCorner,2578,156,26,33,469,495,564,597,8281,0,0,0,0
GarrMission_TopBorderCorner-Highlight,2579,156,26,33,470,496,375,408,8282,0,0,0,0
GarrMission_TopBorderCorner-Select,2580,156,26,33,345,371,306,339,8283,0,0,0,0
GarrMission_UsefulAbilityIcon,2581,156,34,37,345,379,232,269,8284,0,0,0,0
GarrMission_XPBarBig-End,2582,156,15,15,260,275,200,215,8285,0,0,0,0
GarrMission_XPBarBig-LevelBorder,2583,156,28,15,213,241,200,215,8286,0,0,0,0
GarrMission_XPBarBig-Mid,2584,156,16,15,146,162,200,215,8287,0,0,0,0
Garr_InfoBoxBorderMission-Corner,2585,156,30,30,181,211,200,230,8288,0,0,0,0
PartySizeIcon,2586,156,52,42,408,460,504,546,8289,0,0,0,0
GarrMission_CurrencyIcon-Material,2588,157,57,57,1,58,1,58,8290,0,0,0,0
GarrMission_CurrencyIcon-Salvage,2589,157,57,57,60,117,1,58,8291,0,0,0,0
GarrMission_CurrencyIcon-Xp,2590,157,57,57,1,58,60,117,8292,0,0,0,0
_GarrMissionLocation-TannanJungle-Back,2591,158,1024,285,0,1024,1,286,8351,0,0,4,0
_GarrMissionLocation-TannanJungle-Fore,2592,158,1024,285,0,1024,288,573,8352,0,0,4,0
_GarrMissionLocation-TannanJungle-Mid,2593,158,1024,285,0,1024,575,860,8353,0,0,4,0
GarrMission_MissionParchment,2594,159,256,256,0,256,0,256,8293,0,0,6,0
GarrBuilding_MageTower_1_A_Info,2599,160,250,162,1,251,1,163,8298,0,0,0,0
GarrBuilding_MageTower_2_A_Info,2600,161,250,162,1,251,1,163,8299,0,0,0,0
GarrBuilding_MageTower_3_A_Info,2601,162,250,162,1,251,1,163,8300,0,0,0,0
GarrBuilding_TownHall_1_A_Info,2602,163,250,162,1,251,1,163,8301,0,0,0,0
GarrBuilding_TownHall_2_A_Info,2603,164,250,162,1,251,1,163,8294,0,0,0,0
GarrBuilding_TownHall_3_A_Info,2604,165,250,162,1,251,1,163,8295,0,0,0,0
GarrBuilding_TownHall_3_A_Map,2605,166,108,141,1,109,1,142,8296,0,0,0,0
GarrBuilding_TownHall_2_A_Map,2606,167,108,110,1,109,1,111,8297,0,0,0,0
GarrBuilding_TownHall_1_A_Map,2607,168,108,101,1,109,1,102,8302,0,0,0,0
GarrBuilding_MageTower_1_A_Map,2608,169,108,82,1,109,1,83,8303,0,0,0,0
GarrBuilding_MageTower_2_A_Map,2609,170,108,113,1,109,1,114,8304,0,0,0,0
GarrBuilding_MageTower_3_A_Map,2610,171,108,146,1,109,1,147,8305,0,0,0,0
GarrBuilding_Inn_1_A_Info,2612,172,250,162,1,251,1,163,8306,0,0,0,0
GarrBuilding_Inn_1_A_Map,2613,173,108,71,1,109,1,72,8307,0,0,0,0
GarrBuilding_Inn_2_A_Info,2614,174,250,162,1,251,1,163,8308,0,0,0,0
GarrBuilding_Inn_3_A_Info,2615,175,250,162,1,251,1,163,8309,0,0,0,0
GarrBuilding_Inn_2_A_Map,2616,176,108,79,1,109,1,80,8310,0,0,0,0
GarrBuilding_Inn_3_A_Map,2617,177,108,84,1,109,1,85,8311,0,0,0,0
GarrBuilding_Mine_1_A_Info,2618,178,250,162,1,251,1,163,8312,0,0,0,0
GarrBuilding_Mine_2_A_Info,2619,179,250,162,1,251,1,163,8313,0,0,0,0
GarrBuilding_Mine_3_A_Info,2620,180,250,162,1,251,1,163,8314,0,0,0,0
GarrBuilding_Mine_1_A_Map,2621,181,108,78,1,109,1,79,8315,0,0,0,0
GarrBuilding_Mine_2_A_Map,2622,182,108,77,1,109,1,78,8316,0,0,0,0
GarrBuilding_Mine_3_A_Map,2623,183,108,77,1,109,1,78,8317,0,0,0,0
GarrBuilding_Barracks_1_A_Map,2624,184,108,70,1,109,1,71,8318,0,0,0,0
GarrBuilding_Barracks_2_A_Map,2625,185,108,83,1,109,1,84,8319,0,0,0,0
GarrBuilding_Barracks_3_A_Map,2626,186,108,86,1,109,1,87,8320,0,0,0,0
GarrBuilding_Barracks_1_A_Info,2627,187,250,162,1,251,1,163,8321,0,0,0,0
GarrBuilding_Barracks_2_A_Info,2628,188,250,162,1,251,1,163,8322,0,0,0,0
GarrBuilding_Barracks_3_A_Info,2629,189,250,162,1,251,1,163,8323,0,0,0,0
GarrBuilding_Engineering_1_A_Info,2630,190,250,162,1,251,1,163,8324,0,0,0,0
GarrBuilding_Engineering_2_A_Info,2631,191,250,162,1,251,1,163,8325,0,0,0,0
GarrBuilding_Engineering_3_A_Info,2632,192,250,162,1,251,1,163,8326,0,0,0,0
GarrBuilding_Engineering_1_A_Map,2633,193,108,76,1,109,1,77,8327,0,0,0,0
GarrBuilding_Engineering_2_A_Map,2634,194,108,75,1,109,1,76,8328,0,0,0,0
GarrBuilding_Engineering_3_A_Map,2635,195,108,81,1,109,1,82,8329,0,0,0,0
Rewards-Shadow,2644,197,154,16,1,155,153,169,8330,0,0,0,0
OBJFX_LineBurst,2645,197,86,20,84,170,171,191,8331,0,0,0,0
OBJBonusBar-Top,2646,197,230,23,1,231,128,151,8332,0,0,0,0
OBJFX_LineGlow,2647,197,230,22,233,463,128,150,8333,0,0,0,0
Objective-Header,2648,197,297,86,1,298,1,87,8334,0,0,0,0
Rewards-Top,2649,197,167,22,342,509,89,111,8335,0,0,0,0
OBJFX_StarBurst,2650,197,64,64,366,430,1,65,8336,0,0,0,0
Objective-Nub,2651,197,11,10,336,347,67,77,8337,0,0,0,0
OBJFX_Glow,2652,197,64,64,300,364,1,65,8338,0,0,0,0
shadoworbs-small-Orb-Bg,2653,198,28,28,1,29,143,171,8150,0,0,0,0
shadoworbs-small-Orb,2654,198,25,25,1,26,173,198,8151,0,0,0,0
shadoworbs-small-Frame-OrbHighlight,2655,198,52,29,162,214,57,86,8152,0,0,0,0
shadoworbs-large-Orb,2656,198,38,37,216,254,57,94,8153,0,0,0,0
shadoworbs-large-Frame,2657,198,159,54,1,160,1,55,8154,0,0,0,0
shadoworbs-large-Orb-Bg,2658,198,38,37,1,39,104,141,8155,0,0,0,0
shadoworbs-large-Frame-OrbHighlight,2659,198,74,44,162,236,1,45,8156,0,0,0,0
shadoworbs-small-Frame,2660,198,159,45,1,160,57,102,8157,0,0,0,0
achievementcompare-GreenCheckmark,2661,199,9,11,1,10,1,12,8158,0,0,0,0
achievementcompare-YellowCheckmark,2662,199,9,11,12,21,1,12,8159,0,0,0,0
MonkUI-background-shadow,2663,200,136,43,1,137,1,44,8160,0,0,0,0
MonkUI-OrbOff,2664,200,21,21,139,160,1,22,8161,0,0,0,0
MonkUI-OrbOff-small,2665,200,18,18,139,157,24,42,8162,0,0,0,0
MonkUI-LightOrb-small,2666,200,18,18,162,180,24,42,8163,0,0,0,0
MonkUI-background,2667,200,136,43,1,137,46,89,8164,0,0,0,0
MonkUI-LightOrb,2668,200,21,21,162,183,1,22,8165,0,0,0,0
Garr_InfoBoxMission-Corner,2669,156,135,135,1,136,427,562,8354,0,0,0,0
_Garr_InfoBoxMission-Top,2670,156,256,135,0,256,20,155,8364,0,0,4,0
!Garr_InfoBoxMission-Left,2671,154,135,256,1,136,0,256,8365,0,0,2,0
bags-newitem,2673,202,44,44,93,137,1,45,8166,0,0,0,0
Tracker-Check,2675,197,16,16,318,334,67,83,8196,0,0,0,0
_GarrMission_MissionListTopHighlight,2676,156,256,17,0,256,1,18,8339,0,0,4,0
GarrMission_PartyBuffAbilityBorder,2677,152,32,32,725,757,435,467,8340,0,0,0,0
collections-icon-favorites,2679,203,31,33,93,124,7,40,8366,0,0,0,0
collections-itemborder-collected,2680,203,56,56,126,182,7,63,8367,0,0,0,0
collections-itemborder-uncollected-innerglow,2681,203,42,41,184,226,7,48,8368,0,0,0,0
collections-itemborder-uncollected,2682,203,100,100,154,254,102,202,8369,0,0,0,0
collections-levelplate-black,2683,203,32,21,184,216,50,71,8370,0,0,0,0
collections-levelplate-gold,2684,203,32,21,228,260,7,28,8371,0,0,0,0
collections-newglow,2685,203,59,37,262,321,7,44,8372,0,0,0,0
collections-slotheader,2686,203,490,24,1,491,76,100,8373,0,0,0,0
collections-background-filagree,2694,203,151,109,1,152,102,211,8344,0,0,0,0
collections-background-corner,2696,203,90,67,1,91,7,74,8345,0,0,0,0
collections-background-tile,2702,204,256,256,0,256,0,256,8343,0,0,6,0
_collections-background-line,2710,203,512,4,0,512,1,5,8347,0,0,4,0
collections-background-shadow-small,2711,203,13,13,93,106,42,55,8342,0,0,0,0
collections-background-shadow-large,2712,203,145,147,93,238,213,360,8346,0,0,0,0
bags-junkcoin,2713,202,20,18,221,241,72,90,8341,0,0,0,0
bags-innerglow,2785,202,36,36,42,78,138,174,8374,0,0,0,0
Capacitance-Blacksmithing-BG,2786,208,321,370,1,322,1,371,8375,0,0,0,0
Capacitance-Blacksmithing-IconBG,2787,208,291,58,1,292,373,431,8376,0,0,0,0
Capacitance-Blacksmithing-IconBorder,2788,208,59,58,324,383,1,59,8377,0,0,0,0
Capacitance-Blacksmithing-TimerBG,2789,208,275,15,1,276,467,482,8378,0,0,0,0
Capacitance-Blacksmithing-TimerFill,2790,208,275,15,1,276,484,499,8379,0,0,0,0
Capacitance-Blacksmithing-TimerFrame,2791,208,292,32,1,293,433,465,8380,0,0,0,0
Capacitance-General-EmptyFollower,2792,209,59,62,1,60,44,106,8381,0,0,0,0
Capacitance-General-ItemBorder,2793,209,133,41,1,134,1,42,8167,0,0,0,0
Capacitance-General-LockIcon,2794,209,22,29,233,255,1,30,8168,0,0,0,0
Capacitance-General-WorkOrderActive,2795,209,48,48,123,171,44,92,8169,0,0,0,0
Capacitance-General-WorkOrderArrow,2796,209,16,10,136,152,27,37,8170,0,0,0,0
Capacitance-General-WorkOrderBorder,2797,209,34,34,197,231,1,35,8171,0,0,0,0
Capacitance-General-WorkOrderCheckmark,2798,209,36,32,123,159,94,126,8172,0,0,0,0
Capacitance-General-WorkOrderEmpty,2799,209,34,34,173,207,44,78,8173,0,0,0,0
Capacitance-General-LevelBorder,2800,209,59,24,136,195,1,25,8174,0,0,0,0
Capacitance-General-PortraitRing,2801,209,59,62,62,121,44,106,8175,0,0,0,0
minortalents-icon-book,2808,213,40,38,437,477,48,86,8179,0,0,0,0
minortalents-iconcover,2809,213,25,45,437,462,88,133,8180,0,0,0,0
_minortalents-iconspinner,2811,213,512,45,0,512,1,46,8182,0,0,4,0
Objective-Fail,3137,197,16,16,300,316,67,83,8181,0,0,0,0
minortalents-backplate,3138,213,418,169,1,419,238,407,8183,0,0,0,0
minortalents-descriptionshadow,3139,213,434,188,1,435,48,236,8184,0,0,0,0
characterundelete-RestoreButton,3141,217,30,30,1,31,1,31,8176,0,0,0,0
bank-slots-shadow,3157,220,116,327,1,117,1,328,8185,0,0,0,0
bank-slots,3158,220,98,309,119,217,1,310,8186,0,0,0,0
Garr_MissionToast,3168,150,317,82,1,318,1,83,8187,0,0,0,0
Garr_FollowerToast-Epic,3169,150,219,26,275,494,253,279,8177,0,0,0,0
Garr_FollowerToast-Rare,3170,150,219,26,275,494,281,307,8178,0,0,0,0
Garr_FollowerToast-Uncommon,3171,150,219,26,1,220,314,340,8188,0,0,0,0
Garr_MissionToast-IconBG,3172,150,73,55,320,393,1,56,8189,0,0,0,0
Garr_Map_Frostfire1_H,3174,225,672,468,1,673,1,469,8190,0,0,0,0
Garr_Map_Frostfire2_H,3175,226,672,468,1,673,1,469,8191,0,0,0,0
Garr_Map_Frostfire3_H,3176,227,672,468,1,673,1,469,8197,0,0,0,0
ZoneAbility-Generic-AbilityBar-Glow,3189,230,153,27,79,232,30,57,8198,0,0,0,0
ZoneAbility-Generic-AbilityBar,3190,230,153,27,79,232,1,28,8199,0,0,0,0
ZoneAbility-Generic-IconBorder,3191,230,63,65,79,142,59,124,8200,0,0,0,0
ZoneAbility-Generic-SpellBox,3192,230,76,66,1,77,1,67,8201,0,0,0,0
groupfinder-icon-voice,3213,236,16,14,505,521,78,92,8205,0,0,0,0
groupfinder-icon-friend,3214,236,20,19,424,444,78,97,8206,0,0,0,0
GarrBuilding_Barn_1_A_Info,3233,254,250,162,1,251,1,163,8217,0,0,0,0
GarrBuilding_Barn_2_A_Info,3234,255,250,162,1,251,1,163,8218,0,0,0,0
GarrBuilding_Barn_3_A_Info,3235,256,250,162,1,251,1,163,8219,0,0,0,0
GarrBuilding_Barn_1_A_Map,3236,257,108,85,1,109,1,86,8220,0,0,0,0
GarrBuilding_Barn_2_A_Map,3237,258,108,90,1,109,1,91,8223,0,0,0,0
GarrBuilding_Barn_3_A_Map,3238,259,108,94,1,109,1,95,8226,0,0,0,0
GarLanding-Bottom,3266,268,412,86,27,439,1,87,8227,0,0,0,0
GarLanding-Left,3267,268,93,225,27,120,148,373,8232,0,0,0,0
GarLanding-Right,3268,268,94,225,122,216,266,491,8612,0,0,0,0
GarrLanding-InvasionBadge-Glow,3271,268,280,67,122,402,197,264,8615,0,0,0,0
GarrLanding-InvasionBadge,3272,268,280,67,738,1018,1,68,8616,0,0,0,0
GarrLanding-MissionListBG,3274,268,478,64,520,998,617,681,8618,0,0,0,0
GarrLanding-Top,3279,268,413,91,520,933,315,406,8622,0,0,0,0
GarrLanding-TradeskillTimer-BG,3280,268,64,64,27,91,595,659,8623,0,0,0,0
GarrLanding_Watermark-Tradeskill,3284,268,279,277,731,1010,730,1007,8627,0,0,0,0
GarrLanding-FollowerScrollFrame,3286,268,300,384,218,518,315,699,8628,0,0,0,0
GarrLanding-lowerleft,3288,268,209,158,731,940,457,615,8630,0,0,0,0
GarrLanding-lowerright,3289,268,209,158,520,729,457,615,8631,0,0,0,0
GarrLanding-upperleft,3290,268,209,158,520,729,730,888,8632,0,0,0,0
GarrLanding-upperright,3291,268,208,158,218,426,802,960,8633,0,0,0,0
GarrLanding-HeaderBar,3293,268,772,57,27,799,89,146,8635,0,0,0,0
GarrLanding-MiddleTile,3294,269,256,256,0,256,0,256,8617,0,0,6,0
GarrLanding-Mission-Complete,3296,268,400,47,122,522,148,195,8629,0,0,0,0
GarrLanding-Mission-InProgress,3297,268,400,47,404,804,197,244,8634,0,0,0,0
GarrLanding-Building-Complete,3298,268,400,47,218,618,266,313,8636,0,0,0,0
GarrLanding-Building-InProgress,3299,268,400,47,524,924,148,195,8637,0,0,0,0
Garr_BuildingInfoShadow,3301,123,158,57,131,289,173,230,8462,0,0,0,0
GarrBuilding_Farm_1_A_Info,3302,270,250,162,1,251,1,163,8534,0,0,0,0
GarrBuilding_Farm_2_A_Info,3303,271,250,162,1,251,1,163,8535,0,0,0,0
GarrBuilding_Farm_3_A_Info,3304,272,250,162,1,251,1,163,8536,0,0,0,0
GarrBuilding_Farm_1_A_Map,3305,273,108,98,1,109,1,99,8537,0,0,0,0
GarrBuilding_Farm_2_A_Map,3306,274,108,98,1,109,1,99,8538,0,0,0,0
GarrBuilding_Farm_3_A_Map,3307,275,108,98,1,109,1,99,8539,0,0,0,0
GarrBuilding_LumberMill_1_A_Info,3320,277,250,162,1,251,1,163,8122,0,0,0,0
GarrBuilding_LumberMill_2_A_Info,3321,278,250,162,1,251,1,163,8123,0,0,0,0
GarrBuilding_LumberMill_3_A_Info,3322,279,250,162,1,251,1,163,8117,0,0,0,0
GarrBuilding_LumberMill_1_A_Map,3323,280,108,70,1,109,1,71,8118,0,0,0,0
GarrBuilding_LumberMill_2_A_Map,3324,281,108,79,1,109,1,80,8124,0,0,0,0
GarrBuilding_LumberMill_3_A_Map,3325,282,108,99,1,109,1,100,8125,0,0,0,0
GarrBuilding_SalvageYard_1_A_Info,3326,283,250,162,1,251,1,163,8126,0,0,0,0
GarrBuilding_SalvageYard_1_A_Map,3327,284,108,89,1,109,1,90,8127,0,0,0,0
GarrBuilding_SparringArena_1_A_Info,3328,285,250,162,1,251,1,163,8540,0,0,0,0
GarrBuilding_SparringArena_2_A_Info,3329,286,250,162,1,251,1,163,8541,0,0,0,0
GarrBuilding_SparringArena_3_A_Info,3330,287,250,162,1,251,1,163,8542,0,0,0,0
GarrBuilding_SparringArena_1_A_Map,3331,288,108,66,1,109,1,67,8543,0,0,0,0
GarrBuilding_SparringArena_2_A_Map,3332,289,108,81,1,109,1,82,8544,0,0,0,0
GarrBuilding_SparringArena_3_A_Map,3333,290,108,77,1,109,1,78,8545,0,0,0,0
GarrBuilding_Stables_1_A_Info,3334,291,250,162,1,251,1,163,8546,0,0,0,0
GarrBuilding_Stables_2_A_Info,3335,292,250,162,1,251,1,163,8547,0,0,0,0
GarrBuilding_Stables_3_A_Info,3336,293,250,162,1,251,1,163,8548,0,0,0,0
GarrBuilding_Stables_1_A_Map,3337,294,108,80,1,109,1,81,8549,0,0,0,0
GarrBuilding_Stables_2_A_Map,3338,295,108,71,1,109,1,72,8550,0,0,0,0
GarrBuilding_Stables_3_A_Map,3339,296,108,72,1,109,1,73,8551,0,0,0,0
GarrBuilding_Storehouse_1_A_Info,3340,297,250,162,1,251,1,163,8552,0,0,0,0
GarrBuilding_Storehouse_1_A_Map,3341,298,108,73,1,109,1,74,8553,0,0,0,0
GarrBuilding_TradingPost_1_A_Info,3342,299,250,162,1,251,1,163,8554,0,0,0,0
GarrBuilding_TradingPost_2_A_Info,3343,300,250,162,1,251,1,163,8555,0,0,0,0
GarrBuilding_TradingPost_3_A_Info,3344,301,250,162,1,251,1,163,8556,0,0,0,0
GarrBuilding_TradingPost_1_A_Map,3345,302,108,77,1,109,1,78,8557,0,0,0,0
GarrBuilding_TradingPost_2_A_Map,3346,303,108,94,1,109,1,95,8558,0,0,0,0
GarrBuilding_TradingPost_3_A_Map,3347,304,108,85,1,109,1,86,8559,0,0,0,0
Objective-ItemBorder,3351,197,81,30,1,82,171,201,8418,0,0,0,0
Garr_Building-AddFollowerPlus,3352,123,33,33,315,348,389,422,8419,0,0,0,0
Monuments-Frame,3353,307,333,91,1,334,1,92,8420,0,0,0,0
Monuments-LeftButton-Down,3354,307,35,35,466,501,1,36,8421,0,0,0,0
Monuments-LeftButton-Up,3355,307,35,35,383,418,59,94,8422,0,0,0,0
Monuments-RightButton-Down,3356,307,35,35,420,455,59,94,8423,0,0,0,0
Monuments-RightButton-Up,3357,307,35,35,457,492,59,94,8424,0,0,0,0
Monuments-LockedOverlay,3358,307,128,56,336,464,1,57,8425,0,0,0,0
Monuments-Lock,3359,307,45,59,336,381,59,118,8426,0,0,0,0
BonusChest-KeyholeBurst,3360,308,118,128,136,254,136,264,8427,0,0,0,0
BonusChest-KeyholeGlow,3361,308,45,57,136,181,454,511,8428,0,0,0,0
BonusChest-Lock,3362,308,82,104,136,218,266,370,8429,0,0,0,0
BonusChest-CircleGlow,3363,308,99,98,1,100,401,499,8430,0,0,0,0
guild-levelring,3364,309,33,30,1,34,1,31,8463,0,0,0,0
Calendar_Quest,3370,310,91,91,1,92,1,92,8464,0,0,0,0
groupfinder-highlightbar-green,3371,236,304,32,637,941,947,979,8382,0,0,0,0
groupfinder-highlightbar-yellow,3372,236,304,32,331,635,947,979,8383,0,0,0,0
groupfinder-icon-greencheckmark,3373,236,11,13,492,503,78,91,8384,0,0,0,0
groupfinder-icon-redx,3374,236,12,12,462,474,78,90,8385,0,0,0,0
groupfinder-background,3377,236,328,336,1,329,99,435,8386,0,0,0,0
groupfinder-button-arenas,3378,236,290,36,716,1006,40,76,8387,0,0,0,0
groupfinder-button-battlegrounds,3379,236,290,36,331,621,823,859,8388,0,0,0,0
groupfinder-button-cover,3380,236,300,46,1,301,835,881,8389,0,0,0,0
groupfinder-button-custom-pve,3381,236,290,36,623,913,785,821,8390,0,0,0,0
groupfinder-button-custom-pvp,3382,236,290,36,633,923,861,897,8391,0,0,0,0
groupfinder-button-dungeons,3383,236,290,36,623,913,909,945,8392,0,0,0,0
groupfinder-button-questing,3384,236,290,36,1,291,797,833,8393,0,0,0,0
groupfinder-button-raids-bc,3385,236,290,36,1,291,960,996,8394,0,0,0,0
groupfinder-button-raids-cataclysm,3386,236,290,36,1,291,759,795,8395,0,0,0,0
groupfinder-button-raids-classic,3387,236,290,36,1,291,721,757,8396,0,0,0,0
groupfinder-button-raids-mists,3388,236,290,36,1,291,883,919,8397,0,0,0,0
groupfinder-button-raids-wrath,3389,236,290,36,331,621,981,1017,8398,0,0,0,0
groupfinder-button-ratedbgs,3390,236,290,36,424,714,40,76,8399,0,0,0,0
groupfinder-button-scenarios,3391,236,290,36,331,621,909,945,8400,0,0,0,0
groupfinder-button-skirmishes,3392,236,290,36,623,913,823,859,8401,0,0,0,0
groupfinder-highlightbar-blue,3393,236,304,32,718,1022,1,33,8402,0,0,0,0
Garr_SwapIcon,3395,123,46,46,289,335,463,509,8572,0,0,0,0
Garr_BuildFX-Glow,3396,123,49,80,351,400,371,451,8573,0,0,0,0
Garr_BuildFX-Lines,3397,123,27,84,99,126,256,340,8574,0,0,0,0
Garr_LockedBuilding,3398,123,68,83,241,309,304,387,8575,0,0,0,0
Garr_UpgradeFX-Glow,3399,123,49,80,425,474,232,312,8431,0,0,0,0
BonusChest-ItemBorder-Uncommon,3403,308,66,66,405,471,64,130,8501,0,0,0,0
BonusChest-Burst-Uncommon,3404,308,156,133,1,157,1,134,8502,0,0,0,0
bags-glow-purple,3409,202,39,39,1,40,138,177,8576,0,0,0,0
bags-glow-blue,3410,202,39,39,139,178,42,81,8577,0,0,0,0
bags-glow-orange,3411,202,39,39,181,220,93,132,8578,0,0,0,0
bags-glow-green,3412,202,39,39,180,219,1,40,8579,0,0,0,0
bags-glow-heirloom,3413,202,39,39,180,219,42,81,8580,0,0,0,0
bags-glow-white,3414,202,39,39,1,40,179,218,8581,0,0,0,0
bags-glow-flash,3418,202,90,90,1,91,1,91,8465,0,0,0,0
LFG-lock,3423,314,17,21,30,47,1,22,8650,0,0,0,0
Garr_Building_MaterialFrame,3431,123,290,43,274,564,63,106,8651,0,0,0,0
Garr_Mission_MaterialFrame,3433,156,316,43,1,317,622,665,8653,0,0,0,0
GarrMission_RewardsListBG,3434,156,218,75,292,510,427,502,8652,0,0,0,0
GarrMission_RewardsShadow,3435,156,54,54,352,406,504,558,8654,0,0,0,0
Garr_MissionList-CostBG,3436,156,143,30,1,144,200,230,8655,0,0,0,0
Garr_MissionList-IconBG,3437,156,150,76,292,442,859,935,8403,0,0,0,0
GarrMission_ParchmentHeaderSelect-End,3446,156,65,41,403,468,375,416,8404,0,0,0,0
_GarrMission_ParchmentHeaderSelect-Mid,3448,156,128,41,0,128,157,198,8405,0,0,4,0
GarrMission_MissionCostStartButtonBg,3449,152,376,51,433,809,470,521,8406,0,0,0,0
GarMission_ChestPercentageShadow,3450,152,72,50,655,727,970,1020,8407,0,0,0,0
GarrMission_ChestOpenTextGlow,3451,152,189,42,811,1000,470,512,8408,0,0,0,0
GarrMission_PortraitRing_Glow,3452,152,59,62,887,946,877,939,8409,0,0,0,0
GarrMission_PortraitRing_Highlight,3453,152,59,62,948,1007,877,939,8410,0,0,0,0
splash-bigbutton,3454,319,356,99,1,357,18,117,8432,0,0,0,0
BonusChest-Smoke-Uncommon,3457,308,80,80,136,216,372,452,8411,0,0,0,0
splash-botleft,3463,319,368,15,1,369,1,16,8437,0,0,0,0
splash-boost-botleft,3464,320,137,371,374,511,587,958,8438,0,0,0,0
splash-boost-right,3465,320,510,584,1,511,1,585,8439,0,0,0,0
splash-boost-topleft,3466,320,371,434,1,372,587,1021,8440,0,0,0,0
splash-601-botleft,3467,321,137,371,374,511,587,958,8441,0,0,0,0
splash-601-right,3468,321,510,584,1,511,1,585,8433,0,0,0,0
splash-601-topleft,3469,321,371,434,1,372,587,1021,8434,0,0,0,0
splash-600-botleft,3470,322,137,371,374,511,587,958,8435,0,0,0,0
splash-600-right,3471,322,510,584,1,511,1,585,8436,0,0,0,0
splash-600-topleft,3472,322,371,434,1,372,587,1021,8442,0,0,0,0
GarrMission_CheckGlow,3473,152,32,32,218,250,962,994,8412,0,0,0,0
GarrMission_MissionIcon-Blacksmithing,3474,323,64,64,67,131,1,65,8413,0,0,0,0
GarrMission_MissionIcon-Combat,3475,323,64,64,133,197,1,65,8414,0,0,0,0
GarrMission_MissionIcon-Exploration,3476,323,64,64,1,65,67,131,8415,0,0,0,0
GarrMission_ClassIcon-Hunter,3477,324,55,49,115,170,1,50,8416,0,0,0,0
GarrMission_ClassIcon-Warrior,3478,324,55,49,172,227,52,101,8417,0,0,0,0
GarrMission_ClassIcon-Priest,3479,324,55,49,1,56,154,203,8443,0,0,0,0
GarrMission_ClassIcon-Monk,3480,324,55,49,1,56,52,101,8466,0,0,0,0
GarrMission_ClassIcon-Rogue,3481,324,55,49,1,56,205,254,8467,0,0,0,0
GarrMission_ClassIcon-Mage,3482,324,55,49,172,227,1,50,8468,0,0,0,0
GarrMission_ClassIcon-Warlock,3483,324,55,49,115,170,52,101,8469,0,0,0,0
GarrMission_ClassIcon-Shaman,3484,324,55,49,58,113,52,101,8470,0,0,0,0
GarrMission_ClassIcon-Druid,3485,324,55,49,58,113,1,50,8471,0,0,0,0
GarrMission_ClassIcon-Paladin,3486,324,55,49,1,56,103,152,8472,0,0,0,0
GarrMission_ClassIcon-DeathKnight,3487,324,55,49,1,56,1,50,8473,0,0,0,0
GarrMission_EncounterBar-Xright,3491,152,93,96,655,748,872,968,8474,0,0,0,0
Garr_MissionFX-Glow,3492,152,49,80,967,1016,313,393,8475,0,0,0,0
Garr_MissionFX-Lines,3493,152,27,84,269,296,900,984,8476,0,0,0,0
groupfinder-icon-leader,3494,236,14,9,446,460,78,87,8444,0,0,0,0
Garr_Map_Frostfire4_H,3504,330,672,468,1,673,1,469,8233,0,0,0,0
Garr_Map_Shadowmoon4_A,3505,331,672,468,1,673,1,469,8236,0,0,0,0
GarrMission-FollowerItemBg,3506,156,181,41,319,500,622,663,8242,0,0,0,0
bags-button-autosort-down,3507,202,28,26,1,29,220,246,8251,0,0,0,0
bags-button-autosort-up,3508,202,28,26,42,70,214,240,8252,0,0,0,0
bags-roundhighlight,3509,202,36,36,42,78,176,212,8255,0,0,0,0
GarrLanding-MinimapIcon-Alliance-Down,3510,268,53,53,635,688,1,54,8256,0,0,0,0
GarrLanding-MinimapIcon-Alliance-Up,3511,268,53,53,27,80,430,483,8257,0,0,0,0
GarrLanding-MinimapIcon-Horde-Up,3512,268,53,53,27,80,375,428,8258,0,0,0,0
GarrLanding-MinimapIcon-Horde-Down,3513,268,53,53,514,567,1,54,8259,0,0,0,0
GarrLanding-CircleGlow,3515,268,46,46,690,736,1,47,8445,0,0,0,0
GarrLanding-MinimapAlertBG,3516,268,174,46,801,975,89,135,8446,0,0,0,0
GarrLanding-SideToast-Glow,3517,268,99,99,218,317,701,800,8447,0,0,0,0
GarrLanding-TopTabHighlight,3519,268,191,24,806,997,197,221,8448,0,0,0,0
GarrLanding-TopTabSelected,3520,268,205,36,218,423,962,998,8449,0,0,0,0
GarrLanding-TopTabUnselected,3521,268,205,30,806,1011,223,253,8450,0,0,0,0
Alliance_Tier1_Barracks,3529,333,52,54,207,259,57,111,8582,0,0,0,0
Alliance_Tier1_Professions,3530,333,38,43,261,299,193,236,8583,0,0,0,0
Alliance_Tier1_TownHall,3531,333,41,40,468,509,1,41,8584,0,0,0,0
GarrMission_MissionStart,3538,156,222,40,269,491,801,841,8454,0,0,0,0
loottoast-arrow-blue,3545,332,21,25,1,22,214,239,8487,0,0,0,0
loottoast-arrow-green,3546,332,21,25,24,45,214,239,8488,0,0,0,0
loottoast-arrow-orange,3547,332,21,25,47,68,214,239,8489,0,0,0,0
loottoast-arrow-purple,3548,332,21,25,70,91,214,239,8490,0,0,0,0
loottoast-bg-questrewardupgrade,3549,332,276,96,569,845,1,97,8491,0,0,0,0
loottoast-glow,3550,332,286,109,1,287,1,110,8492,0,0,0,0
loottoast-itemborder-blue,3551,332,58,58,569,627,181,239,8493,0,0,0,0
loottoast-itemborder-glow,3552,332,68,68,847,915,99,167,8494,0,0,0,0
loottoast-itemborder-green,3553,332,58,58,629,687,181,239,8495,0,0,0,0
loottoast-itemborder-orange,3554,332,58,58,749,807,181,239,8496,0,0,0,0
loottoast-itemborder-purple,3555,332,58,58,809,867,181,239,8497,0,0,0,0
loottoast-sheen,3556,332,171,75,847,1018,1,76,8498,0,0,0,0
Headhunter_AbilityBorderGlow,3557,334,32,32,1,33,372,404,8585,0,0,0,0
Headhunter_BG,3558,334,321,369,1,322,1,370,8586,0,0,0,0
Headhunter_LineHeader,3559,334,223,1,35,258,372,373,8587,0,0,0,0
_GarrMissionLocation-FrostfireRidge-Back,3560,335,1024,285,0,1024,1,286,8477,0,0,4,0
_GarrMissionLocation-FrostfireRidge-Fore,3561,335,1024,285,0,1024,288,573,8478,0,0,4,0
_GarrMissionLocation-FrostfireRidge-Mid,3562,335,1024,285,0,1024,575,860,8479,0,0,4,0
GarrLanding_RewardsShadow,3563,268,34,34,690,724,49,83,8499,0,0,0,0
GarrLanding_RewardsListBG,3564,268,132,45,520,652,683,728,8500,0,0,0,0
GarrLandingList-CostBG,3565,268,120,18,404,524,246,264,8503,0,0,0,0
GarrMission_MissionIcon-Enchanting,3566,323,64,64,331,395,1,65,8560,0,0,0,0
GarrMission_MissionIcon-Salvage,3567,323,64,64,265,329,67,131,8561,0,0,0,0
GarrMission_MissionIcon-Provision,3568,323,64,64,133,197,67,131,8562,0,0,0,0
GarrMission_MissionIcon-Generic,3569,323,64,64,1,65,133,197,8563,0,0,0,0
GarrMission_MissionIcon-Siege,3570,323,64,64,331,395,67,131,8564,0,0,0,0
GarrMission_MissionIcon-Alchemy,3571,323,64,64,1,65,1,65,8565,0,0,0,0
GarrMission_MissionIcon-Wildlife,3572,323,64,64,67,131,265,329,8566,0,0,0,0
GarrMission_MissionIcon-Tailoring,3573,323,64,64,397,461,67,131,8567,0,0,0,0
GarrMission_MissionIcon-Training,3574,323,64,64,67,131,199,263,8568,0,0,0,0
GarrMission_MissionIcon-Trading,3575,323,64,64,67,131,133,197,8569,0,0,0,0
GarrMission_MissionIcon-Jewelcrafting,3576,323,64,64,1,65,265,329,8570,0,0,0,0
GarrMission_MissionIcon-Defense,3577,323,64,64,265,329,1,65,8571,0,0,0,0
GarrMission_MissionIcon-Construction,3578,323,64,64,199,263,1,65,8588,0,0,0,0
GarrMission_MissionIcon-Inscription,3579,323,64,64,1,65,199,263,8589,0,0,0,0
GarrMission_MissionIcon-Logistics,3580,323,64,64,1,65,397,461,8590,0,0,0,0
GarrMission_MissionIcon-Engineering,3581,323,64,64,397,461,1,65,8591,0,0,0,0
GarrMission_MissionIcon-Patrol,3582,323,64,64,67,131,67,131,8592,0,0,0,0
GarrMission_MissionIcon-Recruit,3583,323,64,64,199,263,67,131,8593,0,0,0,0
GarrMission_MissionIcon-Leatherworking,3584,323,64,64,1,65,331,395,8594,0,0,0,0
GarrBuilding_Jewelcrafting_1_A_Info,3586,336,250,162,1,251,1,163,8480,0,0,0,0
GarrBuilding_Jewelcrafting_2_A_Info,3587,337,250,162,1,251,1,163,8481,0,0,0,0
GarrBuilding_Jewelcrafting_3_A_Info,3588,338,250,162,1,251,1,163,8482,0,0,0,0
GarrBuilding_Jewelcrafting_1_A_Map,3589,339,108,72,1,109,1,73,8483,0,0,0,0
GarrBuilding_Jewelcrafting_2_A_Map,3590,340,108,70,1,109,1,71,8484,0,0,0,0
GarrBuilding_Jewelcrafting_3_A_Map,3591,341,108,76,1,109,1,77,8485,0,0,0,0
GarrBuilding_Enchanting_1_A_Info,3592,342,250,162,1,251,1,163,8486,0,0,0,0
GarrBuilding_Enchanting_2_A_Info,3593,343,250,162,1,251,1,163,8504,0,0,0,0
GarrBuilding_Enchanting_3_A_Info,3594,344,250,162,1,251,1,163,8505,0,0,0,0
GarrBuilding_Enchanting_1_A_Map,3595,345,108,72,1,109,1,73,8506,0,0,0,0
GarrBuilding_Enchanting_2_A_Map,3596,346,108,72,1,109,1,73,8507,0,0,0,0
GarrBuilding_Enchanting_3_A_Map,3597,347,108,72,1,109,1,73,8508,0,0,0,0
GarrBuilding_Blacksmith_1_A_Info,3598,348,250,162,1,251,1,163,8509,0,0,0,0
GarrBuilding_Blacksmith_2_A_Info,3599,349,250,162,1,251,1,163,8510,0,0,0,0
GarrBuilding_Blacksmith_3_A_Info,3600,350,250,162,1,251,1,163,8511,0,0,0,0
GarrBuilding_Blacksmith_1_A_Map,3601,351,108,74,1,109,1,75,8512,0,0,0,0
GarrBuilding_Blacksmith_2_A_Map,3602,352,108,75,1,109,1,76,8513,0,0,0,0
GarrBuilding_Blacksmith_3_A_Map,3603,353,108,76,1,109,1,77,8514,0,0,0,0
GarrBuilding_Fishing_1_A_Info,3604,354,250,162,1,251,1,163,8515,0,0,0,0
GarrBuilding_Fishing_2_A_Info,3605,355,250,162,1,251,1,163,8516,0,0,0,0
GarrBuilding_Fishing_3_A_Info,3606,356,250,162,1,251,1,163,8517,0,0,0,0
GarrBuilding_Fishing_1_A_Map,3607,357,108,74,1,109,1,75,8518,0,0,0,0
GarrBuilding_Fishing_2_A_Map,3608,358,108,75,1,109,1,76,8519,0,0,0,0
GarrBuilding_Fishing_3_A_Map,3609,359,108,78,1,109,1,79,8520,0,0,0,0
GarrBuilding_Workshop_1_A_Info,3610,360,250,162,1,251,1,163,8451,0,0,0,0
GarrBuilding_Workshop_2_A_Info,3611,361,250,162,1,251,1,163,8452,0,0,0,0
GarrBuilding_Workshop_3_A_Info,3612,362,250,162,1,251,1,163,8453,0,0,0,0
GarrBuilding_Workshop_1_A_Map,3613,363,108,78,1,109,1,79,8455,0,0,0,0
GarrBuilding_Workshop_2_A_Map,3614,364,108,87,1,109,1,88,8456,0,0,0,0
GarrBuilding_Workshop_3_A_Map,3615,365,108,96,1,109,1,97,8457,0,0,0,0
groupfinder-eye-highlight,3616,236,86,86,336,422,1,87,8596,0,0,0,0
GarrBuilding_Tailoring_1_A_Info,3618,366,250,162,1,251,1,163,8597,0,0,0,0
GarrBuilding_Tailoring_2_A_Info,3619,367,250,162,1,251,1,163,8598,0,0,0,0
GarrBuilding_Tailoring_3_A_Info,3620,368,250,162,1,251,1,163,8599,0,0,0,0
GarrBuilding_Tailoring_1_A_Map,3621,369,108,73,1,109,1,74,8600,0,0,0,0
GarrBuilding_Tailoring_2_A_Map,3622,370,108,75,1,109,1,76,8601,0,0,0,0
GarrBuilding_Tailoring_3_A_Map,3623,371,108,76,1,109,1,77,8602,0,0,0,0
GarrBuilding_Inscription_1_A_Info,3624,372,250,162,1,251,1,163,8603,0,0,0,0
GarrBuilding_Inscription_2_A_Info,3625,373,250,162,1,251,1,163,8604,0,0,0,0
GarrBuilding_Inscription_3_A_Info,3626,374,250,162,1,251,1,163,8605,0,0,0,0
GarrBuilding_Inscription_1_A_Map,3627,375,108,75,1,109,1,76,8606,0,0,0,0
GarrBuilding_Inscription_2_A_Map,3628,376,108,91,1,109,1,92,8607,0,0,0,0
GarrBuilding_Inscription_3_A_Map,3629,377,108,91,1,109,1,92,8608,0,0,0,0
GarrBuilding_Leatherworking_1_A_Info,3630,378,250,162,1,251,1,163,8609,0,0,0,0
GarrBuilding_Leatherworking_2_A_Info,3631,379,250,162,1,251,1,163,8610,0,0,0,0
GarrBuilding_Leatherworking_3_A_Info,3632,380,250,162,1,251,1,163,8611,0,0,0,0
GarrBuilding_Leatherworking_1_A_Map,3633,381,108,70,1,109,1,71,8458,0,0,0,0
GarrBuilding_Leatherworking_2_A_Map,3634,382,108,72,1,109,1,73,8459,0,0,0,0
GarrBuilding_Leatherworking_3_A_Map,3635,383,108,74,1,109,1,75,8460,0,0,0,0
GarrLanding-TradeskillTimer-ParchmentBG,3636,268,64,64,569,633,1,65,8461,0,0,0,0
GarrBuilding_EmptyPlot_A_1,3689,391,250,162,1,251,1,163,8521,0,0,0,0
GarrBuilding_EmptyPlot_A_2,3690,392,250,162,1,251,1,163,8522,0,0,0,0
GarrBuilding_EmptyPlot_A_3,3691,393,250,162,1,251,1,163,8523,0,0,0,0
GarrLanding-ShipmentCompleteGlow,3692,268,96,96,319,415,701,797,8524,0,0,0,0
GarrBuilding_PetStable_1_A_Info,3693,394,250,162,1,251,1,163,8525,0,0,0,0
GarrBuilding_PetStable_1_A_Map,3694,395,108,72,1,109,1,73,8526,0,0,0,0
_GarrMissionLocation-Gorgrond-Back,3695,396,1024,285,0,1024,1,286,8527,0,0,4,0
_GarrMissionLocation-Gorgrond-Fore,3696,396,1024,285,0,1024,288,573,8528,0,0,4,0
_GarrMissionLocation-Nagrand-Back,3698,397,1024,285,0,1024,1,286,8529,0,0,4,0
_GarrMissionLocation-Nagrand-Fore,3699,397,1024,285,0,1024,288,573,8530,0,0,4,0
_GarrMissionLocation-Nagrand-Mid,3700,397,1024,285,0,1024,575,860,8531,0,0,4,0
_GarrMissionLocation-Talador-Back,3701,398,1024,285,0,1024,1,286,8532,0,0,4,0
_GarrMissionLocation-Talador-Fore,3702,398,1024,285,0,1024,288,573,8533,0,0,4,0
_GarrMissionLocation-Talador-Mid,3703,398,1024,285,0,1024,575,860,8826,0,0,4,0
_GarrMissionLocation-ShadowmoonValley-Back,3704,399,1024,285,0,1024,1,286,8827,0,0,4,0
_GarrMissionLocation-ShadowmoonValley-Fore,3705,399,1024,285,0,1024,288,573,8828,0,0,4,0
_GarrMissionLocation-ShadowmoonValley-Mid,3706,399,1024,285,0,1024,575,860,8829,0,0,4,0
_GarrMissionLocation-SpiresofArak-Back,3707,400,1024,285,0,1024,1,286,8830,0,0,4,0
_GarrMissionLocation-SpiresofArak-Fore,3708,400,1024,285,0,1024,288,573,8831,0,0,4,0
_GarrMissionLocation-SpiresofArak-Mid,3709,400,1024,285,0,1024,575,860,8832,0,0,4,0
_GarrMissionLocation-Underground-Back,3710,401,1024,285,0,1024,1,286,8833,0,0,4,0
_GarrMissionLocation-Underground-Fore,3711,401,1024,285,0,1024,288,573,8834,0,0,4,0
_GarrMissionLocation-Underground-Mid,3712,401,1024,285,0,1024,575,860,8835,0,0,4,0
_GarrMissionLocation-TownHorde-Back,3713,402,1024,285,0,1024,1,286,8836,0,0,4,0
_GarrMissionLocation-TownHorde-Fore,3714,402,1024,285,0,1024,288,573,8837,0,0,4,0
_GarrMissionLocation-TownHorde-Mid,3715,402,1024,285,0,1024,575,860,8838,0,0,4,0
_GarrMissionLocation-TownAlliance-Back,3716,403,1024,285,0,1024,1,286,8839,0,0,4,0
_GarrMissionLocation-TownAlliance-Fore,3717,403,1024,285,0,1024,288,573,8840,0,0,4,0
_GarrMissionLocation-TownAlliance-Mid,3718,403,1024,285,0,1024,575,860,8841,0,0,4,0
GarrBuilding_Tailoring_1_H_Info,3719,404,250,162,1,251,1,163,8953,0,0,0,0
GarrBuilding_Tailoring_1_H_Map,3720,405,108,86,1,109,1,87,8954,0,0,0,0
GarrBuilding_Tailoring_2_H_Info,3721,406,250,162,1,251,1,163,8955,0,0,0,0
GarrBuilding_Tailoring_3_H_Info,3722,407,250,162,1,251,1,163,8956,0,0,0,0
GarrBuilding_Tailoring_2_H_Map,3723,408,108,83,1,109,1,84,8957,0,0,0,0
GarrBuilding_Tailoring_3_H_Map,3724,409,108,84,1,109,1,85,8958,0,0,0,0
GarrBuilding_Leatherworking_1_H_Info,3725,410,250,162,1,251,1,163,8698,0,0,0,0
GarrBuilding_Leatherworking_2_H_Info,3726,411,250,162,1,251,1,163,8699,0,0,0,0
GarrBuilding_Leatherworking_3_H_Info,3727,412,250,162,1,251,1,163,8700,0,0,0,0
GarrBuilding_Leatherworking_1_H_Map,3728,413,108,78,1,109,1,79,8701,0,0,0,0
GarrBuilding_Leatherworking_2_H_Map,3729,414,108,78,1,109,1,79,8702,0,0,0,0
GarrBuilding_Leatherworking_3_H_Map,3730,415,108,87,1,109,1,88,8703,0,0,0,0
GarrBuilding_Jewelcrafting_1_H_Info,3731,416,250,162,1,251,1,163,8959,0,0,0,0
GarrBuilding_Jewelcrafting_2_H_Info,3732,417,250,162,1,251,1,163,8960,0,0,0,0
GarrBuilding_Jewelcrafting_3_H_Info,3733,418,250,162,1,251,1,163,8961,0,0,0,0
GarrBuilding_Jewelcrafting_1_H_Map,3734,419,108,80,1,109,1,81,8962,0,0,0,0
GarrBuilding_Jewelcrafting_2_H_Map,3735,420,108,85,1,109,1,86,8963,0,0,0,0
GarrBuilding_Jewelcrafting_3_H_Map,3736,421,108,93,1,109,1,94,8964,0,0,0,0
GarrBuilding_Inscription_1_H_Info,3737,423,250,162,1,251,1,163,8965,0,0,0,0
GarrBuilding_Inscription_2_H_Info,3738,424,250,162,1,251,1,163,8966,0,0,0,0
GarrBuilding_Inscription_3_H_Info,3739,425,250,162,1,251,1,163,8967,0,0,0,0
GarrBuilding_Inscription_1_H_Map,3740,426,108,78,1,109,1,79,8968,0,0,0,0
GarrBuilding_Inscription_2_H_Map,3741,427,108,87,1,109,1,88,8969,0,0,0,0
GarrBuilding_Inscription_3_H_Map,3743,429,108,90,1,109,1,91,8971,0,0,0,0
GarrBuilding_Engineering_1_H_Info,3744,430,250,162,1,251,1,163,8972,0,0,0,0
GarrBuilding_Engineering_2_H_Info,3745,431,250,162,1,251,1,163,8970,0,0,0,0
GarrBuilding_Engineering_3_H_Info,3746,432,250,162,1,251,1,163,8973,0,0,0,0
GarrBuilding_Engineering_1_H_Map,3747,433,108,79,1,109,1,80,8974,0,0,0,0
GarrBuilding_Engineering_2_H_Map,3748,434,108,79,1,109,1,80,8975,0,0,0,0
GarrBuilding_Engineering_3_H_Map,3749,435,108,81,1,109,1,82,8976,0,0,0,0
GarrBuilding_Enchanting_1_H_Info,3751,437,250,162,1,251,1,163,8659,0,0,0,0
GarrBuilding_Enchanting_2_H_Info,3752,438,250,162,1,251,1,163,8660,0,0,0,0
GarrBuilding_Enchanting_3_H_Info,3753,439,250,162,1,251,1,163,8658,0,0,0,0
GarrBuilding_Enchanting_1_H_Map,3754,440,108,82,1,109,1,83,8661,0,0,0,0
GarrBuilding_Enchanting_2_H_Map,3755,441,108,83,1,109,1,84,8662,0,0,0,0
GarrBuilding_Enchanting_3_H_Map,3756,442,108,81,1,109,1,82,8663,0,0,0,0
GarrBuilding_Blacksmith_1_H_Info,3757,443,250,162,1,251,1,163,8913,0,0,0,0
GarrBuilding_Blacksmith_2_H_Info,3758,444,250,162,1,251,1,163,8914,0,0,0,0
GarrBuilding_Blacksmith_3_H_Info,3759,445,250,162,1,251,1,163,8915,0,0,0,0
GarrBuilding_Blacksmith_1_H_Map,3760,446,108,78,1,109,1,79,8916,0,0,0,0
GarrBuilding_Blacksmith_2_H_Map,3761,447,108,77,1,109,1,78,8917,0,0,0,0
GarrBuilding_Blacksmith_3_H_Map,3762,448,108,80,1,109,1,81,8918,0,0,0,0
GarrBuilding_Alchemy_1_H_Info,3763,449,250,162,1,251,1,163,8919,0,0,0,0
GarrBuilding_Alchemy_2_H_Info,3764,450,250,162,1,251,1,163,8920,0,0,0,0
GarrBuilding_Alchemy_3_H_Info,3765,451,250,162,1,251,1,163,8921,0,0,0,0
GarrBuilding_Alchemy_1_H_Map,3766,452,108,79,1,109,1,80,8922,0,0,0,0
GarrBuilding_Alchemy_2_H_Map,3767,453,108,79,1,109,1,80,8923,0,0,0,0
GarrBuilding_Alchemy_3_H_Map,3768,454,108,82,1,109,1,83,8924,0,0,0,0
GarrBuilding_Barn_1_H_Info,3769,455,250,162,1,251,1,163,8925,0,0,0,0
GarrBuilding_Barn_2_H_Info,3770,456,250,162,1,251,1,163,8926,0,0,0,0
GarrBuilding_Barn_3_H_Info,3771,457,250,162,1,251,1,163,8927,0,0,0,0
GarrBuilding_Barn_1_H_Map,3772,458,108,81,1,109,1,82,8928,0,0,0,0
GarrBuilding_Barn_2_H_Map,3773,459,108,88,1,109,1,89,8929,0,0,0,0
GarrBuilding_Barn_3_H_Map,3774,460,108,97,1,109,1,98,8930,0,0,0,0
GarrBuilding_Fishing_1_H_Info,3775,461,250,162,1,251,1,163,8931,0,0,0,0
GarrBuilding_Fishing_2_H_Info,3776,462,250,162,1,251,1,163,8932,0,0,0,0
GarrBuilding_Fishing_3_H_Info,3777,463,250,162,1,251,1,163,8933,0,0,0,0
GarrBuilding_Fishing_1_H_Map,3778,464,108,80,1,109,1,81,8934,0,0,0,0
GarrBuilding_Fishing_2_H_Map,3779,465,108,84,1,109,1,85,8935,0,0,0,0
GarrBuilding_Fishing_3_H_Map,3780,466,108,80,1,109,1,81,8936,0,0,0,0
GarrBuilding_Farm_1_H_Info,3781,467,250,162,1,251,1,163,8937,0,0,0,0
GarrBuilding_Farm_1_H_Map,3782,468,108,94,1,109,1,95,8938,0,0,0,0
GarrBuilding_EmptyPlot_H_3,3783,469,250,162,1,251,1,163,8939,0,0,0,0
GarrBuilding_EmptyPlot_H_2,3784,470,250,162,1,251,1,163,8940,0,0,0,0
GarrBuilding_EmptyPlot_H_1,3785,471,250,162,1,251,1,163,8941,0,0,0,0
GarrBuilding_Inn_1_H_Info,3786,472,250,162,1,251,1,163,8664,0,0,0,0
GarrBuilding_Inn_2_H_Info,3787,473,250,162,1,251,1,163,8665,0,0,0,0
GarrBuilding_Inn_3_H_Info,3788,474,250,162,1,251,1,163,8666,0,0,0,0
GarrBuilding_Inn_1_H_Map,3789,475,108,88,1,109,1,89,8667,0,0,0,0
GarrBuilding_Inn_2_H_Map,3790,476,108,100,1,109,1,101,8668,0,0,0,0
GarrBuilding_Inn_3_H_Map,3791,477,108,116,1,109,1,117,8669,0,0,0,0
GarrBuilding_TownHall_1_H_Info,3792,478,250,162,1,251,1,163,8670,0,0,0,0
GarrBuilding_TownHall_2_H_Info,3793,479,250,162,1,251,1,163,8671,0,0,0,0
GarrBuilding_TownHall_3_H_Info,3794,480,250,162,1,251,1,163,8672,0,0,0,0
GarrBuilding_TownHall_1_H_Map,3795,481,108,102,1,109,1,103,8673,0,0,0,0
GarrBuilding_TownHall_2_H_Map,3796,482,108,107,1,109,1,108,8674,0,0,0,0
GarrBuilding_TownHall_3_H_Map,3797,483,108,111,1,109,1,112,8675,0,0,0,0
GarrBuilding_Storehouse_1_H_Info,3798,484,250,162,1,251,1,163,8676,0,0,0,0
GarrBuilding_Storehouse_1_H_Map,3799,485,108,80,1,109,1,81,8677,0,0,0,0
GarrBuilding_SalvageYard_1_H_Info,3800,486,250,162,1,251,1,163,8678,0,0,0,0
GarrBuilding_SalvageYard_1_H_Map,3801,487,108,86,1,109,1,87,8679,0,0,0,0
GarrBuilding_Barracks_1_H_Info,3802,488,250,162,1,251,1,163,8680,0,0,0,0
GarrBuilding_Barracks_2_H_Info,3803,489,250,162,1,251,1,163,8681,0,0,0,0
GarrBuilding_Barracks_3_H_Info,3804,490,250,162,1,251,1,163,8682,0,0,0,0
GarrBuilding_Barracks_1_H_Map,3805,491,108,86,1,109,1,87,8683,0,0,0,0
GarrBuilding_Barracks_2_H_Map,3806,492,108,85,1,109,1,86,8684,0,0,0,0
GarrBuilding_Barracks_3_H_Map,3807,493,108,104,1,109,1,105,8685,0,0,0,0
GarrBuilding_SparringArena_1_H_Info,3817,496,250,162,1,251,1,163,8686,0,0,0,0
GarrBuilding_SparringArena_2_H_Info,3818,497,250,162,1,251,1,163,8687,0,0,0,0
GarrBuilding_SparringArena_3_H_Info,3819,498,250,162,1,251,1,163,8688,0,0,0,0
GarrBuilding_SparringArena_1_H_Map,3820,499,108,67,1,109,1,68,8689,0,0,0,0
GarrBuilding_SparringArena_2_H_Map,3821,500,108,76,1,109,1,77,8690,0,0,0,0
GarrBuilding_SparringArena_3_H_Map,3822,501,108,70,1,109,1,71,8691,0,0,0,0
GarrBuilding_Armory_1_H_Info,3823,502,250,162,1,251,1,163,8692,0,0,0,0
GarrBuilding_Armory_2_H_Info,3824,503,250,162,1,251,1,163,8693,0,0,0,0
GarrBuilding_Armory_3_H_Info,3825,504,250,162,1,251,1,163,8694,0,0,0,0
GarrBuilding_Armory_1_H_Map,3826,505,108,81,1,109,1,82,8695,0,0,0,0
GarrBuilding_Armory_2_H_Map,3827,506,108,86,1,109,1,87,8696,0,0,0,0
GarrBuilding_Armory_3_H_Map,3828,507,108,98,1,109,1,99,8697,0,0,0,0
GarrBuilding_MageTower_1_H_Info,3829,508,250,162,1,251,1,163,8704,0,0,0,0
GarrBuilding_MageTower_2_H_Info,3830,509,250,162,1,251,1,163,8785,0,0,0,0
GarrBuilding_MageTower_3_H_Info,3831,510,250,162,1,251,1,163,8786,0,0,0,0
GarrFollower-Shadow,3832,156,342,141,1,343,232,373,8787,0,0,0,0
GarrBuilding_MageTower_1_H_Map,3833,511,108,90,1,109,1,91,8788,0,0,0,0
GarrBuilding_MageTower_2_H_Map,3834,512,108,111,1,109,1,112,8789,0,0,0,0
GarrBuilding_MageTower_3_H_Map,3835,513,108,125,1,109,1,126,8790,0,0,0,0
GarrBuilding_Stables_2_H_Info,3837,515,250,162,1,251,1,163,8792,0,0,0,0
GarrBuilding_Stables_3_H_Info,3838,516,250,162,1,251,1,163,8793,0,0,0,0
GarrBuilding_Stables_1_H_Info,3839,514,250,162,1,251,1,163,8794,0,0,0,0
GarrBuilding_Stables_1_H_Map,3840,517,108,71,1,109,1,72,8795,0,0,0,0
GarrBuilding_Stables_2_H_Map,3841,518,108,71,1,109,1,72,8791,0,0,0,0
GarrBuilding_Stables_3_H_Map,3842,519,108,87,1,109,1,88,8796,0,0,0,0
GarrBuilding_TradingPost_1_H_Info,3843,520,250,162,1,251,1,163,8797,0,0,0,0
GarrBuilding_TradingPost_2_H_Info,3844,521,250,162,1,251,1,163,8798,0,0,0,0
GarrBuilding_TradingPost_3_H_Info,3845,522,250,162,1,251,1,163,8799,0,0,0,0
GarrBuilding_TradingPost_1_H_Map,3846,523,108,65,1,109,1,66,8800,0,0,0,0
GarrBuilding_TradingPost_2_H_Map,3848,525,108,95,1,109,1,96,8801,0,0,0,0
GarrBuilding_TradingPost_3_H_Map,3849,526,108,93,1,109,1,94,8802,0,0,0,0
GarrBuilding_Workshop_1_H_Info,3852,529,250,162,1,251,1,163,8803,0,0,0,0
GarrBuilding_Workshop_2_H_Info,3853,530,250,162,1,251,1,163,8804,0,0,0,0
GarrBuilding_Workshop_3_H_Info,3854,531,250,162,1,251,1,163,8805,0,0,0,0
GarrBuilding_Workshop_1_H_Map,3855,532,108,101,1,109,1,102,8806,0,0,0,0
GarrBuilding_Workshop_2_H_Map,3856,533,108,96,1,109,1,97,8807,0,0,0,0
GarrBuilding_Workshop_3_H_Map,3857,534,108,97,1,109,1,98,8808,0,0,0,0
GarrBuilding_Mine_1_H_Info,3859,536,250,162,1,251,1,163,8809,0,0,0,0
GarrBuilding_Mine_1_H_Map,3861,538,108,78,1,109,1,79,8810,0,0,0,0
GarrBuilding_LumberMill_1_H_Info,3862,539,250,162,1,251,1,163,8811,0,0,0,0
GarrBuilding_LumberMill_2_H_Info,3863,540,250,162,1,251,1,163,8812,0,0,0,0
GarrBuilding_LumberMill_3_H_Info,3864,541,250,162,1,251,1,163,8813,0,0,0,0
GarrBuilding_LumberMill_1_H_Map,3865,542,108,73,1,109,1,74,8814,0,0,0,0
GarrBuilding_LumberMill_2_H_Map,3866,543,108,82,1,109,1,83,8815,0,0,0,0
GarrBuilding_LumberMill_3_H_Map,3867,544,108,94,1,109,1,95,8816,0,0,0,0
GarrBuilding_PetStable_1_H_Info,3868,545,250,162,1,251,1,163,8817,0,0,0,0
GarrBuilding_PetStable_1_H_Map,3869,546,108,78,1,109,1,79,8818,0,0,0,0
GarrMission-AllianceChest,3873,152,209,155,269,478,313,468,8867,0,0,0,0
GarrMission-HordeChest,3874,152,209,155,480,689,313,468,8868,0,0,0,0
DungeonTargetIndicator,3875,314,27,29,1,28,1,30,8869,0,0,0,0
GarrMission_PortraitRing_Darkener,3876,152,59,62,826,885,877,939,8942,0,0,0,0
GarrMission_PortraitRing_Quality,3877,152,59,62,887,946,941,1003,8943,0,0,0,0
BonusChest-OrangeSmoke-Wide,3878,308,228,64,256,484,136,200,8944,0,0,0,0
BonusChest-OrangeGlow-Wide,3879,308,244,64,159,403,64,128,8945,0,0,0,0
loottoast-bg-alliance,3880,332,278,98,289,567,1,99,8202,0,0,0,0
loottoast-bg-horde,3881,332,282,100,1,283,112,212,8203,0,0,0,0
groupfinder-button-highlight,3882,236,292,37,1,293,921,958,8193,0,0,0,0
groupfinder-button-select,3883,236,292,37,424,716,1,38,8194,0,0,0,0
groupfinder-button-cover-down,3884,236,300,46,331,631,861,907,8195,0,0,0,0
GarrMission_EncounterBar-CheckMark-Left,3885,152,74,76,750,824,774,850,8946,0,0,0,0
GarrMission_EncounterBar-CheckMark-Right,3886,152,74,76,750,824,852,928,8947,0,0,0,0
GarrMission_EncounterBar-CheckMark,3887,152,74,76,528,602,920,996,8948,0,0,0,0
GarrMission_EncounterBar-CheckMarkCircleSwipe,3888,152,64,64,365,429,874,938,8949,0,0,0,0
Alliance_Tier1_Mine,3911,333,55,46,261,316,1,47,8819,0,0,0,0
Alliance_Tier1_Trading1,3912,333,42,43,424,466,1,44,8820,0,0,0,0
Alliance_Tier1_Armory1,3913,333,63,79,1,64,78,157,8821,0,0,0,0
Alliance_Tier1_Mage1,3914,333,53,57,139,192,176,233,8822,0,0,0,0
Alliance_Tier1_Mage2,3915,333,58,58,139,197,57,115,8823,0,0,0,0
Alliance_Tier1_Armory2,3916,333,69,75,1,70,1,76,8824,0,0,0,0
Alliance_Tier1_Stables1,3917,333,59,59,72,131,131,190,8825,0,0,0,0
Alliance_Tier1_Barracks1,3918,333,52,54,207,259,1,55,8842,0,0,0,0
Alliance_Tier1_Stables2,3919,333,68,66,1,69,159,225,8843,0,0,0,0
Alliance_Tier1_Lumber1,3920,333,58,61,72,130,68,129,8844,0,0,0,0
Alliance_Tier1_Barn2,3921,333,49,39,373,422,1,40,8845,0,0,0,0
Alliance_Tier1_Professions2,3922,333,38,43,308,346,49,92,8846,0,0,0,0
Alliance_Tier1_Inn1,3923,333,56,57,139,195,117,174,8847,0,0,0,0
Alliance_Tier1_Farm,3924,333,29,37,308,337,136,173,8848,0,0,0,0
Menagery1,3925,333,42,39,261,303,152,191,8849,0,0,0,0
Alliance_Tier1_Arena2,3926,333,53,43,318,371,1,44,8850,0,0,0,0
Alliance_Tier1_Lumber2,3927,333,55,63,72,127,192,255,8851,0,0,0,0
Alliance_Tier1_Trading2,3928,333,37,40,308,345,94,134,8852,0,0,0,0
Alliance_Tier1_Fishing,3929,333,36,30,207,243,217,247,8853,0,0,0,0
Alliance_Tier1_Barn1,3930,333,50,48,207,257,167,215,8854,0,0,0,0
Alliance_Tier1_Inn2,3931,333,43,47,261,304,103,150,8855,0,0,0,0
Alliance_Tier1_Arena1,3932,333,45,52,261,306,49,101,8856,0,0,0,0
Alliance_Tier2_Arena1,3933,554,58,58,390,448,74,132,8857,0,0,0,0
Alliance_Tier2_Arena2,3934,554,60,50,1,61,205,255,8858,0,0,0,0
Alliance_Tier2_Armory1,3935,554,84,99,1,85,1,100,8859,0,0,0,0
Alliance_Tier2_Armory2,3936,554,80,101,1,81,102,203,8860,0,0,0,0
Alliance_Tier2_Barn1,3937,554,48,48,331,379,137,185,8861,0,0,0,0
Alliance_Tier2_Barn2,3938,554,44,37,465,509,1,38,8862,0,0,0,0
Alliance_Tier2_Barracks1,3939,554,70,74,259,329,1,75,8863,0,0,0,0
Alliance_Tier2_Inn1,3940,554,63,63,259,322,77,140,8864,0,0,0,0
Alliance_Tier2_Inn2,3941,554,69,56,259,328,142,198,8865,0,0,0,0
Alliance_Tier2_Lumber1,3942,554,59,61,404,463,1,62,8866,0,0,0,0
Alliance_Tier2_Lumber2,3943,554,59,47,450,509,74,121,8870,0,0,0,0
Alliance_Tier2_Mage1,3944,554,72,75,175,247,158,233,8871,0,0,0,0
Alliance_Tier2_Mage2,3945,554,71,71,331,402,1,72,8872,0,0,0,0
Alliance_Tier2_Stables1,3946,554,73,76,87,160,178,254,8873,0,0,0,0
Alliance_Tier2_Stables2,3947,554,82,78,175,257,1,79,8874,0,0,0,0
Alliance_Tier2_Trading1,3948,554,57,61,331,388,74,135,8875,0,0,0,0
Alliance_Tier2_Trading2,3949,554,54,55,259,313,200,255,8876,0,0,0,0
Alliance_Tier3_Barn1,3950,555,62,67,177,239,296,363,8877,0,0,0,0
Alliance_Tier3_Lumber1,3951,555,66,67,103,169,322,389,8878,0,0,0,0
Alliance_Tier3_Mage2,3952,555,70,71,103,173,174,245,8879,0,0,0,0
Alliance_Tier3_Inn1,3953,555,74,74,1,75,392,466,8880,0,0,0,0
Alliance_Tier3_Barracks1,3954,555,92,90,221,313,1,91,8881,0,0,0,0
Alliance_Tier3_Armory2,3955,555,76,96,1,77,294,390,8882,0,0,0,0
Alliance_Tier3_Mage1,3956,555,72,75,103,175,97,172,8883,0,0,0,0
Alliance_Tier3_Lumber2,3957,555,66,54,103,169,456,510,8884,0,0,0,0
Alliance_Tier3_Inn2,3958,555,70,63,103,173,391,454,8885,0,0,0,0
Alliance_Tier3_Stables1,3959,555,117,94,1,118,1,95,8886,0,0,0,0
Alliance_Tier3_Trading2,3960,555,56,63,244,300,159,222,8887,0,0,0,0
Alliance_Tier3_Arena1,3961,555,66,73,103,169,247,320,8888,0,0,0,0
Alliance_Tier3_Trading1,3962,555,65,66,177,242,159,225,8889,0,0,0,0
Alliance_Tier3_Stables2,3963,555,99,92,120,219,1,93,8890,0,0,0,0
Alliance_Tier3_Barn2,3964,555,63,67,177,240,227,294,8891,0,0,0,0
Alliance_Tier3_Armory1,3965,555,83,95,1,84,197,292,8892,0,0,0,0
Alliance_Tier3_Arena2,3966,555,72,60,177,249,97,157,8893,0,0,0,0
Alliance_Tier1_Barracks2,3967,333,51,52,207,258,113,165,8894,0,0,0,0
Alliance_Tier2_Barracks2,3968,554,73,75,175,248,81,156,8895,0,0,0,0
Alliance_Tier3_Barracks2,3969,555,100,98,1,101,97,195,8896,0,0,0,0
Alliance_Tier1_Workshop1,3970,333,66,54,139,205,1,55,8897,0,0,0,0
Alliance_Tier1_Workshop2,3971,333,65,65,72,137,1,66,8898,0,0,0,0
Alliance_Tier2_Workshop1,3972,554,81,84,87,168,92,176,8899,0,0,0,0
Alliance_Tier2_Workshop2,3973,554,86,89,87,173,1,90,8900,0,0,0,0
Alliance_Tier3_Workshop1,3974,555,81,78,401,482,1,79,8901,0,0,0,0
Alliance_Tier3_Workshop2,3975,555,84,87,315,399,1,88,8902,0,0,0,0
StreamCinematic-LK-Down,3976,557,176,78,437,613,1,79,8903,0,0,0,0
StreamCinematic-LK-Up,3977,557,176,78,437,613,81,159,8904,0,0,0,0
StreamCinematic-WOD-Down,3978,557,176,78,793,969,1,79,8905,0,0,0,0
StreamCinematic-WOD-Up,3979,557,176,78,615,791,81,159,8906,0,0,0,0
StreamCinematic-BC-Down,3980,557,176,78,1,177,1,79,8907,0,0,0,0
StreamCinematic-BC-Up,3981,557,176,78,1,177,81,159,8908,0,0,0,0
StreamCinematic-CC-Down,3982,557,176,78,1,177,161,239,8909,0,0,0,0
StreamCinematic-CC-Up,3983,557,176,78,179,355,1,79,8910,0,0,0,0
StreamCinematic-Classic-Down,3984,557,176,78,179,355,81,159,8911,0,0,0,0
StreamCinematic-Classic-Up,3985,557,176,78,179,355,161,239,8912,0,0,0,0
StreamCinematic-DownloadIcon,3986,557,43,43,357,400,179,222,8950,0,0,0,0
StreamCinematic-Highlight,3987,557,78,176,357,435,1,177,8951,0,0,0,0
StreamCinematic-PlayButton,3988,557,43,43,971,1014,1,44,8952,0,0,0,0
StreamCinematic-ProgressBarBG,3989,557,10,4,1,11,241,245,8977,0,0,0,0
StreamCinematic-MOP-Down,3995,557,176,78,437,613,161,239,8978,0,0,0,0
StreamCinematic-MOP-Up,3996,557,176,78,615,791,1,79,8979,0,0,0,0
accountupgradebanner-bc,3997,558,198,99,203,401,262,361,8980,0,0,0,0
accountupgradebanner-cataclysm,3998,558,200,140,1,201,1,141,8981,0,0,0,0
accountupgradebanner-classic,3999,558,200,100,1,201,381,481,8982,0,0,0,0
accountupgradebanner-mop,4000,558,200,117,203,403,143,260,8983,0,0,0,0
accountupgradebanner-wod,4001,558,200,117,1,201,262,379,8984,0,0,0,0
accountupgradebanner-wotlk,4002,558,200,140,203,403,1,141,8985,0,0,0,0
MissionFX-Smoke,4004,152,80,80,943,1023,157,237,8204,0,0,0,0
MissionFX-SparkLines,4005,152,120,120,845,965,313,433,8229,0,0,0,0
Horde_Tier1_Arena1,4140,276,45,51,190,235,199,250,8986,0,0,0,0
Horde_Tier1_Arena2,4141,276,43,45,250,293,1,46,8987,0,0,0,0
Horde_Tier1_Armory1,4142,276,57,57,70,127,124,181,8988,0,0,0,0
Horde_Tier1_Armory2,4143,276,56,55,132,188,1,56,8705,0,0,0,0
Horde_Tier1_Barn1,4144,276,51,51,132,183,112,163,8706,0,0,0,0
Horde_Tier1_Barn2,4145,276,53,46,190,243,51,97,8707,0,0,0,0
Horde_Tier1_Barracks1,4146,276,65,70,1,66,73,143,8708,0,0,0,0
Horde_Tier1_Barracks2,4147,276,67,70,1,68,1,71,8709,0,0,0,0
Horde_Tier1_Farm1,4148,276,58,48,190,248,1,49,8710,0,0,0,0
Horde_Tier1_Fishing1,4149,276,42,44,250,292,48,92,8711,0,0,0,0
Horde_Tier1_Inn1,4150,276,50,48,190,240,99,147,8712,0,0,0,0
Horde_Tier1_Inn2,4151,276,50,48,190,240,149,197,8713,0,0,0,0
Horde_Tier1_Lumber1,4152,276,45,43,1,46,210,253,8714,0,0,0,0
Horde_Tier1_Lumber2,4153,276,37,48,250,287,183,231,8715,0,0,0,0
Horde_Tier1_Mage1,4154,276,51,50,132,183,165,215,8716,0,0,0,0
Horde_Tier1_Mage2,4155,276,52,52,132,184,58,110,8717,0,0,0,0
Horde_Tier1_Mine1,4156,276,52,36,132,184,217,253,8718,0,0,0,0
Horde_Tier1_Profession1,4157,276,40,38,337,377,1,39,8719,0,0,0,0
Horde_Tier1_Profession2,4158,276,42,43,250,292,138,181,8720,0,0,0,0
Horde_Tier1_Profession3,4159,276,43,42,250,293,94,136,8721,0,0,0,0
Horde_Tier1_Stables1,4160,276,57,55,70,127,183,238,8722,0,0,0,0
Horde_Tier1_Stables2,4161,276,62,63,1,63,145,208,8723,0,0,0,0
Horde_Tier1_Trading1,4162,276,37,37,379,416,1,38,8724,0,0,0,0
Horde_Tier1_Trading2,4163,276,40,39,295,335,1,40,8725,0,0,0,0
Horde_Tier1_Workshop1,4164,276,60,60,70,130,1,61,8726,0,0,0,0
Horde_Tier1_Workshop2,4165,276,56,59,70,126,63,122,8727,0,0,0,0
Horde_Tier2_Arena1,4166,560,59,55,288,347,61,116,8647,0,0,0,0
Horde_Tier2_Arena2,4167,560,54,55,231,285,131,186,8649,0,0,0,0
Horde_Tier2_Armory1,4168,560,64,68,89,153,148,216,8656,0,0,0,0
Horde_Tier2_Armory2,4169,560,65,61,164,229,1,62,8625,0,0,0,0
Horde_Tier2_Barn1,4170,560,59,58,350,409,1,59,8626,0,0,0,0
Horde_Tier2_Barn2,4171,560,53,45,288,341,170,215,8639,0,0,0,0
Horde_Tier2_Barracks1,4172,560,61,60,164,225,64,124,8640,0,0,0,0
Horde_Tier2_Barracks2,4173,560,61,60,164,225,126,186,8641,0,0,0,0
Horde_Tier2_Inn1,4174,560,60,57,411,471,1,58,8642,0,0,0,0
Horde_Tier2_Inn2,4175,560,60,58,288,348,1,59,8643,0,0,0,0
Horde_Tier2_Lumber1,4176,560,55,66,231,286,1,67,8644,0,0,0,0
Horde_Tier2_Lumber2,4177,560,54,60,231,285,69,129,8645,0,0,0,0
Horde_Tier2_Mage1,4178,560,76,76,1,77,167,243,8646,0,0,0,0
Horde_Tier2_Mage2,4179,560,73,74,89,162,1,75,8728,0,0,0,0
Horde_Tier2_Stables1,4180,560,62,59,164,226,188,247,8729,0,0,0,0
Horde_Tier2_Stables2,4181,560,65,69,89,154,77,146,8730,0,0,0,0
Horde_Tier2_Trading1,4182,560,54,52,231,285,188,240,8731,0,0,0,0
Horde_Tier2_Trading2,4183,560,54,50,288,342,118,168,8732,0,0,0,0
Horde_Tier2_Workshop1,4184,560,79,77,1,80,88,165,8733,0,0,0,0
Horde_Tier2_Workshop2,4185,560,86,85,1,87,1,86,8734,0,0,0,0
Horde_Tier3_Arena1,4186,561,70,65,244,314,1,66,8735,0,0,0,0
Horde_Tier3_Arena2,4187,561,55,69,377,432,68,137,8736,0,0,0,0
Horde_Tier3_Armory1,4188,561,65,71,165,230,157,228,8737,0,0,0,0
Horde_Tier3_Armory2,4189,561,65,63,310,375,68,131,8738,0,0,0,0
Horde_Tier3_Barn1,4190,561,64,65,244,308,68,133,8739,0,0,0,0
Horde_Tier3_Barn2,4191,561,72,50,434,506,68,118,8740,0,0,0,0
Horde_Tier3_Barracks1,4192,561,76,88,1,77,86,174,8741,0,0,0,0
Horde_Tier3_Barracks2,4193,561,82,76,1,83,176,252,8742,0,0,0,0
Horde_Tier3_Inn1,4194,561,70,65,316,386,1,66,8743,0,0,0,0
Horde_Tier3_Inn2,4195,561,60,67,244,304,135,202,8744,0,0,0,0
Horde_Tier3_Lumber1,4196,561,68,62,388,456,1,63,8745,0,0,0,0
Horde_Tier3_Lumber2,4197,561,59,51,244,303,204,255,8746,0,0,0,0
Horde_Tier3_Mage1,4198,561,76,75,87,163,174,249,8747,0,0,0,0
Horde_Tier3_Mage2,4199,561,73,73,165,238,82,155,8748,0,0,0,0
Horde_Tier3_Stables1,4200,561,77,79,165,242,1,80,8749,0,0,0,0
Horde_Tier3_Stables2,4201,561,76,83,87,163,89,172,8750,0,0,0,0
Horde_Tier3_Trading1,4202,561,66,54,377,443,139,193,8751,0,0,0,0
Horde_Tier3_Trading2,4203,561,63,63,310,373,133,196,8752,0,0,0,0
Horde_Tier3_Workshop1,4204,561,76,86,87,163,1,87,8753,0,0,0,0
Horde_Tier3_Workshop2,4205,561,84,83,1,85,1,84,8754,0,0,0,0
GarrMission_TabGlow,4206,152,189,42,811,1000,523,565,8755,0,0,0,0
Garr_Plot_Frostfire_H_3,4207,562,108,70,1,109,1,71,8756,0,0,0,0
Garr_Plot_Frostfire_H_2,4208,562,108,70,111,219,1,71,8757,0,0,0,0
Garr_Plot_Frostfire_H_1,4209,562,108,70,1,109,73,143,8758,0,0,0,0
Garr_Plot_Frostfire_H_4,4210,562,108,70,111,219,73,143,8759,0,0,0,0
BonusChest-GreenGlow-Wide,4211,152,244,64,668,912,702,766,8230,0,0,0,0
GarrMission_PortraitRing_iLvlBorder,4213,152,70,24,789,859,287,311,8231,0,0,0,0
bags-icon-consumables,4214,202,28,28,221,249,1,29,8760,0,0,0,0
bags-icon-equipment,4215,202,28,28,221,249,42,70,8761,0,0,0,0
bags-icon-tradegoods,4216,202,28,28,222,250,93,121,8762,0,0,0,0
search-highlight,4223,565,126,27,1,127,79,106,8766,0,0,0,0
search-select,4224,565,126,27,259,385,30,57,8767,0,0,0,0
_search-rowbg,4225,565,64,27,0,64,1,28,8768,0,0,4,0
GarrMission_EncounterAbilityBorder-Lg,4226,152,46,46,317,363,900,946,8763,0,0,0,0
GarrMission_EncounterBar-Elite,4227,152,75,67,943,1018,239,306,8764,0,0,0,0
GarrMission_RewardsBox_Shadow,4228,152,345,50,433,778,576,626,8765,0,0,0,0
GarrMission_MissionCompleteChanceBg,4229,152,282,95,505,787,157,252,8769,0,0,0,0
GarrMission_CurrentEncounter-Glow,4231,152,70,70,902,972,628,698,8771,0,0,0,0
GarrMission_CurrentEncounter-SpikeyGlow,4232,152,152,120,691,843,313,433,8772,0,0,0,0
_GarrMissionLocation-Gorgrond-Mid,4236,396,1024,285,0,1024,575,860,8775,0,0,4,0
GarrMissionLocation-FrostfireRidge-List,4237,566,792,78,1,793,81,159,8773,0,0,0,0
GarrMissionLocation-Gorgrond-List,4238,566,792,78,1,793,161,239,8774,0,0,0,0
GarrMissionLocation-Nagrand-List,4239,566,792,78,1,793,241,319,8776,0,0,0,0
GarrMissionLocation-ShadowmoonValley-List,4240,566,792,78,1,793,321,399,8777,0,0,0,0
GarrMissionLocation-SpiresofArak-List,4241,566,792,78,1,793,401,479,8778,0,0,0,0
GarrMissionLocation-Talador-List,4242,566,792,78,1,793,481,559,8779,0,0,0,0
GarrMissionLocation-TannanJungle-List,4243,566,792,78,1,793,561,639,8780,0,0,0,0
groupfinder-icon-class-deathknight,4244,236,29,29,293,322,721,750,8770,0,0,0,0
groupfinder-icon-class-druid,4245,236,29,29,293,322,797,826,8781,0,0,0,0
groupfinder-icon-class-hunter,4246,236,29,29,946,975,785,814,8782,0,0,0,0
groupfinder-icon-class-mage,4247,236,29,29,293,322,759,788,8783,0,0,0,0
groupfinder-icon-class-monk,4248,236,29,29,295,324,921,950,8784,0,0,0,0
groupfinder-icon-class-paladin,4249,236,29,29,293,322,883,912,9071,0,0,0,0
groupfinder-icon-class-priest,4250,236,29,29,915,944,785,814,9072,0,0,0,0
groupfinder-icon-class-rogue,4251,236,29,29,977,1006,785,814,9073,0,0,0,0
groupfinder-icon-class-shaman,4252,236,29,29,946,975,823,852,9074,0,0,0,0
groupfinder-icon-class-warlock,4253,236,29,29,915,944,823,852,9075,0,0,0,0
groupfinder-icon-class-warrior,4254,236,29,29,977,1006,823,852,9076,0,0,0,0
groupfinder-icon-emptyslot,4255,236,29,29,915,944,909,938,9077,0,0,0,0
groupfinder-icon-quest,4256,236,14,14,476,490,78,92,9078,0,0,0,0
groupfinder-icon-role-large-dps,4257,236,29,29,956,985,861,890,9079,0,0,0,0
groupfinder-icon-role-large-heal,4258,236,29,29,987,1016,861,890,9080,0,0,0,0
groupfinder-icon-role-large-tank,4259,236,29,29,925,954,861,890,9081,0,0,0,0
_GarrMissionLocation-BlackrockMountain-Back,4264,568,1024,285,0,1024,1,286,8989,0,0,4,0
_GarrMissionLocation-BlackrockMountain-Fore,4265,568,1024,285,0,1024,288,573,8990,0,0,4,0
_GarrMissionLocation-BlackrockMountain-Mid,4266,568,1024,285,0,1024,575,860,8991,0,0,4,0
_GarrMissionLocation-BlackrockMountain-List,4267,566,792,78,0,792,1,79,8992,0,0,4,0
GarrLanding-Tab-Bottom-Selected,4268,268,71,42,27,98,485,527,9030,0,0,0,0
GarrLanding-Tab-Bottom-Unselected,4269,268,71,42,441,512,45,87,9031,0,0,0,0
GarrLanding-Tab-Bottom-Highlight,4270,268,71,42,441,512,1,43,9032,0,0,0,0
challenges-timerborder,4271,569,184,23,1,185,411,434,8613,0,0,0,0
challenges-blackfade,4272,569,333,61,397,730,221,282,8614,0,0,0,0
challenges-timerbg,4273,569,243,59,732,975,221,280,8619,0,0,0,0
challenges-bannershine,4274,569,222,106,397,619,113,219,8620,0,0,0,0
challenges-toast,4276,569,311,78,649,960,1,79,8621,0,0,0,0
Banner-BgFiligree,4277,570,249,31,1,250,293,324,8624,0,0,0,0
Banner-FiligreeShadow,4278,570,382,35,1,383,256,291,8638,0,0,0,0
Banner-SmallFiligree,4279,570,61,19,429,490,1,20,8648,0,0,0,0
ScenariosIcon,4280,570,48,47,379,427,1,48,8657,0,0,0,0
ScenarioTrackerToast-FinalFiligree,4281,570,235,69,246,481,177,246,9151,0,0,0,0
ScenarioTrackerToast,4282,570,243,77,1,244,177,254,9152,0,0,0,0
Toast-Flash,4283,570,327,94,1,328,1,95,9153,0,0,0,0
Toast-Frame,4284,570,311,78,1,312,97,175,9154,0,0,0,0
Toast-IconBG,4285,570,47,52,330,377,1,53,9155,0,0,0,0
challenges-nomedal,4287,569,9,10,1,10,499,509,9156,0,0,0,0
Bonus-ToastBanner,4288,570,36,44,379,415,50,94,9157,0,0,0,0
groupfinder-button-ashran,4289,236,290,36,331,621,785,821,9085,0,0,0,0
groupfinder-background-arenas,4290,236,333,96,1,334,1,97,9086,0,0,0,0
groupfinder-background-ashran,4291,236,333,96,331,664,99,195,9087,0,0,0,0
groupfinder-background-battlegrounds,4292,236,333,96,666,999,99,195,9088,0,0,0,0
groupfinder-background-custom-pve,4293,236,333,96,331,664,197,293,9089,0,0,0,0
groupfinder-background-custom-pvp,4294,236,333,96,331,664,295,391,9090,0,0,0,0
groupfinder-background-dungeons,4295,236,333,96,666,999,197,293,9091,0,0,0,0
groupfinder-background-questing,4296,236,333,96,666,999,295,391,9092,0,0,0,0
groupfinder-background-raids-bc,4297,236,333,96,331,664,393,489,9093,0,0,0,0
groupfinder-background-raids-cataclysm,4298,236,333,96,331,664,589,685,9094,0,0,0,0
groupfinder-background-raids-classic,4299,236,333,96,666,999,589,685,9095,0,0,0,0
groupfinder-background-raids-mists,4300,236,333,96,666,999,393,489,9096,0,0,0,0
groupfinder-background-raids-wrath,4301,236,333,96,666,999,491,587,9097,0,0,0,0
groupfinder-background-ratedbgs,4302,236,333,96,331,664,491,587,9098,0,0,0,0
groupfinder-background-scenarios,4303,236,333,96,666,999,687,783,9099,0,0,0,0
groupfinder-background-skirmishes,4304,236,333,96,331,664,687,783,9100,0,0,0,0
GarrLanding-Tab-Bottom-Selected-Right,4307,268,24,42,1,25,89,131,9224,0,0,0,0
GarrLanding-Tab-Bottom-Unselected-Left,4308,268,24,42,1,25,221,263,9225,0,0,0,0
GarrLanding-Tab-Bottom-Selected-Left,4309,268,24,42,1,25,177,219,9226,0,0,0,0
GarrLanding-Tab-Bottom-Highlight-Right,4310,268,24,42,1,25,45,87,9227,0,0,0,0
GarrLanding-Tab-Bottom-Highlight-Left,4311,268,24,42,1,25,1,43,9228,0,0,0,0
GarrLanding-Tab-Bottom-Unselected-Right,4312,268,24,42,1,25,133,175,9229,0,0,0,0
collections-watermark-toy,4313,203,109,110,93,202,362,472,8993,0,0,0,0
CacheToast-Glow,4315,573,286,109,1,287,1,110,9111,0,0,0,0
CacheToast,4316,573,276,96,1,277,112,208,9112,0,0,0,0
NPE_ExclamationPoint,4321,575,32,32,981,1013,1,33,9113,0,0,0,0
NPE_Icon,4322,575,64,64,67,131,423,487,9114,0,0,0,0
NPE_LeftClick,4323,575,32,32,981,1013,67,99,9115,0,0,0,0
NPE_RightClick,4324,575,32,32,981,1013,133,165,9116,0,0,0,0
NPE_TurnIn,4325,575,20,20,981,1001,35,55,9117,0,0,0,0
NPE_ArrowDownGlow,4326,575,64,64,915,979,67,131,9118,0,0,0,0
NPE_ArrowUpGlow,4327,575,64,64,67,131,357,421,9119,0,0,0,0
NPE_ArrowUp,4328,575,64,64,1,65,423,487,9120,0,0,0,0
NPE_ArrowDown,4329,575,64,64,915,979,1,65,9121,0,0,0,0
NPE_ArrowRightGlow,4330,575,64,64,1,65,357,421,9122,0,0,0,0
NPE_keyboard,4331,575,912,354,1,913,1,355,9123,0,0,0,0
NPE_ArrowRight,4332,575,64,64,915,979,265,329,9124,0,0,0,0
NPE_ArrowLeftGlow,4333,575,64,64,915,979,199,263,9125,0,0,0,0
NPE_ArrowLeft,4334,575,64,64,915,979,133,197,9126,0,0,0,0
UI-Minimap-Clock,4340,579,55,28,1,56,1,29,9036,0,0,0,0
GarrLanding-TradeskillTimer-Border,4343,268,64,64,27,91,529,593,9033,0,0,0,0
barbershop-background,4344,580,266,348,274,540,1,349,9158,0,0,0,0
groupfinder-waitdot,4349,236,19,18,559,578,78,96,9127,0,0,0,0
OBJFX-BarGlow,4353,197,339,37,1,340,89,126,9034,0,0,0,0
deathrecap-icon-tombstone,4366,586,15,20,337,352,1,21,8995,0,0,0,0
collections-watermark-heirloom,4367,203,90,92,1,91,213,305,9184,0,0,0,0
Crop-Corner,4368,587,10,10,123,133,181,191,9128,0,0,0,0
Crop-Side,4369,587,10,10,123,133,202,212,9129,0,0,0,0
Crop-Top,4370,587,10,10,123,133,214,224,9130,0,0,0,0
WoWShare-AchievementIcon,4371,587,32,32,89,121,168,200,9131,0,0,0,0
WoWShare-AddButton-Down,4372,587,42,43,1,43,168,211,9132,0,0,0,0
WoWShare-AddButton-Up,4373,587,42,43,45,87,168,211,9133,0,0,0,0
WoWShare-ChatIcon,4374,587,23,18,89,112,236,254,9134,0,0,0,0
WoWShare-Highlight,4375,587,38,39,1,39,213,252,9135,0,0,0,0
WoWShare-ItemQualityBorder,4376,587,32,32,144,176,1,33,9136,0,0,0,0
WoWShare-Plus,4377,587,32,32,178,210,1,33,9137,0,0,0,0
WoWShare-Selection,4378,587,38,39,45,83,213,252,9138,0,0,0,0
WoWShare-ItemIcon,4381,587,32,32,89,121,202,234,9139,0,0,0,0
WoWShare-ScreenshotIcon,4382,587,32,32,212,244,1,33,9140,0,0,0,0
token-button-category,4383,590,156,20,631,787,235,255,9035,0,0,0,0
token-itemslot,4385,590,251,56,631,882,177,233,9037,0,0,0,0
token-choice-bnet,4390,590,174,174,631,805,1,175,9159,0,0,0,0
token-choice-wow,4391,590,108,108,807,915,1,109,9160,0,0,0,0
WoWShare-EdgeArt,4392,587,141,165,1,142,1,166,9230,0,0,0,0
UI-DialogBox-goldbutton-down-right-blue,4399,593,32,32,133,165,1,33,9231,0,0,0,0
UI-DialogBox-goldbutton-down-left-blue,4400,593,64,32,1,65,1,33,9232,0,0,0,0
UI-DialogBox-goldbutton-up-middle-blue,4401,593,64,32,1,65,35,67,9233,0,0,0,0
UI-DialogBox-goldbutton-up-right-blue,4402,593,32,32,167,199,1,33,9234,0,0,0,0
UI-DialogBox-goldbutton-up-left-blue,4403,593,64,32,1,65,69,101,9235,0,0,0,0
UI-DialogBox-goldbutton-down-middle-blue,4404,593,64,32,67,131,1,33,9236,0,0,0,0
BossBanner-BottomFillagree,4406,594,66,28,443,509,161,189,9161,0,0,0,0
BossBanner-SkullCircle,4407,594,44,44,443,487,69,113,9162,0,0,0,0
BossBanner-TopFillagree,4408,594,176,74,125,301,295,369,9163,0,0,0,0
BossBanner-RedFlash,4409,594,92,92,1,93,415,507,9147,0,0,0,0
BossBanner-LeftFillagree,4410,594,72,40,303,375,295,335,9141,0,0,0,0
BossBanner-RightFillagree,4411,594,72,40,377,449,295,335,9142,0,0,0,0
BossBanner-SkullSpikes,4412,594,50,66,443,493,1,67,9143,0,0,0,0
deathrecap-iconborder,4413,586,36,36,299,335,1,37,9103,0,0,0,0
deathrecap-background-innerglow,4414,586,296,254,1,297,1,255,8994,0,0,0,0
!GeneralFrame-InsetFrame-Left,4415,595,8,32,1,9,0,32,9038,0,0,2,0
!GeneralFrame-InsetFrame-Right,4416,595,8,32,11,19,0,32,9039,0,0,2,0
GeneralFrame-HorizontalBar-Left,4417,595,10,19,21,31,1,20,9040,0,0,0,0
GeneralFrame-HorizontalBar-Right,4418,595,10,19,33,43,1,20,9041,0,0,0,0
GeneralFrame-InsetFrame-BottomLeft,4419,595,8,8,21,29,22,30,9042,0,0,0,0
GeneralFrame-InsetFrame-BottomRight,4420,595,8,8,33,41,22,30,9043,0,0,0,0
GeneralFrame-InsetFrame-TopLeft,4421,595,8,8,45,53,1,9,9044,0,0,0,0
GeneralFrame-InsetFrame-TopRight,4422,595,8,8,55,63,1,9,9045,0,0,0,0
_GeneralFrame-HorizontalBar,4423,596,64,8,0,64,1,9,9046,0,0,4,0
_GeneralFrame-InsetFrame-Bottom,4424,596,32,8,0,32,11,19,9047,0,0,4,0
_GeneralFrame-InsetFrame-Top,4425,596,32,8,0,32,21,29,9048,0,0,4,0
collections-upgradeglow,4427,203,100,100,256,356,102,202,9104,0,0,0,0
XPBarAnim-OrangeGain,4429,599,64,8,40,104,21,29,9237,0,0,0,0
XPBarAnim-OrangeSpark,4430,599,32,32,1,33,29,61,9238,0,0,0,0
XPBarAnim-OrangeTrail,4431,599,64,8,40,104,1,9,9239,0,0,0,0
XPBarAnim-OrangeGlow,4432,599,64,8,40,104,11,19,9240,0,0,0,0
XPBarAnim-GlowLines,4433,599,37,26,1,38,1,27,9241,0,0,0,0
collections-upgradeglow-blue,4434,203,100,100,358,458,102,202,9049,0,0,0,0
splash-610-botleft,4435,600,137,371,374,511,587,958,9050,0,0,0,0
splash-610-right,4436,600,510,584,1,511,1,585,9051,0,0,0,0
splash-610-topleft,4437,600,371,434,1,372,587,1021,9052,0,0,0,0
Garr_MissionToast-Blank,4438,150,272,59,1,273,253,312,9053,0,0,0,0
colorblind-bar-green,4439,601,108,17,1,109,151,168,9164,0,0,0,0
colorblind-bar-red,4440,601,108,17,111,219,151,168,9165,0,0,0,0
colorblind-bar-yellow,4441,601,108,17,1,109,170,187,9166,0,0,0,0
colorblind-colorwheel,4442,601,148,148,1,149,1,149,9167,0,0,0,0
GarrMission_MissionTooltipAway,4443,156,15,15,243,258,200,215,9144,0,0,0,0
GarrMission_MissionTooltipWorking,4444,156,15,15,164,179,200,215,9145,0,0,0,0
GarrMission_CounterHalfCheck,4446,152,25,22,532,557,289,311,9054,0,0,0,0
TalkingHeads-Glow-TopSpike,4448,604,46,30,518,564,158,188,9105,0,0,0,0
TalkingHeads-PortraitBg,4449,604,115,115,718,833,1,116,9106,0,0,0,0
TalkingHeads-TextBackground,4450,604,570,155,1,571,1,156,9107,0,0,0,0
TalkingHeads-PortraitFrame,4451,604,143,143,573,716,1,144,9108,0,0,0,0
TalkingHeads-Glow-TopBarGlow,4452,604,81,23,1,82,231,254,9109,0,0,0,0
TalkingHeads-Glow-SideBarGlow,4453,604,23,86,573,596,146,232,9110,0,0,0,0
TalkingHeads-Glow-Sheen,4454,604,262,34,254,516,158,192,9185,0,0,0,0
TalkingHeads-Glow-TextSheen,4455,604,251,71,1,252,158,229,9186,0,0,0,0
GarrMission-AbilityHighlight,4456,156,58,58,292,350,504,562,9146,0,0,0,0
token-info-background,4458,590,628,510,1,629,1,511,9148,0,0,0,0
WoWShare-TwitterLogo,4459,587,14,11,123,137,168,179,8996,0,0,0,0
token-info-arrow,4477,590,32,21,807,839,111,132,9055,0,0,0,0
adventureguide-pane-large,4481,609,335,337,1,336,164,501,9149,0,0,0,0
adventureguide-ring,4482,609,94,95,397,491,1,96,9150,0,0,0,0
BossBanner-BgBanner-Bottom,4483,594,440,112,1,441,1,113,9249,0,0,0,0
BossBanner-BgBanner-Top,4484,594,440,112,1,441,115,227,9252,0,0,0,0
LootBanner-IconGlow,4485,594,40,40,443,483,229,269,9253,0,0,0,0
LootBanner-ItemBg,4486,594,269,41,125,394,371,412,9254,0,0,0,0
LootBanner-LootBagCircle,4487,594,44,44,443,487,115,159,9255,0,0,0,0
BossBanner-BgBanner-Mid,4488,594,440,64,1,441,229,293,9256,0,0,0,0
LootToast-LessAwesome,4489,332,276,80,569,845,99,179,9056,0,0,0,0
transmog-frame-pink,4494,610,44,43,239,283,1,44,9257,0,0,0,0
transmog-frame-red,4495,610,44,43,285,329,1,44,9258,0,0,0,0
transmog-frame-selected,4496,610,62,62,105,167,337,399,9259,0,0,0,0
transmog-frame,4497,610,58,57,105,163,401,458,9260,0,0,0,0
transmog-icon-chat,4498,610,13,13,169,182,337,350,9261,0,0,0,0
transmog-icon-checkmark,4499,610,28,26,243,271,127,153,9262,0,0,0,0
transmog-icon-remove,4500,610,26,26,484,510,88,114,9263,0,0,0,0
transmog-icon-revert-small-disabled,4501,610,25,24,300,325,127,151,9264,0,0,0,0
transmog-icon-revert-small,4502,610,25,24,273,298,127,151,9265,0,0,0,0
transmog-icon-revert,4503,610,32,32,450,482,88,120,8997,0,0,0,0
transmog-wardrobe-border-collected,4504,610,96,122,1,97,131,253,8998,0,0,0,0
transmog-wardrobe-border-highlighted,4505,610,84,110,105,189,225,335,8999,0,0,0,0
transmog-wardrobe-border-selected,4506,610,102,128,1,103,1,129,9000,0,0,0,0
transmog-wardrobe-border-uncollected,4507,610,96,122,1,97,255,377,9001,0,0,0,0
adventureguide-pane-small,4509,609,344,161,1,345,1,162,9168,0,0,0,0
NavalMap01,4522,612,934,630,1,935,1,631,9014,0,0,0,0
!ShipMission_Bg-Edge,4524,154,46,256,186,232,0,256,9169,0,0,2,0
!ShipMission_RewardsBorder-Left-Desaturate,4525,154,30,64,298,328,0,64,9170,0,0,2,0
!GarrMission_Bg-DarkEdge,4526,614,334,256,1,335,0,256,9171,0,0,2,0
!ShipMission_Bg-DarkEdge,4527,614,334,256,337,671,0,256,9172,0,0,2,0
_ShipMission_Bg-BottomEdge,4528,153,256,251,0,256,254,505,9173,0,0,4,0
_ShipMission_Bg-BottomEdgeSmall,4529,153,256,42,0,256,551,593,9174,0,0,4,0
_ShipMission_LocationCover-Bottom,4530,153,256,38,0,256,678,716,9175,0,0,4,0
_ShipMission_RewardsBorder-Top-Desaturate,4531,153,64,25,0,64,807,832,9176,0,0,4,0
_ShipMission_TopBorder,4532,153,32,10,0,32,890,900,9177,0,0,4,0
ShipMission_FollowerListButton-Highlight,4533,156,255,80,35,290,941,1021,9178,0,0,0,0
ShipMission_FollowerListButton-Select,4534,156,255,80,35,290,859,939,9179,0,0,0,0
ShipMission_FollowerListButton,4535,156,255,80,1,256,719,799,9180,0,0,0,0
ShipMission_IconLevelBG,4536,156,91,65,372,463,941,1006,9181,0,0,0,0
ShipMission_TopBorderCorner,4537,156,26,33,345,371,271,304,9182,0,0,0,0
ShipMission_Bg-DarkEdgeCorner,4538,152,46,256,317,363,642,898,8260,0,0,0,0
ShipMission_BoatRarity-Epic,4539,152,27,20,559,586,289,309,8261,0,0,0,0
ShipMission_BoatRarity-Rare,4540,152,27,20,588,615,289,309,8262,0,0,0,0
ShipMission_BoatRarity-Uncommon,4541,152,27,20,617,644,289,309,8264,0,0,0,0
ShipMission_DangerousSkull,4542,152,17,18,763,780,254,272,8268,0,0,0,0
ShipMission_EncounterAbilityBorder-Lg,4543,152,46,46,974,1020,628,674,8271,0,0,0,0
ShipMission_EncounterAbilityBorder,4544,152,32,32,759,791,435,467,9183,0,0,0,0
ShipMission_LocationCover-Side,4545,152,49,230,604,653,774,1004,9187,0,0,0,0
ShipMission_MissionCostStartButtonBg,4546,152,376,51,433,809,523,574,9188,0,0,0,0
ShipMission_RewardsBG-Desaturate,4547,152,502,154,1,503,157,311,9189,0,0,0,0
ShipMission_RewardsBorder-Corner-Desaturate,4548,152,64,64,826,890,811,875,9190,0,0,0,0
ShipMission_StartMissionFrame,4549,152,215,39,780,995,576,615,9191,0,0,0,0
ShipMissionParchment-Tile,4550,615,256,256,0,256,0,256,8272,0,0,6,0
_GarrMissionLocation-TannanSea-Back,4551,616,1024,285,0,1024,1,286,9192,0,0,4,0
_GarrMissionLocation-TannanSea-Fore,4552,616,1024,285,0,1024,288,573,9193,0,0,4,0
_GarrMissionLocation-TannanSea-Mid,4553,616,1024,285,0,1024,575,860,9194,0,0,4,0
ShipMission_CurrencyIcon-Oil,4554,157,57,57,60,117,60,117,9195,0,0,0,0
NavalMap-Horde-Fog,4557,612,496,361,1,497,633,994,9016,0,0,0,0
NavalMap-Horde-Highlight,4558,612,496,361,499,995,633,994,9017,0,0,0,0
NavalMap-Alliance-Fog,4559,618,449,351,1,450,1,352,9018,0,0,0,0
NavalMap-IronHorde-Fog,4560,618,454,353,1,455,354,707,9019,0,0,0,0
NavalMap-OpenWaters-Fog,4561,618,452,306,457,909,709,1015,9020,0,0,0,0
NavalMap-Alliance-Highlight,4562,618,449,351,452,901,1,352,9021,0,0,0,0
NavalMap-IronHorde-Highlight,4563,618,454,353,457,911,354,707,9022,0,0,0,0
NavalMap-OpenWaters-Highlight,4564,618,452,306,1,453,709,1015,9023,0,0,0,0
ShipMission_FollowerBG,4566,152,152,128,789,941,157,285,9196,0,0,0,0
ShipMission_FollowerBG-Glow,4567,156,152,128,138,290,427,555,9197,0,0,0,0
Ships_GalleonH-List,4568,620,154,80,1,155,131,211,9198,0,0,0,0
Ships_GalleonH-Portrait,4569,620,152,128,1,153,1,129,9199,0,0,0,0
Ships_GalleonH-Map,4582,621,83,72,1,84,1,73,9212,0,0,0,0
ShipMissionIcon-Combat-Map,4585,622,64,64,135,199,324,388,9213,0,0,0,0
ShipMissionIcon-Combat-MapBadge,4586,622,34,34,91,125,428,462,9200,0,0,0,0
ShipMissionIcon-Oil-Map,4587,622,64,64,201,265,258,322,9201,0,0,0,0
ShipMissionIcon-Oil-MapBadge,4588,622,34,34,135,169,456,490,9203,0,0,0,0
ShipMissionIcon-SiegeA-Map,4589,622,64,64,201,265,324,388,9204,0,0,0,0
ShipMissionIcon-SiegeA-MapBadge,4590,622,34,34,201,235,456,490,9206,0,0,0,0
ShipMissionIcon-SiegeH-Map,4591,622,64,64,201,265,390,454,9207,0,0,0,0
ShipMissionIcon-SiegeH-MapBadge,4592,622,34,34,465,499,258,292,9209,0,0,0,0
ShipMissionIcon-Training-Map,4593,622,64,64,399,463,258,322,9210,0,0,0,0
ShipMissionIcon-Training-MapBadge,4594,622,34,34,267,301,462,496,9214,0,0,0,0
ShipMissionIcon-Treasure-Map,4595,622,64,64,267,331,324,388,9215,0,0,0,0
ShipMissionIcon-Treasure-MapBadge,4596,622,34,34,333,367,324,358,9216,0,0,0,0
Ships_TroopTransport-List,4597,623,154,80,1,155,131,211,9217,0,0,0,0
Ships_TroopTransport-Portrait,4598,623,152,128,1,153,1,129,9218,0,0,0,0
Ships_TroopTransport-Map,4599,624,83,72,1,84,1,73,9219,0,0,0,0
Ships_EnemyTroopTransport-Portrait,4600,625,152,128,1,153,1,129,9220,0,0,0,0
Ships_Dreadnaught-List,4601,626,154,80,1,155,131,211,9221,0,0,0,0
Ships_Dreadnaught-Portrait,4602,626,152,128,1,153,1,129,9222,0,0,0,0
Ships_Dreadnaught-Map,4603,627,94,94,1,95,1,95,9024,0,0,0,0
Ships_EnemyDreadnaught-Portrait,4604,628,152,128,1,153,1,129,9002,0,0,0,0
Ships_SubmarineH-List,4605,629,154,80,1,155,131,211,9003,0,0,0,0
Ships_SubmarineH-Portrait,4606,629,152,128,1,153,1,129,9004,0,0,0,0
Ships_SubmarineH-Map,4607,630,83,72,1,84,1,73,9005,0,0,0,0
Ships_EnemySubmarineH-Portrait,4608,631,152,128,1,153,1,129,9006,0,0,0,0
Ships_SubmarineA-List,4609,632,154,80,1,155,131,211,9007,0,0,0,0
Ships_SubmarineA-Portrait,4610,632,152,128,1,153,1,129,9008,0,0,0,0
Ships_SubmarineA-Map,4611,633,83,72,1,84,1,73,9009,0,0,0,0
Ships_EnemySubmarineA-Portrait,4612,634,152,128,1,153,1,129,9010,0,0,0,0
ShipMissionIcon-Combat-Mission,4613,323,64,64,67,131,397,461,9223,0,0,0,0
ShipMissionIcon-Oil-Mission,4614,323,64,64,199,263,133,197,9202,0,0,0,0
ShipMissionIcon-SiegeA-Mission,4615,323,64,64,265,329,133,197,9205,0,0,0,0
ShipMissionIcon-SiegeH-Mission,4616,323,64,64,331,395,133,197,9208,0,0,0,0
ShipMissionIcon-Training-Mission,4617,323,64,64,133,197,265,329,9211,0,0,0,0
ShipMissionIcon-Treasure-Mission,4618,323,64,64,133,197,331,395,9011,0,0,0,0
Ships_EnemyGalleonH-Portrait,4619,635,152,128,1,153,1,129,9012,0,0,0,0
Ships_GalleonA-List,4620,636,154,80,1,155,131,211,9013,0,0,0,0
Ships_GalleonA-Portrait,4621,636,152,128,1,153,1,129,9015,0,0,0,0
Ships_GalleonA-Map,4622,637,83,72,1,84,1,73,9025,0,0,0,0
Ships_EnemyGalleonA-Portrait,4623,638,152,128,1,153,1,129,9026,0,0,0,0
Ships_CargoShip-List,4624,639,154,80,1,155,131,211,9027,0,0,0,0
Ships_CargoShip-Portrait,4625,639,152,128,1,153,1,129,9028,0,0,0,0
Ships_CargoShip-Map,4626,640,94,94,1,95,1,95,9029,0,0,0,0
Ships_EnemyCargoShip-Portrait,4627,641,152,128,1,153,1,129,9057,0,0,0,0
Ships_Carrier-List,4628,642,154,80,1,155,131,211,9058,0,0,0,0
Ships_Carrier-Portrait,4629,642,152,128,1,153,1,129,9059,0,0,0,0
Ships_Carrier-Map,4630,643,94,94,1,95,1,95,9060,0,0,0,0
Ships_EnemyCarrier-Portrait,4631,644,152,128,1,153,1,129,9061,0,0,0,0
ShipMission_ShipFollower-EquipmentBG,4632,156,78,78,292,370,941,1019,9062,0,0,0,0
ShipMission_ShipFollower-EquipmentFrame,4633,156,78,78,258,336,719,797,9063,0,0,0,0
ShipMission_ShipFollower-Lock-Epic,4634,156,48,61,460,508,719,780,9064,0,0,0,0
ShipMission_ShipFollower-Lock-Rare,4635,156,48,61,461,509,232,293,9065,0,0,0,0
ShipMission_ShipFollower-TypeFrame,4636,156,78,78,381,459,232,310,9066,0,0,0,0
transmog-frame-small-pink,4637,610,38,38,461,499,1,39,9067,0,0,0,0
transmog-frame-small,4638,610,40,40,377,417,1,41,9068,0,0,0,0
transmog-frame-small-selected,4639,610,40,40,419,459,1,41,9069,0,0,0,0
transmog-frame-small-red,4640,610,38,38,191,229,48,86,9070,0,0,0,0
ShipMission-RedGlowRing,4642,622,88,88,1,89,392,480,9456,0,0,0,0
adventureguide-rewardring,4670,609,48,48,347,395,1,49,9457,0,0,0,0
WildBattlePet,4672,647,32,32,440,472,236,268,9494,0,0,8,0
StableMaster,4673,647,32,32,406,438,168,200,9495,0,0,8,0
ArchBlob,4674,647,32,32,32,64,168,200,9496,0,0,8,0
Banker,4675,647,32,32,32,64,372,404,9497,0,0,8,0
Focus,4676,647,32,32,66,98,440,472,9498,0,0,8,0
BattleMaster,4677,647,32,32,32,64,406,438,9499,0,0,8,0
Ammunition,4678,647,32,32,32,64,100,132,9500,0,0,8,0
Class,4679,647,32,32,32,64,474,506,9501,0,0,8,0
Profession,4681,647,32,32,406,438,134,166,9503,0,0,8,0
Target,4682,647,32,32,440,472,168,200,9504,0,0,8,0
Food,4683,647,32,32,100,132,100,132,9505,0,0,8,0
Reagents,4684,647,32,32,202,234,168,200,9506,0,0,8,0
Innkeeper,4685,647,32,32,202,234,100,132,9507,0,0,8,0
Auctioneer,4686,647,32,32,32,64,270,302,9508,0,0,8,0
Repair,4687,647,32,32,236,268,168,200,9509,0,0,8,0
Mailbox,4688,647,32,32,304,336,100,132,9510,0,0,8,0
FlightMaster,4689,647,32,32,66,98,372,404,9511,0,0,8,0
None,4690,647,32,32,100,132,304,336,9512,0,0,8,0
QuestBlob,4691,647,32,32,134,166,168,200,9513,0,0,8,0
TrivialQuests,4692,647,32,32,168,200,202,234,9514,0,0,8,0
Poisons,4693,647,32,32,270,302,134,166,9515,0,0,8,0
PlayerFriend,4694,647,32,32,134,166,134,166,9516,0,0,8,0
QuestRepeatableTurnin,4695,647,32,32,134,166,406,438,9517,0,0,8,0
MantidTowerDestroyed,4697,647,32,32,372,404,100,132,9519,0,0,8,0
PortalRed,4698,647,32,32,372,404,134,166,9520,0,0,8,0
QuestTurnin,4699,647,32,32,134,166,474,506,9521,0,0,8,0
Object,4701,647,32,32,100,132,338,370,9523,0,0,8,0
Gear,4702,647,32,32,134,166,100,132,9524,0,0,8,0
MonsterFriend,4703,647,32,32,100,132,202,234,9525,0,0,8,0
MonsterEnemy,4704,647,32,32,100,132,168,200,9526,0,0,8,0
PortalPurple,4705,647,32,32,338,370,134,166,9527,0,0,8,0
DungeonSkull,4707,647,32,32,66,98,338,370,9529,0,0,8,0
PlayerNeutral,4708,647,32,32,168,200,134,166,9530,0,0,8,0
MonsterNeutral,4710,647,32,32,100,132,236,268,9531,0,0,8,0
PortalBlue,4711,647,32,32,304,336,134,166,9532,0,0,8,0
QuestLegendaryTurnin,4712,647,32,32,134,166,304,336,9533,0,0,8,0
QuestDaily,4713,647,32,32,134,166,236,268,9534,0,0,8,0
PlayerControlled,4714,647,32,32,100,132,406,438,9535,0,0,8,0
VignetteLoot,4715,647,32,32,304,336,236,268,9536,0,0,8,0
VignetteEvent,4716,647,32,32,202,234,440,472,9537,0,0,8,0
PlayerEnemy,4717,647,32,32,100,132,474,506,9538,0,0,8,0
PartyMember,4719,647,32,32,100,132,372,404,9539,0,0,8,0
XMarksTheSpot,4720,647,32,32,236,268,304,336,9540,0,0,8,0
QuestObjective,4721,647,32,32,134,166,372,404,9541,0,0,8,0
QuestLegendary,4723,647,32,32,134,166,270,302,9542,0,0,8,0
ArtifactQuest,4725,647,32,32,32,64,202,234,9543,0,0,8,0
QuestNormal,4726,647,32,32,134,166,338,370,9544,0,0,8,0
VignetteLootElite,4727,647,32,32,338,370,236,268,9545,0,0,8,0
FlightPath,4728,647,32,32,66,98,406,438,9546,0,0,8,0
VignetteEventElite,4729,647,32,32,202,234,474,506,9267,0,0,8,0
ChatBallon,4730,647,32,32,32,64,440,472,9359,0,0,8,0
MantidTower,4731,647,32,32,338,370,100,132,9360,0,0,8,0
RaidMember,4732,647,32,32,168,200,168,200,9361,0,0,8,0
VignetteKill,4733,647,32,32,236,268,236,268,9362,0,0,8,0
QuestBonusObjective,4734,647,32,32,134,166,202,234,9363,0,0,8,0
ArtifactQuestTurnin,4735,647,32,32,32,64,236,268,9364,0,0,8,0
SmallQuestBang,4736,647,32,32,372,404,168,200,9365,0,0,8,0
VignetteKillElite,4737,647,32,32,270,302,236,268,9366,0,0,8,0
GreenCross,4738,647,32,32,168,200,100,132,9367,0,0,8,0
PlayerDeadBlip,4740,647,32,32,100,132,440,472,9368,0,0,8,0
PlayerPartyBlip,4741,647,32,32,202,234,134,166,9369,0,0,8,0
PlayerRaidBlip,4742,647,32,32,236,268,134,166,9370,0,0,8,0
Vehicle-Air-Alliance,4743,647,64,64,67,131,1,65,9400,0,0,8,0
Vehicle-Air-Horde,4745,647,64,64,133,197,1,65,9402,0,0,8,0
Vehicle-Air-Occupied,4746,647,32,32,168,200,236,268,9403,0,0,8,0
Vehicle-Air-Unoccupied,4747,647,32,32,168,200,270,302,9404,0,0,8,0
Vehicle-AllianceCart,4748,647,32,32,168,200,304,336,9405,0,0,8,0
Vehicle-Carriage,4749,647,64,64,199,263,1,65,9406,0,0,8,0
Vehicle-Ground-Occupied,4750,647,32,32,168,200,338,370,9407,0,0,8,0
Vehicle-Ground-Unoccupied,4751,647,32,32,168,200,372,404,9408,0,0,8,0
Vehicle-GrummleConvoy,4752,647,32,32,168,200,406,438,9409,0,0,8,0
Vehicle-HammerGold-1,4753,647,32,32,168,200,474,506,9410,0,0,8,0
Vehicle-HammerGold-2,4754,647,32,32,202,234,202,234,9411,0,0,8,0
Vehicle-HammerGold-3,4755,647,32,32,236,268,202,234,9412,0,0,8,0
Vehicle-HammerGold,4756,647,32,32,168,200,440,472,9413,0,0,8,0
Vehicle-HordeCart,4757,647,32,32,270,302,202,234,9414,0,0,8,0
Vehicle-Mogu,4758,647,32,32,304,336,202,234,9415,0,0,8,0
Vehicle-SilvershardMines-Arrow,4759,647,32,32,338,370,202,234,9416,0,0,8,0
Vehicle-SilvershardMines-MineCart,4760,647,32,32,372,404,202,234,9417,0,0,8,0
Vehicle-SilvershardMines-MineCartBlue,4761,647,32,32,406,438,202,234,9418,0,0,8,0
Vehicle-SilvershardMines-MineCartRed,4762,647,32,32,440,472,202,234,9419,0,0,8,0
Vehicle-TempleofKotmogu-CyanBall,4763,647,32,32,474,506,202,234,9420,0,0,8,0
Vehicle-TempleofKotmogu-GreenBall,4764,647,32,32,202,234,236,268,9421,0,0,8,0
Vehicle-TempleofKotmogu-OrangeBall,4765,647,32,32,202,234,270,302,9422,0,0,8,0
Vehicle-TempleofKotmogu-PurpleBall,4766,647,32,32,202,234,304,336,9423,0,0,8,0
Vehicle-Trap-Gold,4767,647,32,32,202,234,338,370,9424,0,0,8,0
Vehicle-Trap-Grey,4768,647,32,32,202,234,372,404,9425,0,0,8,0
Vehicle-Trap-Red,4769,647,32,32,202,234,406,438,9426,0,0,8,0
QuestSkull,4770,647,32,32,134,166,440,472,9427,0,0,8,0
Focus-Tracker,4771,647,32,32,66,98,474,506,9458,0,0,8,0
MagePortalAlliance,4772,647,32,32,236,268,100,132,9459,0,0,8,0
MagePortalHorde,4773,647,32,32,270,302,100,132,9460,0,0,8,0
QuestArtifact,4774,647,32,32,440,472,134,166,9461,0,0,8,0
QuestArtifactTurnin,4775,647,32,32,474,506,134,166,9462,0,0,8,0
Target-Tracker,4776,647,32,32,474,506,168,200,9463,0,0,8,0
WarlockPortalAlliance,4777,647,32,32,372,404,236,268,9464,0,0,8,0
WarlockPortalHorde,4778,647,32,32,406,438,236,268,9465,0,0,8,0
WildBattlePet-Tracker,4779,647,32,32,474,506,236,268,9466,0,0,8,0
WildBattlePetCapturable,4780,647,32,32,236,268,270,302,9467,0,0,8,0
CrossedFlags,4781,647,32,32,66,98,100,132,9468,0,0,8,0
CrossedFlagsWithTimer,4782,647,32,32,66,98,134,166,9469,0,0,8,0
MiniMap-DeadArrow,4785,647,32,32,406,438,100,132,9437,0,0,8,0
MiniMap-PositionArrows,4786,647,16,32,1,17,138,170,9438,0,0,8,0
MiniMap-QuestArrow,4787,647,32,32,440,472,100,132,9439,0,0,8,0
MiniMap-VignetteArrow,4788,647,32,32,474,506,100,132,9440,0,0,8,0
MinimapArrow,4789,647,32,32,100,132,134,166,9441,0,0,8,0
Rotating-MinimapArrow,4790,647,32,32,270,302,168,200,9442,0,0,8,0
Rotating-MinimapGroupArrow,4791,647,32,32,304,336,168,200,9443,0,0,8,0
Rotating-MinimapGuideArrow,4792,647,32,32,338,370,168,200,9444,0,0,8,0
MiniMap-PositionArrowDown,4793,647,48,48,331,379,1,49,9470,0,0,8,0
MiniMap-PositionArrowUp,4794,647,48,48,381,429,1,49,9471,0,0,8,0
MovieRecordingIcon,4795,647,32,32,100,132,270,302,9493,0,0,8,0
BossBanner-RedLightning,4798,594,122,118,1,123,295,413,9343,0,0,0,0
Artifacts-PerkRing-GoldMedal,4800,607,88,88,136,224,932,1020,9268,0,0,0,0
Artifacts-PerkRing-MainProc-Glow,4801,607,120,120,1,121,470,590,9269,0,0,0,0
Artifacts-PerkRing-MainProc,4802,607,92,92,502,594,894,986,9270,0,0,0,0
Artifacts-PerkRing-Small,4803,607,60,60,1,61,958,1018,9271,0,0,0,0
Artifacts-PointsBox,4804,607,28,24,981,1009,73,97,9272,0,0,0,0
Artifacts-PerkRing-Highlight,4808,607,46,46,760,806,870,916,9401,0,0,0,0
ArtifactsFX-SpinningGlowys,4809,607,70,70,760,830,699,769,9428,0,0,0,0
ArtifactsFX-StarBurst,4810,607,133,133,1,134,335,468,9429,0,0,0,0
ArtifactsFX-Whirls,4811,607,76,76,792,868,121,197,9430,0,0,0,0
ArtifactsFX-YellowRing,4812,607,50,50,760,810,818,868,9431,0,0,0,0
Artifacts-DemonHunter-BG,4813,649,896,615,1,897,1,616,9432,0,0,0,0
Artifacts-Paladin-BG,4815,650,896,615,1,897,1,616,9433,0,0,0,0
Artifacts-PointsBoxGreen,4817,607,28,24,226,254,932,956,9310,0,0,0,0
ArtifactsFX-PointSideBurstLeft,4818,607,33,35,990,1023,200,235,9311,0,0,0,0
ArtifactsFX-PointSideBurstRight,4819,607,33,35,990,1023,237,272,9312,0,0,0,0
vas-receipt-selectedcharbg,4837,654,302,72,149,451,1,73,9307,0,0,0,0
Ships_CarrierA-List,4838,655,154,80,1,155,131,211,9278,0,0,0,0
Ships_CarrierA-Portrait,4839,655,152,128,1,153,1,129,9279,0,0,0,0
Ships_CarrierA-Map,4840,656,83,72,1,84,1,73,9280,0,0,0,0
Ships_CarrierH-Map,4841,657,83,72,1,84,1,73,9281,0,0,0,0
Ships_CarrierH-List,4842,658,154,80,1,155,131,211,9282,0,0,0,0
Ships_CarrierH-Portrait,4843,658,152,128,1,153,1,129,9283,0,0,0,0
GarrLanding-ShipMission-Complete,4844,268,400,47,620,1020,266,313,9284,0,0,0,0
GarrLanding-ShipMission-InProgress,4845,268,400,47,520,920,408,455,9285,0,0,0,0
_GarrMissionLocation-FrostfireSea-Back,4846,659,1024,285,0,1024,1,286,9445,0,0,4,0
_GarrMissionLocation-FrostfireSea-Fore,4847,659,1024,285,0,1024,288,573,9446,0,0,4,0
_GarrMissionLocation-FrostfireSea-Mid,4848,659,1024,285,0,1024,575,860,9447,0,0,4,0
_GarrMissionLocation-ShadowmoonSea-Back,4849,660,1024,285,0,1024,1,286,9448,0,0,4,0
_GarrMissionLocation-ShadowmoonSea-Fore,4850,660,1024,285,0,1024,288,573,9449,0,0,4,0
_GarrMissionLocation-ShadowmoonSea-Mid,4851,660,1024,285,0,1024,575,860,9450,0,0,4,0
_GarrMissionLocation-NagrandSea-Back,4852,661,1024,285,0,1024,1,286,9451,0,0,4,0
_GarrMissionLocation-NagrandSea-Fore,4853,661,1024,285,0,1024,288,573,9452,0,0,4,0
_GarrMissionLocation-NagrandSea-Mid,4854,661,1024,285,0,1024,575,860,9453,0,0,4,0
ShipMission_Toast,4855,150,317,82,1,318,169,251,9308,0,0,0,0
adventureguide-redx,4856,609,35,34,347,382,90,124,9502,0,0,0,0
Artifacts-MageArcane-BG,4858,662,896,615,1,897,1,616,9372,0,0,0,0
GarrisonFX_BlueFlare,4859,308,128,128,1,129,271,399,9309,0,0,0,0
GarrMission_WeakEncounterAbilityBorder-Lg,4860,152,46,46,317,363,948,994,9454,0,0,0,0
bonusobjectives-bar-bg,4861,663,193,18,208,401,315,333,9518,0,0,0,0
bonusobjectives-bar-fill,4862,663,1,18,259,260,153,171,9522,0,0,0,0
bonusobjectives-bar-frame,4863,663,240,51,1,241,262,313,9528,0,0,0,0
bonusobjectives-bar-glow-ring,4864,663,240,51,243,483,262,313,9242,0,0,0,0
bonusobjectives-bar-glow,4865,663,205,31,1,206,315,346,9243,0,0,0,0
bonusobjectives-bar-ring,4866,663,81,51,404,485,47,98,9244,0,0,0,0
bonusobjectives-bar-sheen,4867,663,97,44,404,501,1,45,9245,0,0,0,0
bonusobjectives-bar-spark,4868,663,10,28,247,257,153,181,9246,0,0,0,0
bonusobjectives-bar-starburst,4869,663,36,36,404,440,100,136,9247,0,0,0,0
bonusobjectives-title-bg,4870,663,418,76,1,419,184,260,9248,0,0,0,0
bonusobjectives-title-icon,4871,663,155,150,247,402,1,151,9250,0,0,0,0
ShipMission_NameBG,4873,153,132,21,1,133,918,939,9287,0,0,0,0
ShipMission_PartyBuffsBG,4874,153,256,33,0,256,718,751,9288,0,0,4,0
Ships_DreadnaughtA-List,4875,664,154,80,1,155,131,211,9289,0,0,0,0
Ships_DreadnaughtA-Portrait,4876,664,152,128,1,153,1,129,9286,0,0,0,0
Ships_DreadnaughtA-Map,4877,665,83,72,1,84,1,73,9290,0,0,0,0
Ships_DreadnaughtH-List,4878,666,154,80,1,155,131,211,9291,0,0,0,0
Ships_DreadnaughtH-Portrait,4879,666,152,128,1,153,1,129,9292,0,0,0,0
Ships_DreadnaughtH-Map,4880,667,83,72,1,84,1,73,9293,0,0,0,0
Ships_EnemyDreadnaughtH-Portrait,4881,668,152,128,1,153,1,129,9294,0,0,0,0
Ships_EnemyDreadnaughtA-Portrait,4882,669,152,128,1,153,1,129,9295,0,0,0,0
FontStyle_Parchment,4883,670,256,256,0,256,0,256,9251,0,0,6,0
FontStyle_BlueGradient,4884,671,128,128,0,128,0,128,9296,0,0,6,0
FontStyle_Garrisons,4885,672,256,256,0,256,0,256,9297,0,0,6,0
FontStyle_IronHordeMetal,4886,673,256,256,0,256,0,256,9298,0,0,6,0
FontStyle_Legion,4887,674,256,256,0,256,0,256,9299,0,0,6,0
FontStyle_Metal,4888,675,256,256,0,256,0,256,9300,0,0,6,0
splash-620-botleft,4889,676,137,371,374,511,587,958,9301,0,0,0,0
splash-620-right,4890,676,510,584,1,511,1,585,9302,0,0,0,0
splash-620-topleft,4891,676,371,434,1,372,587,1021,9303,0,0,0,0
Artifacts-DeathKnightFrost-BG,4892,677,896,615,1,897,1,616,9304,0,0,0,0
shop-card-darkcover,4893,654,146,209,1,147,1,210,9455,0,0,0,0
Artifacts-Warrior-BG,4894,678,896,615,1,897,1,616,9305,0,0,0,0
Artifacts-Rogue-BG,4895,679,896,615,1,897,1,616,9373,0,0,0,0
Artifacts-Druid-BG,4896,680,896,615,1,897,1,616,9374,0,0,0,0
ShipMissionIcon-Bonus-Mission,4897,323,64,64,67,131,331,395,9344,0,0,0,0
ShipMissionIcon-Bonus-Map,4898,622,64,64,135,199,258,322,9345,0,0,0,0
ShipMissionIcon-Bonus-MapBadge,4899,622,34,34,91,125,392,426,9346,0,0,0,0
NavalMap-CircleGlowTrails,4900,622,255,255,1,256,1,256,9347,0,0,0,0
NavalMap-LargeBonusCircle,4901,622,234,234,258,492,1,235,9348,0,0,0,0
NavalMap-SmallBonusCircle,4902,622,132,132,1,133,258,390,9349,0,0,0,0
GarrisonFX-StarBurst,4903,308,133,133,1,134,136,269,9350,0,0,0,0
GarrMission_WeakEncounterAbilityBorder,4904,152,32,32,793,825,435,467,9306,0,0,0,0
ShipMission-TimerBG,4905,622,55,21,1,56,482,503,9351,0,0,0,0
services-icon-warning,4928,687,42,37,1,43,985,1022,9434,0,0,0,0
ShipMissionIcon-Legendary-Map,4929,622,64,64,135,199,390,454,9371,0,0,0,0
ShipMissionIcon-Legendary-MapBadge,4930,622,34,34,91,125,464,498,9375,0,0,0,0
ShipMissionIcon-Legendary-Mission,4931,323,64,64,133,197,133,197,9376,0,0,0,0
_ForgeBorder-Top,4967,688,256,16,0,256,1,17,9313,0,0,4,0
!ForgeBorder-Right,4968,689,16,256,1,17,0,256,9314,0,0,2,0
_DemonHunter-DemonicFuryBar,4969,690,128,10,0,128,1,11,9315,0,0,4,0
services-icon-goldborder,4970,687,62,62,825,887,82,144,9316,0,0,0,0
vas-receipt-brownarrow,4971,654,30,15,37,67,212,227,9435,0,0,0,0
vas-receipt-greenbg,4972,654,297,46,149,446,75,121,9436,0,0,0,0
,4973,654,34,34,0,0,0,0,0,0,0,1,0
,4974,654,34,34,0,0,0,0,0,0,0,1,0
,4975,654,34,34,0,0,0,0,0,0,0,1,0
,4976,654,34,34,0,0,0,0,0,0,0,1,0
,4977,654,34,34,0,0,0,0,0,0,0,1,0
,4978,654,34,34,0,0,0,0,0,0,0,1,0
,4979,654,34,34,0,0,0,0,0,0,0,1,0
,4980,654,34,34,0,0,0,0,0,0,0,1,0
,4981,654,34,34,0,0,0,0,0,0,0,1,0
,4982,654,34,34,0,0,0,0,0,0,0,1,0
,4983,654,34,34,0,0,0,0,0,0,0,1,0
,4984,654,34,34,0,0,0,0,0,0,0,1,0
,4985,654,34,34,0,0,0,0,0,0,0,1,0
,4986,654,34,34,0,0,0,0,0,0,0,1,0
,4987,654,34,34,0,0,0,0,0,0,0,1,0
,4988,654,34,34,0,0,0,0,0,0,0,1,0
,4989,654,34,34,0,0,0,0,0,0,0,1,0
,4990,654,34,34,0,0,0,0,0,0,0,1,0
,4991,654,34,34,0,0,0,0,0,0,0,1,0
,4992,654,34,34,0,0,0,0,0,0,0,1,0
,4993,654,34,34,0,0,0,0,0,0,0,1,0
,4994,654,34,34,0,0,0,0,0,0,0,1,0
,4995,654,34,34,0,0,0,0,0,0,0,1,0
,4996,654,34,34,0,0,0,0,0,0,0,1,0
,4997,654,34,34,0,0,0,0,0,0,0,1,0
,4998,654,34,34,0,0,0,0,0,0,0,1,0
,4999,654,34,34,0,0,0,0,0,0,0,1,0
,5000,654,34,34,0,0,0,0,0,0,0,1,0
Ships_EnemyCarrierA-Portrait,5001,691,152,128,1,153,1,129,9472,0,0,0,0
Ships_EnemyCarrierH-Portrait,5002,692,152,128,1,153,1,129,9473,0,0,0,0
LootToast-MoreAwesome,5003,332,276,96,289,565,101,197,9384,0,0,0,0
legioninvasion-map-icon-portal-large,5005,693,59,62,314,373,144,206,9474,0,0,0,0
legioninvasion-map-icon-portal,5006,693,42,44,425,467,144,188,9475,0,0,0,0
legioninvasion-scenario-rewardring,5007,693,48,48,375,423,144,192,9476,0,0,0,0
legioninvasion-ScenarioTrackerToast,5008,693,243,77,1,244,224,301,9477,0,0,0,0
legioninvasion-Toast-Frame,5009,693,311,78,1,312,144,222,9478,0,0,0,0
legioninvasion-map-cover,5010,694,1004,672,1,1005,1,673,9479,0,0,0,0
ShipMissionIcon-SiegeIHA-Map,5012,622,64,64,267,331,258,322,9385,0,0,0,0
ShipMissionIcon-SiegeIHA-MapBadge,5013,622,34,34,267,301,390,424,9386,0,0,0,0
ShipMissionIcon-SiegeIHH-Map,5014,622,64,64,333,397,258,322,9387,0,0,0,0
ShipMissionIcon-SiegeIHH-MapBadge,5015,622,34,34,267,301,426,460,9388,0,0,0,0
ShipMissionIcon-SiegeIHA-Mission,5016,323,64,64,397,461,133,197,9389,0,0,0,0
ShipMissionIcon-SiegeIHH-Mission,5017,323,64,64,133,197,199,263,9390,0,0,0,0
tournamentarena-flag-large-blue-flash,5021,695,128,64,389,517,165,229,9391,0,0,0,0
tournamentarena-flag-large-blue,5022,695,128,64,259,387,165,229,9392,0,0,0,0
tournamentarena-flag-large-red-flash,5023,695,128,64,649,777,165,229,9393,0,0,0,0
tournamentarena-flag-large-red,5024,695,128,64,519,647,165,229,9394,0,0,0,0
tournamentarena-frame-bg-side-blue,5029,695,8,32,371,379,1,33,9397,0,0,0,0
tournamentarena-frame-bg-side-red,5030,695,8,32,361,369,1,33,9398,0,0,0,0
tournamentarena-frame-bot,5035,695,512,64,259,771,751,815,9480,0,0,0,0
tournamentarena-frame-botleft,5036,695,64,64,779,843,165,229,9481,0,0,0,0
tournamentarena-frame-botright,5037,695,64,64,911,975,165,229,9482,0,0,0,0
tournamentarena-frame-left,5038,695,64,256,1,65,751,1007,9483,0,0,0,0
tournamentarena-frame-right,5039,695,64,256,67,131,751,1007,9484,0,0,0,0
tournamentarena-frame-top,5040,695,512,64,259,771,947,1011,9485,0,0,0,0
tournamentarena-frame-topleft,5041,695,64,64,845,909,165,229,9486,0,0,0,0
tournamentarena-frame-topright,5042,695,64,64,775,839,361,425,9487,0,0,0,0
tournamentarena-titlebackplate,5043,695,512,128,259,771,817,945,9488,0,0,0,0
honorsystem-bar-background,5044,696,471,18,130,601,433,451,9317,0,0,0,0
honorsystem-bar-frame,5045,696,521,45,1,522,386,431,9318,0,0,0,0
honorsystem-bar-spark,5046,696,16,64,910,926,223,287,9319,0,0,0,0
honorsystem-bar-rewardborder-prestige-flash,5048,696,127,131,1,128,433,564,9320,0,0,0,0
honorsystem-bar-rewardborder-prestige,5049,696,59,60,902,961,56,116,9321,0,0,0,0
honorsystem-bar-rewardborder,5050,696,39,39,940,979,118,157,9322,0,0,0,0
honorsystem-prestige-laurel-bg-alliance,5051,696,134,134,638,772,223,357,9323,0,0,0,0
honorsystem-prestige-laurel-bg-horde,5052,696,134,134,774,908,223,357,9324,0,0,0,0
honorsystem-prestige-laurel,5053,696,262,220,638,900,1,221,9325,0,0,0,0
honorsystem-talents-bg,5054,696,635,383,1,636,1,384,9326,0,0,0,0
_honorsystem-bar-fill,5055,697,256,17,0,256,1,18,9327,0,0,4,0
honorsystem-icon-prestige-1,5056,698,128,128,1,129,1,129,9328,0,0,0,0
honorsystem-icon-prestige-10,5057,698,128,128,1,129,131,259,9329,0,0,0,0
honorsystem-icon-prestige-11,5058,698,128,128,1,129,261,389,9330,0,0,0,0
honorsystem-icon-prestige-2,5059,698,128,128,131,259,1,129,9331,0,0,0,0
honorsystem-icon-prestige-3,5060,698,128,128,131,259,131,259,9332,0,0,0,0
honorsystem-icon-prestige-4,5061,698,128,128,131,259,261,389,9333,0,0,0,0
honorsystem-icon-prestige-5,5062,698,128,128,261,389,1,129,9334,0,0,0,0
honorsystem-icon-prestige-6,5063,698,128,128,261,389,131,259,9335,0,0,0,0
honorsystem-icon-prestige-7,5064,698,128,128,261,389,261,389,9336,0,0,0,0
honorsystem-icon-prestige-8,5065,698,128,128,391,519,1,129,9337,0,0,0,0
honorsystem-icon-prestige-9,5066,698,128,128,391,519,131,259,9338,0,0,0,0
bonusobjectives-title-icon-honor,5067,663,244,181,1,245,1,182,9339,0,0,0,0
honorsystem-bar-frame-small,5068,696,314,43,524,838,386,429,9340,0,0,0,0
honorsystem-bar-rewardborder-circle,5069,696,48,48,963,1011,56,104,9341,0,0,0,0
honorsystem-icon-bonus,5070,696,29,29,993,1022,1,30,9342,0,0,0,0
honorsystem-portrait-alliance,5071,698,50,52,1,51,391,443,9489,0,0,0,0
honorsystem-portrait-horde,5072,698,50,52,1,51,445,497,9490,0,0,0,0
DemonInvasion1,5073,647,32,32,66,98,168,200,9491,0,0,8,0
DemonInvasion2,5074,647,32,32,66,98,202,234,9492,0,0,8,0
DemonInvasion3,5075,647,32,32,66,98,236,268,9739,0,0,8,0
DemonInvasion4,5076,647,32,32,66,98,270,302,9740,0,0,8,0
_Shaman-MaelstromBar,5077,699,128,10,0,128,1,11,9587,0,0,4,0
_Druid-LunarBar,5078,700,128,10,0,128,1,11,9588,0,0,4,0
titleprestige-glowcover,5079,701,216,216,358,574,330,546,9698,0,0,0,0
titleprestige-prestigeicon,5080,701,89,91,916,1005,1,92,9699,0,0,0,0
titleprestige-starglow,5081,701,355,359,1,356,1,360,9700,0,0,0,0
titleprestige-title,5082,701,141,43,576,717,485,528,9701,0,0,0,0
titleprestige-title2,5083,701,140,24,778,918,548,572,9702,0,0,0,0
titleprestige-wreath,5084,701,262,153,576,838,330,483,9703,0,0,0,0
titleprestige-title-bg,5085,701,418,76,358,776,548,624,9589,0,0,0,0
titleprestige-ember,5086,701,27,31,280,307,362,393,9590,0,0,0,0
services-popup-bot,5087,702,198,44,201,399,215,259,9604,0,0,0,0
services-popup-botleft,5088,702,104,44,397,501,125,169,9605,0,0,0,0
services-popup-botright,5089,702,104,44,401,505,215,259,9606,0,0,0,0
services-popup-top,5090,702,198,60,1,199,215,275,9607,0,0,0,0
services-popup-topleft,5091,702,106,60,397,503,1,61,9608,0,0,0,0
services-popup-topright,5092,702,106,60,397,503,63,123,9609,0,0,0,0
services-popup-bg,5093,702,394,212,1,395,1,213,9610,0,0,0,0
services-popup-left,5094,702,64,32,397,461,171,203,9611,0,0,0,0
services-popup-right,5095,702,64,32,1,65,277,309,9612,0,0,0,0
titleprestige-wings,5096,701,277,327,1,278,362,689,9547,0,0,0,0
titleprestige-wings2,5097,701,277,327,358,635,1,328,9548,0,0,0,0
titleprestige-wings-white,5098,701,277,327,1,278,691,1018,9549,0,0,0,0
titleprestige-wings2-white,5099,701,277,327,637,914,1,328,9550,0,0,0,0
titleprestige-starcrown,5101,701,122,41,840,962,503,544,9741,0,0,0,0
AdventureMapLabel-Large,5103,703,455,63,354,809,311,374,9705,0,0,0,0
AdventureMapLabel-Small,5104,703,181,39,802,983,171,210,9706,0,0,0,0
AdventureMapIcon-DailyQuest,5106,703,25,41,846,871,250,291,9708,0,0,0,0
AdventureMapIcon-MissionCombat,5107,703,42,42,802,844,250,292,9709,0,0,0,0
AdventureMapIcon-Quest,5108,703,25,41,873,898,250,291,9710,0,0,0,0
AdventureMapIcon-SandboxQuest,5109,703,25,39,900,925,250,289,9711,0,0,0,0
QuestPortraitIcon-SandboxQuest,5110,703,33,55,967,1000,114,169,9712,0,0,0,0
Mage-ArcaneCharge,5111,704,39,39,60,99,61,100,9704,0,0,0,0
Mage-ArcaneChargeBar,5112,704,125,15,60,185,1,16,9713,0,0,0,0
Priest-InsanityOverlay,5113,705,55,36,196,251,13,49,9707,0,0,0,0
_Priest-InsanityBar,5114,705,128,10,0,128,1,11,9714,0,0,4,0
Legion-boostpopup-bottom,5115,706,430,70,1,431,185,255,9551,0,0,0,0
Legion-boostpopup-middle,5116,706,430,108,1,431,1,109,9552,0,0,0,0
Legion-boostpopup-top,5117,706,430,72,1,431,111,183,9553,0,0,0,0
AdventureMapIcon-Lock,5125,703,28,37,985,1013,171,208,9715,0,0,0,0
AdventureMapLabel-MissionTimer,5126,703,76,20,125,201,1001,1021,9716,0,0,0,0
AdventureMapLabel-QuestDiscovered,5127,703,189,36,802,991,212,248,9717,0,0,0,0
FXAM-QuestBang,5128,703,34,54,987,1021,1,55,9718,0,0,0,0
FXAM-SmallSpikeyGlow,5129,703,40,52,288,328,971,1023,9719,0,0,0,0
Mission-FollowerPortraitFrame,5130,703,49,47,288,337,874,921,9720,0,0,0,0
Mission-LootBackgroundGlow,5131,703,183,71,802,985,1,72,9721,0,0,0,0
FogofWar,5132,703,341,371,1,342,441,812,9722,0,0,0,0
AdventureMapQuest-QuestPane,5133,703,351,438,1,352,1,439,9723,0,0,0,0
AdventureMapQuest-RewardsPanel,5134,703,285,185,1,286,814,999,9724,0,0,0,0
AdventureMapQuest-ItemNameBG,5135,703,95,38,921,1016,74,112,9725,0,0,0,0
charactercreate-banner-bottom,5137,708,200,64,1,201,1975,2039,9742,0,0,0,0
charactercreate-banner-middle,5138,708,200,194,1149,1349,259,453,9743,0,0,0,0
charactercreate-banner-top,5139,708,200,49,1345,1545,497,546,9744,0,0,0,0
Artifacts-Shaman-BG,5140,709,896,615,1,897,1,616,9591,0,0,0,0
Artifacts-Hunter-BG,5145,710,896,615,1,897,1,616,9595,0,0,0,0
Artifacts-Priest-BG,5150,711,896,615,1,897,1,616,9599,0,0,0,0
Artifacts-Monk-BG,5155,712,896,615,1,897,1,616,9602,0,0,0,0
Artifacts-Warlock-BG,5160,713,896,615,1,897,1,616,9603,0,0,0,0
services-checkmark,5165,687,41,44,971,1012,1,45,9651,0,0,0,0
services-cover-ring,5166,687,80,82,256,336,867,949,9652,0,0,0,0
services-cover,5167,687,421,724,1,422,1,725,9653,0,0,0,0
services-icon-bonus-large,5168,687,34,34,89,123,985,1019,9654,0,0,0,0
services-icon-bonus-red,5169,687,19,19,179,198,985,1004,9655,0,0,0,0
services-icon-bonus,5170,687,19,19,200,219,985,1004,9656,0,0,0,0
services-icon-processing,5171,687,42,37,45,87,985,1022,9657,0,0,0,0
services-number-1,5172,687,71,79,338,409,867,946,9658,0,0,0,0
services-number-2,5173,687,71,79,679,750,1,80,9659,0,0,0,0
services-number-3,5174,687,71,79,679,750,82,161,9660,0,0,0,0
services-number-4,5175,687,71,79,679,750,163,242,9661,0,0,0,0
services-number-5,5176,687,71,79,752,823,1,80,9662,0,0,0,0
services-number-6,5177,687,71,79,752,823,82,161,9663,0,0,0,0
services-number-7,5178,687,71,79,752,823,163,242,9664,0,0,0,0
services-number-8,5179,687,71,79,825,896,1,80,9665,0,0,0,0
services-number-9,5180,687,71,79,898,969,1,80,9666,0,0,0,0
services-ring-countcircle,5181,687,32,32,125,157,985,1017,9667,0,0,0,0
services-ring-large-glow,5182,687,253,256,1,254,727,983,9668,0,0,0,0
services-ring-large-glowpulse,5183,687,145,138,256,401,727,865,9669,0,0,0,0
services-ring-large-glowspin,5184,687,253,256,424,677,1,257,9670,0,0,0,0
services-ring-large,5185,687,72,73,338,410,948,1021,9671,0,0,0,0
services-ring-wod,5186,687,72,68,256,328,951,1019,9672,0,0,0,0
services-ring,5187,687,59,60,825,884,146,206,9673,0,0,0,0
services-yellowarrow,5188,687,18,32,159,177,985,1017,9674,0,0,0,0
transmog-nav-slot-back,5189,610,35,37,152,187,460,497,9780,0,0,0,0
transmog-nav-slot-chest,5190,610,35,37,231,266,48,85,9781,0,0,0,0
transmog-nav-slot-feet,5191,610,35,37,268,303,48,85,9782,0,0,0,0
transmog-nav-slot-hands,5192,610,35,37,305,340,48,85,9783,0,0,0,0
transmog-nav-slot-head,5193,610,35,37,342,377,48,85,9784,0,0,0,0
transmog-nav-slot-legs,5194,610,35,37,379,414,48,85,9785,0,0,0,0
transmog-nav-slot-mainhand,5195,610,35,37,416,451,48,85,9786,0,0,0,0
transmog-nav-slot-selected,5197,610,45,47,105,150,460,507,9788,0,0,0,0
transmog-nav-slot-shirt,5198,610,35,37,191,226,88,125,9789,0,0,0,0
transmog-nav-slot-shoulder,5199,610,35,37,228,263,88,125,9790,0,0,0,0
transmog-nav-slot-tabard,5200,610,35,37,265,300,88,125,9791,0,0,0,0
transmog-nav-slot-waist,5201,610,35,37,302,337,88,125,9792,0,0,0,0
transmog-nav-slot-wrist,5202,610,35,37,339,374,88,125,9793,0,0,0,0
boostpopup-wod-bottom,5203,714,430,65,1,431,121,186,9794,0,0,0,0
boostpopup-wod-middle,5204,714,430,118,1,431,1,119,9795,0,0,0,0
boostpopup-wod-top,5205,714,430,65,1,431,188,253,9796,0,0,0,0
Relic-Arcane-Slot,5206,607,72,72,870,942,121,193,9613,0,0,0,0
Relic-Arcane-TraitBG,5207,607,120,120,1,121,592,712,9614,0,0,0,0
Relic-Arcane-TraitGlow,5208,607,120,120,1,121,714,834,9615,0,0,0,0
Relic-Arcane-TraitGlowRing,5209,607,120,120,1,121,836,956,9616,0,0,0,0
Relic-Blood-Slot,5210,607,72,72,944,1016,121,193,9617,0,0,0,0
Relic-Blood-TraitBG,5211,607,120,120,136,256,200,320,9618,0,0,0,0
Relic-Blood-TraitGlow,5212,607,120,120,136,256,322,442,9619,0,0,0,0
Relic-Blood-TraitGlowRing,5213,607,120,120,136,256,444,564,9620,0,0,0,0
Relic-Fel-Slot,5214,607,72,72,920,992,566,638,9621,0,0,0,0
Relic-Fel-TraitBG,5215,607,120,120,136,256,566,686,9622,0,0,0,0
Relic-Fel-TraitGlow,5216,607,120,120,136,256,688,808,9623,0,0,0,0
Relic-Fel-TraitGlowRing,5217,607,120,120,136,256,810,930,9624,0,0,0,0
Relic-Fire-Slot,5218,607,72,72,612,684,699,771,9625,0,0,0,0
Relic-Fire-TraitBG,5219,607,120,120,258,378,200,320,9626,0,0,0,0
Relic-Fire-TraitGlow,5220,607,120,120,380,500,200,320,9627,0,0,0,0
Relic-Fire-TraitGlowRing,5221,607,120,120,502,622,200,320,9628,0,0,0,0
Relic-Frost-Slot,5222,607,72,72,612,684,773,845,9629,0,0,0,0
Relic-Frost-TraitBG,5223,607,120,120,624,744,200,320,9630,0,0,0,0
Relic-Frost-TraitGlow,5224,607,120,120,746,866,200,320,9631,0,0,0,0
Relic-Frost-TraitGlowRing,5225,607,120,120,868,988,200,320,9632,0,0,0,0
Relic-Holy-Slot,5226,607,72,72,612,684,847,919,9633,0,0,0,0
Relic-Holy-TraitBG,5227,607,120,120,258,378,322,442,9634,0,0,0,0
Relic-Holy-TraitGlow,5228,607,120,120,258,378,444,564,9635,0,0,0,0
Relic-Holy-TraitGlowRing,5229,607,120,120,258,378,566,686,9636,0,0,0,0
Relic-Iron-Slot,5230,607,72,72,612,684,921,993,9637,0,0,0,0
Relic-Iron-TraitBG,5231,607,120,120,258,378,688,808,9638,0,0,0,0
Relic-Iron-TraitGlow,5232,607,120,120,258,378,810,930,9639,0,0,0,0
Relic-Iron-TraitGlowRing,5233,607,120,120,380,500,322,442,9640,0,0,0,0
Relic-Life-Slot,5234,607,72,72,686,758,699,771,9641,0,0,0,0
Relic-Life-TraitBG,5235,607,120,120,502,622,322,442,9642,0,0,0,0
Relic-Life-TraitGlow,5236,607,120,120,624,744,322,442,9643,0,0,0,0
Relic-Life-TraitGlowRing,5237,607,120,120,746,866,322,442,9644,0,0,0,0
Relic-Shadow-Slot,5238,607,72,72,686,758,773,845,9645,0,0,0,0
Relic-Shadow-TraitBG,5239,607,120,120,868,988,322,442,9646,0,0,0,0
Relic-Shadow-TraitGlow,5240,607,120,120,380,500,444,564,9647,0,0,0,0
Relic-Shadow-TraitGlowRing,5241,607,120,120,380,500,566,686,9648,0,0,0,0
Relic-SlotBG,5242,607,34,34,981,1015,1,35,9649,0,0,0,0
Relic-Water-Slot,5243,607,72,72,686,758,847,919,9650,0,0,0,0
Relic-Water-TraitBG,5244,607,120,120,380,500,688,808,9675,0,0,0,0
Relic-Water-TraitGlow,5245,607,120,120,380,500,810,930,9676,0,0,0,0
Relic-Water-TraitGlowRing,5246,607,120,120,502,622,444,564,9677,0,0,0,0
Relic-Wind-Slot,5247,607,72,72,686,758,921,993,9678,0,0,0,0
Relic-Wind-TraitBG,5248,607,120,120,624,744,444,564,9679,0,0,0,0
Relic-Wind-TraitGlow,5249,607,120,120,746,866,444,564,9680,0,0,0,0
Relic-Wind-TraitGlowRing,5250,607,120,120,868,988,444,564,9681,0,0,0,0
transmog-toast-bg,5251,715,253,75,1,254,1,76,9682,0,0,0,0
FullAlert-BigSpike,5252,716,27,34,1,28,1,35,9726,0,0,0,0
FullAlert-SoftCurveGlow,5253,716,20,37,30,50,1,38,9727,0,0,0,0
FullAlert-YellowCurveGlow,5254,716,20,37,52,72,1,38,9728,0,0,0,0
FullAlert-FrameGlow,5255,716,34,18,74,108,1,19,9729,0,0,0,0
accountupgradebanner-legion,5258,558,200,117,1,201,143,260,9745,0,0,0,0
Glues-WoW-LegionLogo,5259,717,510,256,1,511,1,257,9730,0,0,0,0
Glues-WoW-LegionLogo_cn,5260,717,510,256,1,511,259,515,9731,0,0,0,0
Glues-WoW-LegionLogo_tw,5261,717,510,256,1,511,517,773,9732,0,0,0,0
shop-games-legion,5262,718,138,86,149,287,128,214,9733,0,0,0,0
shop-games-legiondeluxe-card,5263,718,146,209,1,147,1,210,9734,0,0,0,0
shop-games-magnifyingglass,5264,718,46,47,289,335,1,48,9735,0,0,0,0
shop-games-legiondeluxe,5265,718,138,125,149,287,1,126,9736,0,0,0,0
Barbershop-Bottom,5266,580,271,103,542,813,1,104,9797,0,0,0,0
Barbershop-Top,5267,580,271,102,542,813,106,208,9798,0,0,0,0
!Barbershop-MiddleTile,5268,580,271,128,1,272,0,128,9799,0,0,2,0
AftLevelup-CloudyLineLeft,5269,607,255,67,278,533,121,188,9800,0,0,0,0
AftLevelup-CloudyLineRight,5270,607,255,67,535,790,121,188,9801,0,0,0,0
AftLevelup-Dots1,5271,607,46,32,502,548,988,1020,9802,0,0,0,0
AftLevelup-Dots2,5272,607,77,45,760,837,771,816,9803,0,0,0,0
AftLevelup-GlowLine,5273,607,322,18,612,934,679,697,9804,0,0,0,0
AftLevelup-IconFrame,5274,607,80,80,380,460,932,1012,9805,0,0,0,0
AftLevelup-IconGlow,5275,607,80,80,838,918,566,646,9806,0,0,0,0
AftLevelup-Lines1,5276,607,108,115,502,610,566,681,9807,0,0,0,0
AftLevelup-Lines2,5277,607,93,110,502,595,683,793,9808,0,0,0,0
AftLevelup-SoftCloud,5278,607,256,96,723,979,1,97,9809,0,0,0,0
AftLevelup-ToastBG,5279,607,275,77,1,276,121,198,9810,0,0,0,0
AftLevelup-FiligreeLeft,5280,607,138,34,832,970,699,733,9683,0,0,0,0
AftLevelup-FiligreeRight,5281,607,138,34,832,970,735,769,9684,0,0,0,0
transmog-nav-slot-secondaryhand,5282,610,35,37,453,488,48,85,9787,0,0,0,0
AftLevelup-WhiteIconGlow,5283,607,97,97,502,599,795,892,9685,0,0,0,0
AftLevelup-WhiteStarBurst,5284,607,133,133,1,134,200,333,9686,0,0,0,0
_transmog-preview-QuestPortrait-Divider_noname,5287,719,128,44,0,128,1,45,9737,0,0,4,0
_transmog-preview-QuestPortrait-StoneSwirls-Top,5288,719,128,18,0,128,47,65,9738,0,0,4,0
transmog-icon-downarrow,5289,610,15,9,169,184,352,361,9687,0,0,0,0
Forge-ColorSwatch,5291,720,55,55,1,56,921,976,9399,0,0,0,0
Forge-ColorSwatchBorder,5292,720,55,55,67,122,723,778,9377,0,0,0,0
Forge-ColorSwatchSelection,5293,720,55,55,67,122,780,835,9378,0,0,0,0
Forge-Lock,5294,720,55,55,67,122,837,892,9379,0,0,0,0
ForgeBorder-CornerBottomLeft,5295,720,64,64,1,65,723,787,9380,0,0,0,0
ForgeBorder-CornerBottomRight,5296,720,64,64,1,65,789,853,9381,0,0,0,0
ForgeBorder-CornerTopRight,5297,720,64,64,1,65,855,919,9382,0,0,0,0
Forge-Background,5298,720,460,615,1,461,1,616,9383,0,0,0,0
Artifacts-HeaderBG,5299,607,720,118,1,721,1,119,9811,0,0,0,0
Artifacts-Paladin-Header,5300,650,720,83,1,721,618,701,9812,0,0,0,0
Artifacts-DeathKnightFrost-Header,5301,677,720,125,1,721,618,743,9813,0,0,0,0
Artifacts-DemonHunter-Header,5302,649,896,126,1,897,618,744,9814,0,0,0,0
Artifacts-Druid-Header,5303,680,896,180,1,897,618,798,9815,0,0,0,0
search-iconframe-large,5304,565,38,38,387,425,30,68,9816,0,0,0,0
search-highlight-large,5305,565,256,47,1,257,30,77,9817,0,0,0,0
Artifacts-Hunter-Header,5306,710,720,65,1,721,618,683,9818,0,0,0,0
Artifacts-MageArcane-Header,5307,662,720,138,1,721,618,756,9819,0,0,0,0
Artifacts-Monk-Header,5308,712,896,145,1,897,618,763,9820,0,0,0,0
Artifacts-Priest-Header,5309,711,720,110,1,721,618,728,9821,0,0,0,0
Artifacts-Rogue-Header,5310,679,720,79,1,721,618,697,9822,0,0,0,0
Artifacts-Shaman-Header,5311,709,720,99,1,721,618,717,9554,0,0,0,0
Artifacts-Warlock-Header,5312,713,720,92,1,721,618,710,9555,0,0,0,0
Artifacts-Warrior-Header,5313,678,720,62,283,1003,618,680,9556,0,0,0,0
titleprestige-prestigeiconplate-alliance,5314,701,158,171,840,998,330,501,9746,0,0,0,0
titleprestige-prestigeiconplate-horde,5315,701,158,171,358,516,626,797,9747,0,0,0,0
Artifacts-PerkRing-WhiteGlow,5318,607,50,50,63,113,958,1008,9748,0,0,0,0
AdventureMapQuest-PortraitBG,5319,703,44,44,921,965,114,158,9749,0,0,0,0
Rune-01-dark,5320,721,75,77,1,76,1,78,9688,0,0,0,0
Rune-01-light,5321,721,75,77,1,76,80,157,9689,0,0,0,0
Rune-02-dark,5322,721,75,77,1,76,159,236,9690,0,0,0,0
Rune-02-light,5323,721,75,77,1,76,238,315,9691,0,0,0,0
Rune-03-dark,5324,721,75,77,1,76,317,394,9692,0,0,0,0
Rune-03-light,5325,721,75,77,1,76,396,473,9693,0,0,0,0
Rune-04-dark,5326,721,75,77,78,153,1,78,9694,0,0,0,0
Rune-04-light,5327,721,75,77,155,230,1,78,9695,0,0,0,0
Rune-05-dark,5328,721,75,77,232,307,1,78,9696,0,0,0,0
Rune-05-light,5329,721,75,77,309,384,1,78,9697,0,0,0,0
Rune-06-dark,5330,721,75,77,386,461,1,78,9750,0,0,0,0
Rune-06-light,5331,721,75,77,78,153,80,157,9751,0,0,0,0
Rune-07-dark,5332,721,75,77,78,153,159,236,9752,0,0,0,0
Rune-07-light,5333,721,75,77,78,153,238,315,9753,0,0,0,0
Rune-08-dark,5334,721,75,77,78,153,317,394,9754,0,0,0,0
Rune-08-light,5335,721,75,77,78,153,396,473,9755,0,0,0,0
Rune-09-dark,5336,721,75,77,155,230,80,157,9756,0,0,0,0
Rune-09-light,5337,721,75,77,232,307,80,157,9757,0,0,0,0
Rune-10-dark ,5338,721,75,77,309,384,80,157,9758,0,0,0,0
Rune-10-light,5339,721,75,77,386,461,80,157,9759,0,0,0,0
Rune-11-dark,5340,721,75,77,155,230,159,236,9760,0,0,0,0
Rune-11-light,5341,721,75,77,155,230,238,315,9761,0,0,0,0
Mage-ArcaneCharge-CircleGlow,5342,704,41,41,60,101,18,59,9557,0,0,0,0
Mage-ArcaneCharge-Rune,5343,704,46,45,1,47,75,120,9558,0,0,0,0
Mage-ArcaneCharge-SmallSpark,5344,704,38,39,103,141,18,57,9559,0,0,0,0
Mage-ArcaneCharge-Spark,5345,704,57,72,1,58,1,73,9560,0,0,0,0
Forge-AppearanceStrip,5346,720,460,103,1,461,618,721,9762,0,0,0,0
Forge-ColorSwatchBackground,5347,720,55,55,67,122,894,949,9763,0,0,0,0
Forge-ColorSwatchHighlight,5348,720,55,55,67,122,951,1006,9764,0,0,0,0
AdventureMap_TopBorder,5349,722,1002,668,1,1003,1,669,9561,0,0,0,0
AdventureMap_TileBg,5350,723,512,512,0,512,0,512,9562,0,0,6,0
Artifacts-PriestShadow-BG,5351,724,896,615,1,897,1,616,9563,0,0,0,0
Artifacts-PriestShadow-Header,5352,724,720,114,1,721,618,732,9564,0,0,0,0
bags-glow-artifact,5354,202,39,39,139,178,1,40,9765,0,0,0,0
AdventureMap-InsetMapBorder,5355,703,446,308,354,800,1,309,9766,0,0,0,0
Artifacts-Paladin-KnowledgeRank,5357,650,57,56,899,956,89,145,9565,0,0,0,0
ClassOverlay-HolyPower1off,5358,725,32,22,69,101,36,58,9566,0,0,0,0
ClassOverlay-HolyPower1on,5359,725,32,22,136,168,1,23,9567,0,0,0,0
ClassOverlay-HolyPower2off,5360,725,33,20,170,203,1,21,9568,0,0,0,0
ClassOverlay-HolyPower2on,5361,725,33,20,205,238,1,21,9569,0,0,0,0
ClassOverlay-HolyPower3off,5362,725,32,24,1,33,36,60,9570,0,0,0,0
ClassOverlay-HolyPower3on,5363,725,32,24,35,67,36,60,9571,0,0,0,0
ClassOverlay-HolyPower4off,5364,725,33,17,170,203,23,40,9572,0,0,0,0
ClassOverlay-HolyPower4on,5365,725,33,17,170,203,42,59,9573,0,0,0,0
ClassOverlay-HolyPower5off,5366,725,33,17,205,238,23,40,9574,0,0,0,0
ClassOverlay-HolyPower5on,5367,725,33,17,205,238,42,59,9575,0,0,0,0
ClassOverlay-HolyPowerBG,5368,725,133,33,1,134,1,34,9576,0,0,0,0
Artifacts-DeathKnightFrost-KnowledgeRank,5369,677,57,56,899,956,89,145,9577,0,0,0,0
Artifacts-DemonHunter-KnowledgeRank,5370,649,57,56,899,956,89,145,9578,0,0,0,0
Artifacts-Druid-KnowledgeRank,5371,680,57,56,899,956,89,145,9579,0,0,0,0
Artifacts-Hunter-KnowledgeRank,5372,710,57,56,899,956,89,145,9580,0,0,0,0
Artifacts-MageArcane-KnowledgeRank,5373,662,57,56,899,956,89,145,9581,0,0,0,0
Artifacts-Monk-KnowledgeRank,5374,712,57,56,899,956,89,145,9582,0,0,0,0
Artifacts-Priest-KnowledgeRank,5375,711,57,56,899,956,89,145,9583,0,0,0,0
Artifacts-PriestShadow-KnowledgeRank,5376,724,57,56,899,956,89,145,9584,0,0,0,0
Artifacts-Rogue-KnowledgeRank,5377,679,57,56,899,956,89,145,9585,0,0,0,0
Artifacts-Shaman-KnowledgeRank,5378,709,57,56,899,956,89,145,9586,0,0,0,0
Artifacts-Warlock-KnowledgeRank,5379,713,57,56,899,956,89,145,9592,0,0,0,0
Artifacts-Warrior-KnowledgeRank,5380,678,57,56,899,956,89,145,9593,0,0,0,0
ClassOverlay-Fury,5381,726,118,11,1,119,1,12,9594,0,0,0,0
ClassOverlay-FuryBG,5382,726,118,11,1,119,14,25,9596,0,0,0,0
ClassOverlay-Rune,5383,727,25,28,1,26,1,29,9597,0,0,0,0
ClassOverlay-RunicPower,5384,727,142,6,28,170,1,7,9598,0,0,0,0
ClassOverlay-RunicPowerBg,5385,727,142,6,28,170,9,15,9600,0,0,0,0
ClassOverlay-ComboPoint,5386,728,20,20,100,120,21,41,9601,0,0,0,0
LegionSplash-NewCharacter,5388,729,822,362,1,823,1,363,9273,0,0,0,0
LegionSplash-DemonHunterButton,5389,729,504,84,503,1007,365,449,9266,0,0,0,0
LegionSplash-Logo,5390,729,500,238,1,501,365,603,9274,0,0,0,0
LegionSplash-NewCharacterButton,5392,729,465,84,503,968,451,535,9275,0,0,0,0
LegionSplash-DemonHunter,5393,730,942,759,1,943,1,760,9276,0,0,0,0
legioninvasion-title-bg,5394,693,467,141,1,468,1,142,9277,0,0,0,0
transmog-nav-slot-enchant,5395,610,29,29,212,241,127,156,9767,0,0,0,0
transmog-nav-slot-selected-small,5396,610,34,35,376,410,88,123,9768,0,0,0,0
nameplates-bar-background,5397,731,254,13,1,255,1,14,9769,0,0,0,0
honorsystem-portrait-neutral,5398,698,50,52,53,103,391,443,9770,0,0,0,0
nameplates-holypower1-off,5399,731,25,19,40,65,45,64,9771,0,0,0,0
nameplates-holypower1-on,5400,731,25,19,40,65,66,85,9772,0,0,0,0
nameplates-holypower2-off,5401,731,26,17,67,93,45,62,9773,0,0,0,0
nameplates-holypower2-on,5402,731,26,17,67,93,64,81,9774,0,0,0,0
nameplates-holypower3-off,5403,731,24,17,40,64,87,104,9775,0,0,0,0
nameplates-holypower3-on,5404,731,24,17,40,64,106,123,9776,0,0,0,0
nameplates-holypower4-off,5405,731,25,14,67,92,83,97,9777,0,0,0,0
nameplates-holypower4-on,5406,731,25,14,67,92,99,113,9778,0,0,0,0
nameplates-playerhealth-background,5407,731,126,12,1,127,31,43,9779,0,0,0,0
nameplates-InterruptShield,5409,731,14,16,95,109,45,61,9823,0,0,0,0
nameplate-WarlockShard-Off,5411,732,17,17,1,18,26,43,9824,0,0,0,0
nameplate-WarlockShard-On,5412,732,17,17,1,18,45,62,9825,0,0,0,0
nameplate-WarlockShard-Glow,5413,732,26,23,1,27,1,24,9826,0,0,0,0
ClassOverlay-ComboPoint-Off,5414,728,20,20,100,120,43,63,9827,0,0,0,0
Insanity-DrippyPurple1,5415,705,49,33,196,245,51,84,9828,0,0,0,0
Insanity-DrippyPurple2,5416,705,49,29,132,181,175,204,9829,0,0,0,0
Insanity-PortraitOverlay,5417,705,193,77,1,194,13,90,9830,0,0,0,0
Insanity-PurpleBurstOn,5418,705,174,27,1,175,146,173,9831,0,0,0,0
Insanity-ShadowBurstOn,5419,705,139,34,107,246,92,126,9832,0,0,0,0
Insanity-Tentacles,5420,705,129,30,1,130,175,205,9833,0,0,0,0
Insanity-TopPurpleShadow,5421,705,104,52,1,105,92,144,9834,0,0,0,0
options-notch,5422,733,1,6,1,2,1,7,9835,0,0,0,0
Insanity-Spark,5423,705,9,41,1,10,207,248,9836,0,0,0,0
tradeskills-star-off,5424,734,20,19,23,43,434,453,9837,0,0,0,0
tradeskills-star,5425,734,20,19,1,21,434,453,9838,0,0,0,0
tradeskill-background-recipe,5426,734,300,383,1,301,1,384,9839,0,0,0,0
tradeskill-background-recipe-unlearned,5427,734,300,383,303,603,1,384,9840,0,0,0,0
loottoast-itemborder-heirloom,5429,332,58,58,689,747,181,239,9842,0,0,0,0
ComboPoints-AllPointsBG,5430,728,126,18,1,127,1,19,9843,0,0,0,0
ComboPoints-PointBg,5431,728,20,21,78,98,21,42,9841,0,0,0,0
ComboPoints-ComboPointDash,5432,728,9,10,29,38,48,58,9844,0,0,0,0
ComboPoints-ComboPointDash-Bg,5433,728,9,10,40,49,48,58,9845,0,0,0,0
ComboPoints-ComboPoint,5434,728,20,21,56,76,21,42,9846,0,0,0,0
ComboPoints-FX-Circle,5435,728,26,27,1,27,21,48,9847,0,0,0,0
ComboPoints-FX-Dash,5436,728,25,8,1,26,50,58,9848,0,0,0,0
ComboPoints-FX-Star,5437,728,25,25,29,54,21,46,9849,0,0,0,0
obliterumforge-background,5438,735,322,160,1,323,1,161,9850,0,0,0,0
obliterumforge-slotted-corners-glow,5439,735,132,60,325,457,1,61,9851,0,0,0,0
obliterumforge-slotted-corners,5440,735,132,60,325,457,63,123,9852,0,0,0,0
ChallengeMode-AffixRing-Lg,5442,736,52,52,934,986,55,107,9853,0,0,0,0
ChallengeMode-AffixRing-Sm,5443,736,34,34,988,1022,1,35,9854,0,0,0,0
ChallengeMode-DungeonIconFrame,5444,736,52,52,934,986,1,53,9855,0,0,0,0
ChallengeMode-KeystoneFrame,5445,736,398,548,137,535,400,948,9856,0,0,0,0
ChallengeMode-KeystoneSlotBG,5446,736,114,114,1,115,779,893,9857,0,0,0,0
ChallengeMode-KeystoneSlotFrame,5447,736,120,120,1,121,657,777,9858,0,0,0,0
ChallengeMode-KeystoneSlotFrameGlow,5448,736,120,120,1,121,535,655,9859,0,0,0,0
ChallengeMode-MainTabBg,5449,736,548,397,1,549,1,398,9860,0,0,0,0
ChallengeMode-ThinDivider,5453,736,365,3,551,916,384,387,9863,0,0,0,0
_DemonHunter-DemonicPainBar,5458,690,128,10,0,128,13,23,9977,0,0,4,0
GlyphIcon-Spellbook,5494,741,21,22,1,22,1,23,9941,0,0,0,0
ChallengeMode-Runes-GlowLarge,5495,736,392,391,537,929,630,1021,9929,0,0,0,0
ChallengeMode-Runes-Large,5496,736,381,381,551,932,1,382,9930,0,0,0,0
ChallengeMode-Runes-LineGlow,5497,736,242,228,537,779,400,628,9931,0,0,0,0
BossBanner-PortraitBorder,5498,569,61,61,1,62,436,497,9932,0,0,0,0
ChallengeMode-SoftYellowGlow,5499,569,206,206,1,207,1,207,9933,0,0,0,0
ChallengeMode-SpikeyStar,5500,569,200,200,1,201,209,409,9934,0,0,0,0
ChallengeMode-Timer,5501,569,261,87,621,882,113,200,9935,0,0,0,0
ChallengeMode-TimerBG,5502,569,223,11,649,872,81,92,9936,0,0,0,0
ChallengeMode-TimerFill,5503,569,223,11,621,844,202,213,9937,0,0,0,0
ChallengeMode-WhiteSpikeyGlow,5504,569,186,209,209,395,1,210,9938,0,0,0,0
ChallengeMode-Runes-BackgroundCoverGlow,5505,737,276,275,713,989,304,579,9939,0,0,0,0
ChallengeMode-Runes-GlowBurstLarge,5506,737,234,234,514,748,713,947,9913,0,0,0,0
ChallengeMode-Runes-GlowSmall,5507,737,261,260,1,262,713,973,9914,0,0,0,0
ChallengeMode-RuneBG,5508,737,710,710,1,711,1,711,9915,0,0,0,0
ChallengeMode-Runes-BackgroundBurst,5509,737,300,301,713,1013,1,302,9916,0,0,0,0
ChallengeMode-Runes-BL-Glow,5510,737,78,78,811,889,581,659,9917,0,0,0,0
ChallengeMode-Runes-BR-Glow,5511,737,78,78,891,969,581,659,9918,0,0,0,0
ChallengeMode-Runes-InnerCircleGlow,5512,737,211,209,750,961,713,922,9919,0,0,0,0
ChallengeMode-Runes-L-Glow,5513,737,78,78,750,828,924,1002,9920,0,0,0,0
ChallengeMode-Runes-R-Glow,5514,737,78,78,830,908,924,1002,9921,0,0,0,0
ChallengeMode-Runes-Small,5515,737,248,248,264,512,713,961,9922,0,0,0,0
ChallengeMode-Runes-T-Glow,5516,737,78,78,910,988,924,1002,9923,0,0,0,0
ChallengeMode-Runes-CircleGlow,5517,737,96,96,713,809,581,677,9924,0,0,0,0
recipetoast-bg,5518,742,312,89,1,313,1,90,9968,0,0,0,0
recipetoast-icon-star,5519,742,20,19,1,21,92,111,9969,0,0,0,0
transmog-wardrobe-border-unusable,5520,610,96,122,1,97,379,501,9906,0,0,0,0
worldquest-icon-clock,5521,743,22,22,384,406,92,114,9942,0,0,0,0
worldquest-questmarker-dragon-glow,5524,743,49,48,1,50,74,122,9943,0,0,0,0
worldquest-questmarker-dragon,5525,743,34,34,319,353,89,123,9944,0,0,0,0
worldquest-questmarker-epic-down,5526,743,20,20,438,458,1,21,9945,0,0,0,0
worldquest-questmarker-epic,5527,743,20,20,416,436,1,21,9946,0,0,0,0
worldquest-questmarker-glow,5528,743,36,36,281,317,89,125,9947,0,0,0,0
worldquest-questmarker-questbang,5530,743,8,17,432,440,86,103,9948,0,0,0,0
worldquest-tracker-checkmark,5531,743,40,35,226,266,74,109,9949,0,0,0,0
worldquest-tracker-questmarker-gray,5532,743,25,25,384,409,65,90,9950,0,0,0,0
worldquest-tracker-questmarker,5533,743,25,25,355,380,89,114,9951,0,0,0,0
worldquest-tracker,5534,743,278,71,1,279,1,72,9952,0,0,0,0
ChallengeMode-Runes-SmallCircleGlow,5535,736,134,133,1,135,400,533,9907,0,0,0,0
worldquest-questmarker-questionmark,5537,743,13,17,452,465,23,40,9970,0,0,0,0
ChallengeMode-Runes-Shockwave,5538,736,206,209,781,987,400,609,9908,0,0,0,0
ChallengeMode-Chest,5540,569,175,130,209,384,212,342,9862,0,0,0,0
worldquest-icon-pvp-ffa,5558,743,14,14,416,430,42,56,9975,0,0,0,0
worldquest-tracker-ring-selected,5559,743,44,44,98,142,74,118,9976,0,0,0,0
worldquest-tracker-ring,5560,743,44,44,52,96,74,118,9978,0,0,0,0
ChallengeMode-icon-chest,5561,569,19,20,187,206,411,431,9864,0,0,0,0
ChallengeMode-icon-redline,5562,569,19,19,64,83,436,455,9865,0,0,0,0
ChallengeMode-TimerBG-back,5563,569,223,11,649,872,94,105,9866,0,0,0,0
LegionMissionIcon-ZoneSupportAlliance-Map,5564,745,64,64,1,65,1,65,9867,0,0,0,0
orderhalltalents-background-mage,5569,746,322,382,1,323,1,383,9872,0,0,0,0
orderhalltalents-background-deathknight,5577,747,322,382,1,323,1,383,9878,0,0,0,0
orderhalltalents-background-demonhunter,5578,748,322,382,1,323,1,383,9879,0,0,0,0
orderhalltalents-background-druid,5579,749,322,382,1,323,1,383,9868,0,0,0,0
orderhalltalents-background-hunter,5580,750,322,382,1,323,1,383,9869,0,0,0,0
orderhalltalents-background-monk,5581,751,322,382,1,323,1,383,9870,0,0,0,0
orderhalltalents-background-paladin,5582,752,322,382,1,323,1,383,9871,0,0,0,0
orderhalltalents-background-priest,5583,753,322,382,1,323,1,383,9873,0,0,0,0
orderhalltalents-background-rogue,5584,754,322,382,1,323,1,383,9874,0,0,0,0
orderhalltalents-background-shaman,5585,755,322,382,1,323,1,383,9875,0,0,0,0
orderhalltalents-background-warlock,5586,756,322,382,1,323,1,383,9876,0,0,0,0
orderhalltalents-background-warrior,5587,757,322,382,1,323,1,383,9877,0,0,0,0
orderhalltalents-choice-background,5590,758,163,59,149,312,1,60,9971,0,0,0,0
orderhalltalents-spellborder-green,5591,758,50,50,67,117,201,251,9972,0,0,0,0
orderhalltalents-spellborder-yellow,5592,758,50,50,149,199,62,112,9973,0,0,0,0
orderhalltalents-spellborder,5593,758,50,50,67,117,149,199,9974,0,0,0,0
LegionMissionIcon-ZoneSupportAlliance-MapBadge,5594,745,34,34,199,233,1,35,9881,0,0,0,0
LegionMissionIcon-ZoneSupportHorde-Map,5595,745,64,64,133,197,1,65,9882,0,0,0,0
LegionMissionIcon-ZoneSupportHorde-MapBadge,5596,745,34,34,1,35,133,167,9883,0,0,0,0
LegionMissionIcon-ZoneSupportAlliance-Mission,5597,745,64,64,67,131,1,65,9884,0,0,0,0
LegionMissionIcon-ZoneSupportHorde-Mission,5598,745,64,64,1,65,67,131,9885,0,0,0,0
orderhalltalents-timer-bg,5599,758,64,64,1,65,149,213,9953,0,0,0,0
legionmission-map-orderhall-deathknight,5601,759,99,66,1,100,1,67,9954,0,0,0,0
legionmission-map-orderhall-demonhunter,5602,759,99,66,1,100,137,203,9955,0,0,0,0
legionmission-map-orderhall-druid,5603,759,99,66,1,100,69,135,9956,0,0,0,0
legionmission-map-orderhall-glow,5604,759,142,109,203,345,69,178,9957,0,0,0,0
legionmission-map-orderhall-hunter,5605,759,99,66,102,201,1,67,9958,0,0,0,0
legionmission-map-orderhall-mage,5606,759,99,66,102,201,69,135,9959,0,0,0,0
legionmission-map-orderhall-monk,5607,759,99,66,102,201,137,203,9960,0,0,0,0
legionmission-map-orderhall-paladin,5608,759,99,66,203,302,1,67,9961,0,0,0,0
legionmission-map-orderhall-priest,5609,759,99,66,304,403,1,67,9962,0,0,0,0
legionmission-map-orderhall-rogue,5610,759,99,66,405,504,1,67,9963,0,0,0,0
legionmission-map-orderhall-shaman,5611,759,99,66,347,446,69,135,9964,0,0,0,0
legionmission-map-orderhall-warlock,5612,759,99,66,347,446,137,203,9965,0,0,0,0
legionmission-map-orderhall-warrior,5613,759,99,66,203,302,180,246,9966,0,0,0,0
legionmission-map-orderhall-textglow,5614,759,122,22,347,469,205,227,9967,0,0,0,0
worldquest-icon-alchemy,5615,743,12,14,499,511,23,37,9886,0,0,0,0
worldquest-icon-archaeology,5616,743,14,14,483,497,23,37,9887,0,0,0,0
worldquest-icon-blacksmithing,5617,743,14,15,264,278,111,126,9888,0,0,0,0
worldquest-icon-cooking,5618,743,11,15,268,279,74,89,9889,0,0,0,0
worldquest-icon-enchanting,5619,743,12,13,416,428,103,116,9890,0,0,0,0
worldquest-icon-engineering,5620,743,14,15,467,481,23,38,9891,0,0,0,0
worldquest-icon-firstaid,5621,743,10,10,371,381,116,126,9892,0,0,0,0
worldquest-icon-fishing,5622,743,13,13,416,429,73,86,9893,0,0,0,0
worldquest-icon-herbalism,5623,743,13,13,416,429,88,101,9894,0,0,0,0
worldquest-icon-inscription,5624,743,11,14,268,279,91,105,9895,0,0,0,0
worldquest-icon-jewelcrafting,5625,743,14,11,355,369,116,127,9896,0,0,0,0
worldquest-icon-leatherworking,5626,743,13,12,432,445,42,54,9897,0,0,0,0
worldquest-icon-mining,5627,743,12,13,432,444,56,69,9898,0,0,0,0
worldquest-icon-skinning,5628,743,14,13,416,430,58,71,9899,0,0,0,0
worldquest-icon-tailoring,5629,743,12,13,432,444,71,84,9900,0,0,0,0
worldquest-icon-petbattle,5637,743,13,11,384,397,116,127,9909,0,0,0,0
DemonInvasion5,5639,647,32,32,66,98,304,336,9910,0,0,0,0
book-bg,5640,761,486,494,1,487,1,495,9911,0,0,0,0
book-line,5641,761,411,8,1,412,497,505,9912,0,0,0,0
_orderhall-commandbar-bg,5642,762,128,25,0,128,1,26,9901,0,0,4,0
worldquest-icon-boss,5643,743,11,12,447,458,42,54,9902,0,0,0,0
transmog-icon-hidden,5647,610,36,30,412,448,88,118,9903,0,0,0,0
orderhalltalents-choice-arrow-large,5648,758,47,27,149,196,114,141,9904,0,0,0,0
orderhalltalents-choice-background-on,5650,758,163,59,314,477,1,60,9905,0,0,0,0
LegendaryToast-particles3,5651,764,84,163,203,287,294,457,9925,0,0,0,0
LegendaryToast-particles2,5652,764,78,147,329,407,122,269,9926,0,0,0,0
LegendaryToast-background,5655,764,302,119,203,505,1,120,9927,0,0,0,0
LegendaryToast-ring1,5656,764,131,176,1,132,205,381,9928,0,0,0,0
LegendaryToast-particles1,5657,764,124,170,203,327,122,292,9940,0,0,0,0
tradeskills-iconborder,5662,734,46,46,1,47,386,432,10086,0,0,0,0
LegendaryToast-OrangeStarglow,5663,764,200,202,1,201,1,203,10122,0,0,0,0
loottoast-itemborder-artifact,5667,332,58,58,917,975,99,157,10014,0,0,0,0
adventureguide-icon-whatsnew,5668,609,37,37,347,384,51,88,10015,0,0,0,0
adventureguide-microbutton-alert,5669,768,28,28,1,29,1,29,10016,0,0,0,0
transmog-frame-blackcover,5670,610,46,45,191,237,1,46,10123,0,0,0,0
transmog-frame-highlighted,5839,610,44,41,331,375,1,42,10124,0,0,0,0
transmog-background-race-bloodelf,5840,770,294,494,1,295,1,495,10125,0,0,0,0
transmog-background-race-human,5841,771,294,494,1,295,1,495,10126,0,0,0,0
transmog-background-race-draenei,5842,772,294,494,1,295,1,495,10127,0,0,0,0
transmog-background-race-dwarf,5843,773,294,494,1,295,1,495,10128,0,0,0,0
transmog-background-race-gnome,5844,774,294,494,1,295,1,495,10129,0,0,0,0
transmog-background-race-goblin,5845,775,294,494,1,295,1,495,10130,0,0,0,0
transmog-background-race-nightelf,5846,776,294,494,1,295,1,495,10131,0,0,0,0
transmog-background-race-orc,5847,777,294,494,1,295,1,495,10132,0,0,0,0
transmog-background-race-pandaren,5848,778,294,494,1,295,1,495,10133,0,0,0,0
transmog-background-race-tauren,5849,779,294,494,1,295,1,495,10134,0,0,0,0
transmog-background-race-troll,5850,780,294,494,1,295,1,495,10135,0,0,0,0
transmog-background-race-undead,5851,781,294,494,1,295,1,495,10136,0,0,0,0
transmog-background-race-worgen,5852,782,294,494,1,295,1,495,10137,0,0,0,0
AdventureMap-combatally-clouds,5853,703,117,95,802,919,74,169,10138,0,0,0,0
AdventureMap-combatally-empty,5854,703,46,46,288,334,923,969,10139,0,0,0,0
AdventureMap-combatally-ring,5855,703,58,58,288,346,814,872,10140,0,0,0,0
AdventureMap-textlabelglow,5856,703,122,22,1,123,1001,1023,10141,0,0,0,0
legionmission-EncounterAbilityBorder-Lg,5857,783,61,61,1,62,158,219,10142,0,0,0,0
legionmission-EncounterAbilityBorder,5858,783,35,35,212,247,1,36,10143,0,0,0,0
worldquest-followerabilityframe,5859,743,101,86,281,382,1,87,9979,0,0,0,0
worldquest-questmarker-abilityhighlight,5860,743,42,42,144,186,74,116,9980,0,0,0,0
transmog-frame-highlighted-small,5863,610,24,24,165,189,401,425,9981,0,0,0,0
nameplates-bar-background-white,5864,731,254,13,1,255,16,29,10017,0,0,0,0
_honorsystem-bar-fill-rested,5865,697,256,17,0,256,20,37,10018,0,0,4,0
honorsystem-bar-frame-exhaustiontick-highlight,5866,696,17,35,1000,1017,118,153,10019,0,0,0,0
honorsystem-bar-frame-exhaustiontick,5867,696,17,35,981,998,118,153,10020,0,0,0,0
legionmission-complete-background-deathknight,5869,785,690,333,1,691,1,334,10144,0,0,0,0
legionmission-complete-background-demonhunter,5870,786,690,333,1,691,1,334,10145,0,0,0,0
legionmission-complete-background-druid,5871,787,690,333,1,691,1,334,10146,0,0,0,0
legionmission-complete-background-hunter,5872,788,690,333,1,691,1,334,10147,0,0,0,0
legionmission-complete-background-mage,5873,789,690,333,1,691,1,334,10148,0,0,0,0
legionmission-complete-background-monk,5874,790,690,333,1,691,1,334,10149,0,0,0,0
legionmission-complete-background-paladin,5875,791,690,333,1,691,1,334,10150,0,0,0,0
legionmission-complete-background-priest,5876,792,690,333,1,691,1,334,10151,0,0,0,0
legionmission-complete-background-rogue,5877,793,690,333,1,691,1,334,10152,0,0,0,0
legionmission-complete-background-shaman,5878,794,690,333,1,691,1,334,10153,0,0,0,0
legionmission-complete-background-warlock,5879,795,690,333,1,691,1,334,10154,0,0,0,0
legionmission-complete-background-warrior,5880,796,690,333,1,691,1,334,10155,0,0,0,0
legionmission-landingpage-background-deathknight,5881,797,229,184,1,230,1,185,10021,0,0,0,0
legionmission-landingpage-background-demonhunter,5882,798,230,236,1,231,1,237,10022,0,0,0,0
legionmission-landingpage-background-druid,5883,799,230,219,1,231,1,220,10023,0,0,0,0
legionmission-landingpage-background-hunter,5884,800,225,228,1,226,1,229,10024,0,0,0,0
legionmission-landingpage-background-mage,5885,801,230,203,1,231,1,204,10025,0,0,0,0
legionmission-landingpage-background-monk,5886,802,221,249,1,222,1,250,10026,0,0,0,0
legionmission-landingpage-background-paladin,5887,803,200,250,1,201,1,251,10027,0,0,0,0
legionmission-landingpage-background-priest,5888,804,230,190,1,231,1,191,10028,0,0,0,0
legionmission-landingpage-background-rogue,5889,805,231,211,1,232,1,212,10029,0,0,0,0
legionmission-landingpage-background-shaman,5890,806,209,250,1,210,1,251,10030,0,0,0,0
legionmission-landingpage-background-warlock,5891,807,230,184,1,231,1,185,10031,0,0,0,0
legionmission-landingpage-background-warrior,5892,808,181,253,1,182,1,254,10032,0,0,0,0
legionmission-landingbutton-deathknight-down,5893,809,53,53,1,54,1,54,10087,0,0,0,0
legionmission-landingbutton-deathknight-up,5894,809,53,53,56,109,1,54,10088,0,0,0,0
legionmission-landingbutton-demonhunter-down,5895,810,53,53,1,54,1,54,10089,0,0,0,0
legionmission-landingbutton-demonhunter-up,5896,810,53,53,56,109,1,54,10090,0,0,0,0
legionmission-landingbutton-druid-down,5897,811,53,53,1,54,1,54,10091,0,0,0,0
legionmission-landingbutton-druid-up,5898,811,53,53,56,109,1,54,10092,0,0,0,0
legionmission-landingbutton-hunter-down,5899,812,53,53,1,54,1,54,10093,0,0,0,0
legionmission-landingbutton-hunter-up,5900,812,53,53,56,109,1,54,10094,0,0,0,0
legionmission-landingbutton-mage-down,5901,813,53,53,1,54,1,54,10095,0,0,0,0
legionmission-landingbutton-mage-up,5902,813,53,53,56,109,1,54,10096,0,0,0,0
legionmission-landingbutton-monk-down,5903,814,53,53,1,54,1,54,10097,0,0,0,0
legionmission-landingbutton-monk-up,5904,814,53,53,56,109,1,54,10098,0,0,0,0
legionmission-landingbutton-paladin-down,5905,815,53,53,1,54,1,54,10099,0,0,0,0
legionmission-landingbutton-paladin-up,5906,815,53,53,56,109,1,54,10100,0,0,0,0
legionmission-landingbutton-priest-down,5907,816,53,53,1,54,1,54,10101,0,0,0,0
legionmission-landingbutton-priest-up,5908,816,53,53,56,109,1,54,10102,0,0,0,0
legionmission-landingbutton-rogue-down,5909,817,53,53,1,54,1,54,10103,0,0,0,0
legionmission-landingbutton-rogue-up,5910,817,53,53,56,109,1,54,10104,0,0,0,0
legionmission-landingbutton-shaman-down,5911,818,53,53,1,54,1,54,10105,0,0,0,0
legionmission-landingbutton-shaman-up,5912,818,53,53,56,109,1,54,10106,0,0,0,0
legionmission-landingbutton-warlock-down,5913,819,53,53,1,54,1,54,10107,0,0,0,0
legionmission-landingbutton-warlock-up,5914,819,53,53,56,109,1,54,10108,0,0,0,0
legionmission-landingbutton-warrior-down,5915,820,53,53,1,54,1,54,10109,0,0,0,0
legionmission-landingbutton-warrior-up,5916,820,53,53,56,109,1,54,10110,0,0,0,0
transmog-wardrobe-border-current,5917,610,84,110,105,189,1,111,10111,0,0,0,0
transmog-wardrobe-border-selected-wisp,5918,610,28,19,327,355,127,146,10112,0,0,0,0
transmog-wardrobe-border-current-transmogged,5919,610,84,110,105,189,113,223,10113,0,0,0,0
glueannouncementpopup-arrow,5920,821,64,47,803,867,1,48,10114,0,0,0,0
glueannouncementpopup-background,5921,821,800,533,1,801,1,534,10115,0,0,0,0
glueannouncementpopup-icon-info,5922,821,21,21,869,890,1,22,10116,0,0,0,0
glueannouncementpopup-inset,5923,821,361,86,1,362,536,622,10117,0,0,0,0
loottab-set-itemborder-green,5925,822,41,41,44,85,1,42,10049,0,0,0,0
loottab-set-itemborder-purple,5926,822,41,41,1,42,1,42,10050,0,0,0,0
loottab-set-itemborder-blue,5929,822,41,41,87,128,1,42,10051,0,0,0,0
poi-alliance,5930,647,32,32,236,268,440,472,10118,0,0,0,0
poi-horde,5931,647,32,32,236,268,474,506,10119,0,0,0,0
GarrisonTroops-Health-Consume,5932,783,15,13,229,244,38,51,10120,0,0,0,0
GarrisonTroops-Health,5933,783,15,13,212,227,38,51,10121,0,0,0,0
BonusChest-BonusTextGlow,5935,308,311,61,159,470,1,62,10156,0,0,0,0
GarrMission_ClassIcon-DeathKnight-Blood,5936,823,55,49,172,227,154,203,9982,0,0,0,0
GarrMission_ClassIcon-DeathKnight-Frost,5937,823,55,49,343,398,1,50,9983,0,0,0,0
GarrMission_ClassIcon-DeathKnight-Unholy,5938,823,55,49,115,170,103,152,9984,0,0,0,0
GarrMission_ClassIcon-DemonHunter-Havoc,5939,823,55,49,58,113,205,254,9985,0,0,0,0
GarrMission_ClassIcon-DemonHunter-Vengeance,5940,823,55,49,58,113,256,305,9986,0,0,0,0
GarrMission_ClassIcon-Druid-Balance,5941,823,55,49,286,341,52,101,9987,0,0,0,0
GarrMission_ClassIcon-Druid-Feral,5942,823,55,49,1,56,358,407,9988,0,0,0,0
GarrMission_ClassIcon-Druid-Guardian,5943,823,55,49,229,284,103,152,9989,0,0,0,0
GarrMission_ClassIcon-Druid-Restoration,5944,823,55,49,400,455,103,152,9990,0,0,0,0
GarrMission_ClassIcon-Hunter-BeastMastery,5945,823,55,49,115,170,1,50,9991,0,0,0,0
GarrMission_ClassIcon-Hunter-Marksmanship,5946,823,55,49,400,455,1,50,9992,0,0,0,0
GarrMission_ClassIcon-Hunter-Survival,5947,823,55,49,343,398,52,101,9993,0,0,0,0
GarrMission_ClassIcon-Mage-Arcane,5948,823,55,49,1,56,205,254,9994,0,0,0,0
GarrMission_ClassIcon-Mage-Fire,5949,823,55,49,286,341,1,50,9995,0,0,0,0
GarrMission_ClassIcon-Mage-Frost,5950,823,55,49,1,56,307,356,9996,0,0,0,0
GarrMission_ClassIcon-Monk-Brewmaster,5951,823,55,49,115,170,154,203,9997,0,0,0,0
GarrMission_ClassIcon-Monk-Mistweaver,5952,823,55,49,229,284,1,50,9998,0,0,0,0
GarrMission_ClassIcon-Monk-Windwalker,5953,823,55,49,343,398,103,152,9999,0,0,0,0
GarrMission_ClassIcon-Paladin-Holy,5954,823,55,49,172,227,103,152,10000,0,0,0,0
GarrMission_ClassIcon-Paladin-Protection,5955,823,55,49,58,113,307,356,10001,0,0,0,0
GarrMission_ClassIcon-Paladin-Retribution,5956,823,55,49,58,113,1,50,10002,0,0,0,0
GarrMission_ClassIcon-Priest-Discipline,5957,823,55,49,58,113,154,203,10003,0,0,0,0
GarrMission_ClassIcon-Priest-Holy,5958,823,55,49,58,113,409,458,10004,0,0,0,0
GarrMission_ClassIcon-Priest-Shadow,5959,823,55,49,115,170,52,101,10005,0,0,0,0
GarrMission_ClassIcon-Rogue-Assassination,5960,823,55,49,229,284,154,203,10006,0,0,0,0
GarrMission_ClassIcon-Rogue-Outlaw,5961,823,55,49,1,56,52,101,10007,0,0,0,0
GarrMission_ClassIcon-Rogue-Subtlety,5962,823,55,49,172,227,52,101,10008,0,0,0,0
GarrMission_ClassIcon-Shaman-Elemental,5963,823,55,49,286,341,103,152,10009,0,0,0,0
GarrMission_ClassIcon-Shaman-Enhancement,5964,823,55,49,1,56,409,458,10010,0,0,0,0
GarrMission_ClassIcon-Shaman-Restoration,5965,823,55,49,1,56,154,203,10011,0,0,0,0
GarrMission_ClassIcon-Warlock-Affliction,5966,823,55,49,172,227,1,50,10012,0,0,0,0
GarrMission_ClassIcon-Warlock-Demonology,5967,823,55,49,229,284,52,101,10013,0,0,0,0
GarrMission_ClassIcon-Warlock-Destruction,5968,823,55,49,58,113,358,407,10033,0,0,0,0
GarrMission_ClassIcon-Warrior-Arms,5969,823,55,49,58,113,460,509,10157,0,0,0,0
GarrMission_ClassIcon-Warrior-Fury,5970,823,55,49,400,455,52,101,10158,0,0,0,0
GarrMission_ClassIcon-Warrior-Protection,5971,823,55,49,1,56,256,305,10034,0,0,0,0
legionmission-background-combatally,5973,825,918,619,1,919,1,620,10036,0,0,0,0
_GarrMissionLocation-Legion-Mid,5976,828,1024,285,0,1024,1,286,10039,0,0,4,0
_GarrMissionLocation-Highmountain-Mid,5977,827,1024,285,0,1024,1,286,10040,0,0,4,0
_GarrMissionLocation-Dalaran-Mid,5978,826,1024,285,0,1024,1,286,10038,0,0,4,0
_GarrMissionLocation-Azsuna-Mid,5979,824,1024,285,0,1024,1,286,10041,0,0,4,0
_GarrMissionLocation-Stormheim-Mid,5980,829,1024,285,0,1024,1,286,10042,0,0,4,0
_GarrMissionLocation-Suramar-Mid,5981,830,1024,285,0,1024,1,286,10035,0,0,4,0
_GarrMissionLocation-Valsharah-Mid,5982,831,1024,285,0,1024,1,286,10037,0,0,4,0
legionmission-hearts-background,5983,783,119,44,134,253,158,202,10043,0,0,0,0
GarrMissionLocation-Azsuna-List,5984,832,792,78,1,793,1,79,10044,0,0,0,0
GarrMissionLocation-Dalaran-List,5985,832,792,78,1,793,81,159,10045,0,0,0,0
GarrMissionLocation-Highmountain-List,5986,832,792,78,1,793,161,239,10046,0,0,0,0
GarrMissionLocation-Legion-List,5987,832,792,78,1,793,241,319,10047,0,0,0,0
GarrMissionLocation-Stormheim-List,5988,832,792,78,1,793,321,399,10048,0,0,0,0
GarrMissionLocation-Suramar-List,5989,832,792,78,1,793,401,479,10052,0,0,0,0
GarrMissionLocation-Valsharah-List,5990,832,792,78,1,793,481,559,10053,0,0,0,0
poi-workorders,5991,647,32,32,338,370,270,302,10054,0,0,0,0
orderhall-commandbar-iconmask,5994,762,57,23,1,58,28,51,10057,0,0,0,0
GarrMission-NeutralChest,5995,783,209,155,1,210,1,156,10058,0,0,0,0
worldquest-tracker-lock,5996,743,36,47,188,224,74,121,10059,0,0,0,0
ClassTrial-End-Frame,5997,833,563,345,1,564,1,346,10060,0,0,0,0
ClassTrial-Hunter-Ring,5998,833,188,188,1,189,348,536,10061,0,0,0,0
ClassTrial-Priest-Ring,5999,833,188,188,191,379,538,726,10062,0,0,0,0
ClassTrial-DeathKnight-Ring,6000,833,188,188,566,754,1,189,10063,0,0,0,0
ClassTrial-Warrior-Ring,6001,833,188,188,571,759,348,536,10064,0,0,0,0
ClassTrial-Paladin-Ring,6002,833,188,188,191,379,348,536,10065,0,0,0,0
ClassTrial-Warlock-Ring,6003,833,188,188,381,569,348,536,10066,0,0,0,0
ClassTrial-Druid-Ring,6004,833,188,188,756,944,1,189,10067,0,0,0,0
ClassTrial-Monk-Ring,6005,833,188,188,1,189,728,916,10068,0,0,0,0
ClassTrial-Mage-Ring,6006,833,188,188,1,189,538,726,10069,0,0,0,0
ClassTrial-Rogue-Ring,6007,833,188,188,191,379,728,916,10070,0,0,0,0
Legion-boostpopup-exit-frame,6008,706,25,24,433,458,1,25,10071,0,0,0,0
transmog-wardrobe-border-selected-smoke,6009,610,19,65,191,210,127,192,10072,0,0,0,0
legionmission-icon-currency,6010,783,44,41,134,178,204,245,10073,0,0,0,0
UI-CharacterCreate-MetalFrame-Horizontal,6011,834,256,16,0,256,1,17,10074,0,0,4,0
UI-CharacterCreate-MetalFrame-Vertical,6012,835,16,256,1,17,0,256,10075,0,0,2,0
ClassTrial-Timer-Mid,6013,836,17,81,0,17,1,82,10076,0,0,4,0
ClassTrial-Timer-RightCorner,6014,836,25,81,282,307,84,165,10077,0,0,0,0
ClassTrial-Timer,6015,836,279,81,1,280,84,165,10078,0,0,0,0
UI-CharacterCreate-LargeButton-Blue-Highlight,6016,837,108,37,1,109,1,38,10079,0,0,0,0
UI-CharacterCreate-LargeButton-Yellow-Highlight,6017,837,108,37,1,109,40,77,10080,0,0,0,0
UI-CharacterCreate-LargeButton,6018,837,108,41,1,109,79,120,10081,0,0,0,0
UI-CharacterCreate-Metal-Finery-Corner,6019,837,56,49,111,167,40,89,10082,0,0,0,0
UI-CharacterCreate-Metal-Small-Finery,6020,837,35,32,111,146,1,33,10083,0,0,0,0
UI-CharacterCreate-PadLock,6021,837,63,76,169,232,40,116,10084,0,0,0,0
UI-Character-Info-Paladin-BG,6022,838,197,355,200,397,1,356,10085,0,0,0,0
UI-Character-Info-Priest-BG,6024,838,197,355,200,397,358,713,10166,0,0,0,0
UI-Character-Info-Warlock-BG,6025,838,197,355,598,795,1,356,10167,0,0,0,0
UI-Character-Info-Line-Bounce,6028,838,157,19,1,158,788,807,10170,0,0,0,0
UI-Character-Info-Shaman-BG,6029,838,197,355,399,596,358,713,10171,0,0,0,0
UI-Character-Info-ItemLevel-Bounce,6030,838,162,29,1,163,757,786,10172,0,0,0,0
UI-Character-Info-Warrior-BG,6032,838,197,355,797,994,1,356,10173,0,0,0,0
UI-Character-Info-Title,6033,838,196,40,1,197,715,755,10174,0,0,0,0
UI-Character-Info-Mage-BG,6034,838,197,355,1,198,1,356,10175,0,0,0,0
UI-Character-Info-Rogue-BG,6035,838,197,355,399,596,1,356,10176,0,0,0,0
UI-Character-Info-Monk-BG,6036,838,197,355,1,198,358,713,10177,0,0,0,0
UI-Character-Info-DeathKnight-BG,6037,839,197,355,1,198,1,356,10178,0,0,0,0
UI-Character-Info-DemonHunter-BG,6038,839,197,355,200,397,1,356,10179,0,0,0,0
UI-Character-Info-Druid-BG,6039,839,197,355,399,596,1,356,10180,0,0,0,0
UI-Character-Info-Hunter-BG,6040,839,197,355,598,795,1,356,10181,0,0,0,0
Relic-SlotBG-Glass,6041,607,34,34,981,1015,37,71,10161,0,0,0,0
loottab-set-itemborder-artifact,6042,822,41,41,1,42,44,85,10162,0,0,0,0
loottab-set-itemborder-white,6043,822,41,41,87,128,44,85,10163,0,0,0,0
loottab-set-itemborder-orange,6044,822,41,41,44,85,44,85,10164,0,0,0,0
Artifacts-BG-Shadow,6045,840,896,615,1,897,1,616,10165,0,0,0,0
worldquest-questmarker-rare-down,6046,743,20,20,482,502,1,21,10159,0,0,0,0
worldquest-questmarker-rare,6047,743,20,20,460,480,1,21,10160,0,0,0,0
poi-majorcity,6049,647,32,32,270,302,270,302,10168,0,0,0,0
poi-town,6050,647,32,32,304,336,270,302,10169,0,0,0,0
pvpqueue-bg-alliance,6051,841,322,229,1,323,1,230,10186,0,0,0,0
pvpqueue-bg-horde,6052,842,322,229,1,323,1,230,10187,0,0,0,0
honorsystem-prestige-smallwreath,6053,696,89,53,902,991,1,54,10185,0,0,0,0
orderhall-commandbar-mapbutton-down,6054,762,27,27,60,87,28,55,10182,0,0,0,0
orderhall-commandbar-mapbutton-up,6055,762,27,27,89,116,28,55,10183,0,0,0,0
worldquest-tracker-bg-noemissary,6056,743,30,30,384,414,1,31,10184,0,0,0,0
Quest-Alliance-WaxSeal,6057,843,97,90,1,98,819,909,10239,0,0,0,0
Quest-Horde-WaxSeal,6058,843,97,90,1,98,911,1001,10240,0,0,0,0
QuestBG-Alliance,6059,843,299,407,1,300,1,408,10241,0,0,0,0
QuestBG-Horde,6060,843,299,407,1,300,410,817,10242,0,0,0,0
insetshadow,6062,844,510,395,1,511,1,396,10291,0,0,0,0
ChallengeMode-guild-background,6063,569,250,110,397,647,1,111,10245,0,0,0,0
ChallengeMode-RankLineDivider,6064,569,193,9,397,590,284,293,10246,0,0,0,0
_Talent-green-glow,6068,110,16,16,0,16,64,80,10292,0,0,4,0
legionmission-lock,6072,783,32,42,212,244,53,95,10251,0,0,0,0
honorsystem-prestige-rewardline,6076,696,276,1,603,879,433,434,10255,0,0,0,0
orderhalltalents-done-checkmark,6085,758,40,35,1,41,215,250,10188,0,0,0,0
orderhalltalents-done-glow,6086,758,146,146,1,147,1,147,10189,0,0,0,0
map-icon-ignored-blueexclaimation,6088,647,32,32,236,268,372,404,10190,0,0,0,0
map-icon-ignored-bluequestion,6089,647,32,32,236,268,406,438,10191,0,0,0,0
map-icon-deathknightclasshall,6090,647,64,64,265,329,1,65,10256,0,0,0,0
Dungeon,6091,647,22,22,194,216,67,89,10192,0,0,0,0
Raid,6092,647,22,22,218,240,67,89,10193,0,0,0,0
map-icon-SuramarDoor.tga,6093,647,32,32,236,268,338,370,10210,0,0,0,0
ClassTrial-Shaman-Ring,6094,833,188,188,761,949,348,536,10252,0,0,0,0
Mobile-BonusIcon,6095,846,128,128,391,519,1,129,10211,0,0,0,0
Mobile-CombatBadgeIcon,6096,846,128,128,651,779,1,129,10212,0,0,0,0
Mobile-CombatIcon,6097,846,128,128,781,909,1,129,10213,0,0,0,0
Mobile-LegendaryQuestIcon,6098,846,128,128,651,779,131,259,10214,0,0,0,0
Mobile-QuestIcon,6099,846,128,128,391,519,261,389,10215,0,0,0,0
Mobile-TreasureIcon,6100,846,128,128,261,389,391,519,10216,0,0,0,0
ClassHall_StoneFrame-BackgroundTile,6101,847,256,256,0,256,0,256,10217,0,0,6,0
ClassHall_InfoBoxMission-BackgroundTile,6102,848,256,256,0,256,0,256,10218,0,0,6,0
StoneFrameCorner-TopLeft,6103,849,42,40,461,503,61,101,10219,0,0,0,0
ClassHall-Circle-Mage,6104,849,90,88,1,91,421,509,10220,0,0,0,0
_StoneFrameTile-Bottom,6105,849,512,28,0,512,1,29,10221,0,0,4,0
_StoneFrameTile-Top,6106,849,512,28,0,512,31,59,10222,0,0,4,0
ClassHall-Circle-DeathKnight,6107,849,90,88,1,91,61,149,10223,0,0,0,0
ClassHall-Circle-Hunter,6108,849,90,88,1,91,331,419,10224,0,0,0,0
ClassHall-Circle-Warrior,6109,849,90,88,93,183,331,419,10225,0,0,0,0
ClassHall-Circle-Druid,6110,849,90,88,1,91,241,329,10226,0,0,0,0
ClassHall-Circle-Warlock,6111,849,90,88,93,183,241,329,10227,0,0,0,0
ClassHall-Circle-Shaman,6112,849,90,88,93,183,151,239,10228,0,0,0,0
ClassHall-Circle-Rogue,6113,849,90,88,369,459,61,149,10229,0,0,0,0
ClassHall-Circle-Monk,6114,849,90,88,93,183,61,149,10230,0,0,0,0
ClassHall-Circle-DemonHunter,6115,849,90,88,1,91,151,239,10231,0,0,0,0
ClassHall-Circle-Priest,6116,849,90,88,277,367,61,149,10232,0,0,0,0
ClassHall-Circle-Paladin,6117,849,90,88,185,275,61,149,10233,0,0,0,0
!StoneFrameTile-Left,6118,850,28,512,1,29,0,512,10234,0,0,2,0
ClassHall_ParchmentHeaderSelect-End,6119,851,40,41,1,41,441,482,10235,0,0,0,0
_ClassHall_ParchmentHeaderSelect-Mid,6120,851,128,41,0,128,181,222,10236,0,0,4,0
_ClassHall_ParchmentHeader-Mid,6121,851,128,41,0,128,138,179,10237,0,0,4,0
ClassHall_ParchmentHeader-End,6122,851,40,41,138,178,304,345,10238,0,0,0,0
Mobile-CombatIcon-Desaturated,6123,846,128,128,1,129,131,259,10257,0,0,0,0
Mobile-BonusIcon-Desaturated,6124,846,128,128,521,649,1,129,10258,0,0,0,0
Mobile-TreasureIcon-Desaturated,6125,846,128,128,261,389,521,649,10259,0,0,0,0
Mobile-QuestIcon-Desaturated,6126,846,128,128,521,649,261,389,10260,0,0,0,0
Mobile-LegendaryQuestIcon-Desaturated,6127,846,128,128,781,909,131,259,10261,0,0,0,0
ClassHall-TreasureIcon-Desaturated,6128,852,64,64,1,65,1,65,10262,0,0,0,0
ClassHall-LegendaryIcon-Desaturated,6129,852,64,64,67,131,1,65,10263,0,0,0,0
ClassHall-QuestIcon-Desaturated,6130,852,64,64,133,197,1,65,10264,0,0,0,0
ClassHall-BonusIcon-Desaturated,6131,852,64,64,1,65,67,131,10265,0,0,0,0
ClassHall-CombatIcon-Desaturated,6132,852,64,64,1,65,133,197,10266,0,0,0,0
worldquest-icon-dungeon,6133,743,16,17,416,432,23,40,10243,0,0,0,0
honorsystem-bar-lock,6134,696,36,47,902,938,118,165,10293,0,0,0,0
Mobile-Alchemy,6135,846,128,128,1,129,1,129,10267,0,0,0,0
Mobile-Archeology,6136,846,128,128,131,259,1,129,10268,0,0,0,0
Mobile-Blacksmithing,6137,846,128,128,261,389,1,129,10269,0,0,0,0
Mobile-Cooking,6138,846,128,128,1,129,261,389,10270,0,0,0,0
Mobile-Enchanting,6139,846,128,128,1,129,391,519,10271,0,0,0,0
Mobile-Enginnering,6140,846,128,128,1,129,521,649,10272,0,0,0,0
Mobile-FirstAid,6141,846,128,128,1,129,651,779,10273,0,0,0,0
Mobile-Fishing,6142,846,128,128,1,129,781,909,10274,0,0,0,0
Mobile-Herbalism,6143,846,128,128,131,259,131,259,10275,0,0,0,0
Mobile-Inscription,6144,846,128,128,261,389,131,259,10276,0,0,0,0
Mobile-Jewelcrafting,6145,846,128,128,391,519,131,259,10280,0,0,0,0
Mobile-Leatherworking,6146,846,128,128,521,649,131,259,10281,0,0,0,0
Mobile-MechanicIcon-Curse,6147,846,128,128,131,259,261,389,10282,0,0,0,0
Mobile-MechanicIcon-Disorienting,6148,846,128,128,131,259,391,519,10283,0,0,0,0
Mobile-MechanicIcon-Lethal,6149,846,128,128,131,259,521,649,10284,0,0,0,0
Mobile-MechanicIcon-Slowing,6150,846,128,128,131,259,651,779,10285,0,0,0,0
Mobile-Mining,6151,846,128,128,131,259,781,909,10286,0,0,0,0
Mobile-Pets,6152,846,128,128,261,389,261,389,10287,0,0,0,0
Mobile-Skinning,6153,846,128,128,651,779,261,389,10288,0,0,0,0
Mobile-Tailoring,6154,846,128,128,781,909,261,389,10289,0,0,0,0
Taxi_Frame_Gray,6155,853,74,74,1,75,35,109,10194,0,0,0,0
Taxi_Frame_Green,6156,853,74,74,1,75,111,185,10195,0,0,0,0
UI-Taxi-Icon-Nub,6157,853,16,16,77,93,35,51,10196,0,0,0,0
!UI-Taxi-Line,6159,854,32,32,1,33,0,32,10198,0,0,2,0
_UI-Taxi-Line-horizontal,6161,853,32,32,0,32,1,33,10197,0,0,4,0
Mobile-MechanicIcon-Powerful,6162,846,128,128,261,389,651,779,10290,0,0,0,0
GarrMission_ClassIcon-DemonHunter-Outcast,6163,823,55,49,1,56,1,50,10244,0,0,0,0
splash-703-botleft,6165,855,137,371,374,511,587,958,10199,0,0,0,0
splash-703-right,6166,855,510,584,1,511,1,585,10200,0,0,0,0
splash-703-topleft,6167,855,371,434,1,372,587,1021,10201,0,0,0,0
splash-704-botleft,6168,856,137,371,374,511,587,958,10202,0,0,0,0
splash-704-right,6169,856,510,584,1,511,1,585,10203,0,0,0,0
splash-704-topleft,6170,856,371,434,1,372,587,1021,10204,0,0,0,0
splash-705-botleft,6171,857,137,371,374,511,587,958,10205,0,0,0,0
splash-705-right,6172,857,510,584,1,511,1,585,10206,0,0,0,0
splash-705-topleft,6173,857,371,434,1,372,587,1021,10207,0,0,0,0
inspect-talent-selected,6174,858,38,38,1,39,1,39,10294,0,0,0,0
loottab-background,6175,859,786,381,1,787,1,382,10253,0,0,0,0
loottab-set-background,6176,859,744,41,1,745,384,425,10247,0,0,0,0
AutoQuest-badgeborder,6177,860,44,45,1,45,1,46,10208,0,0,0,0
ClassHall_Follower-EquipmentBG,6178,851,78,78,138,216,224,302,10295,0,0,0,0
ClassHall_Follower-EquipmentFrame,6179,851,78,78,1,79,361,439,10296,0,0,0,0
ClassHall_InfoBoxMission-Corner,6180,851,135,135,1,136,224,359,10297,0,0,0,0
_ClassHall_InfoBoxMission-Top,6181,851,256,135,0,256,1,136,10298,0,0,4,0
!ClassHall_InfoBoxMission-Left,6182,861,135,256,1,136,0,256,10299,0,0,2,0
ClassHall_ParchmentHeader-End-2,6183,851,40,41,180,220,304,345,10300,0,0,0,0
ClassHall_ParchmentHeaderSelect-End-2,6184,851,40,41,81,121,361,402,10301,0,0,0,0
ClassHall-CombatAlly,6197,864,890,115,1,891,1,116,10209,0,0,0,0
nameplates-icon-elite-gold,6198,731,37,35,1,38,45,80,9861,0,0,0,0
nameplates-icon-elite-silver,6199,731,37,35,1,38,82,117,9880,0,0,0,0
StreamCinematic-Legion-Down,6200,557,176,78,615,791,161,239,10302,0,0,0,0
StreamCinematic-Legion-Up,6201,557,176,78,793,969,81,159,10303,0,0,0,0
GarrMission_ClassIcon-Karazhan,6219,823,55,49,1,56,103,152,10313,0,0,0,0
WhiteCircle-RaidBlips,6220,867,19,18,1,20,1,19,10304,0,0,0,0
WhiteDotCircle-RaidBlips,6221,867,19,18,22,41,1,19,10305,0,0,0,0
friendslist-categorybutton-arrow-down,6222,869,16,11,296,312,1,12,5845,0,0,0,0
friendslist-categorybutton-arrow-right,6223,869,11,16,314,325,1,17,23305,0,0,0,0
friendslist-categorybutton,6224,869,293,26,1,294,1,27,5847,0,0,0,0
Taxi_Frame_Yellow,6225,853,74,74,1,75,187,261,10306,0,0,0,0
pvprated-loottoast-bg-alliance,6226,870,277,113,1,278,118,231,10310,0,0,0,0
pvprated-loottoast-bg-horde,6227,870,281,115,1,282,1,116,10311,0,0,0,0
128-RedButton-Highlight,6228,871,441,128,1,442,391,519,10314,0,0,0,0
128-RedButton-LeftCorner-Disabled,6229,871,292,128,1,293,521,649,10315,0,0,0,0
128-RedButton-LeftCorner-Pressed,6230,871,292,128,1,293,651,779,10316,0,0,0,0
128-RedButton-LeftCorner,6231,871,292,128,1,293,781,909,10317,0,0,0,0
128-RedButton-RightCorner-Disabled,6232,871,114,128,295,409,521,649,10318,0,0,0,0
128-RedButton-RightCorner-Pressed,6233,871,114,128,295,409,651,779,10319,0,0,0,0
128-RedButton-RightCorner,6234,871,114,128,295,409,781,909,10320,0,0,0,0
_128-RedButton-Tile-Disabled,6235,871,64,128,0,64,1,129,10321,0,0,4,0
_128-RedButton-Tile-Pressed,6236,871,64,128,0,64,131,259,10322,0,0,4,0
_128-RedButton-Tile,6237,871,64,128,0,64,261,389,10323,0,0,4,0
bags-greenarrow,6238,202,20,22,80,100,138,160,10312,0,0,0,0
socialqueuing-icon-clock,6239,845,13,11,304,317,35,46,10277,0,0,0,0
socialqueuing-icon-eye,6240,845,24,25,382,406,29,54,10278,0,0,0,0
socialqueuing-icon-group,6241,845,29,26,382,411,1,27,10279,0,0,0,0
quickjoin-button-friendslist-down,6242,872,32,32,304,336,1,33,10248,0,0,0,0
quickjoin-button-friendslist-up,6243,872,32,32,338,370,1,33,10249,0,0,0,0
quickjoin-button-quickjoin-down,6244,872,32,32,440,472,1,33,10250,0,0,0,0
quickjoin-button-quickjoin-up,6245,872,32,32,474,506,1,33,10254,0,0,0,0
quickjoin-toast-background,6248,872,301,32,1,302,1,33,10394,0,0,0,0
quickjoin-toast-lines,6249,872,287,23,1,288,35,58,10395,0,0,0,0
macropopup-bottomleft,6253,873,18,39,81,99,172,211,5879,0,0,0,0
macropopup-bottomright,6254,873,174,39,1,175,131,170,5880,0,0,0,0
macropopup-topleft,6255,873,18,71,1,19,172,243,5881,0,0,0,0
macropopup-topright,6256,873,18,71,21,39,172,243,5882,0,0,0,0
_macropopup-bottom,6257,873,256,39,0,256,71,110,5883,0,0,4,0
_macropopup-top,6258,873,256,68,0,256,1,69,5884,0,0,4,0
!macropopup-left,6259,874,17,256,33,50,0,256,5885,0,0,2,0
!macropopup-right,6260,874,17,256,52,69,0,256,5886,0,0,2,0
macropopup-scrollbar-bottom,6261,873,30,24,209,239,131,155,5877,0,0,0,0
macropopup-scrollbar-top,6262,873,30,25,177,207,131,156,5878,0,0,0,0
!macropopup-scrollbar-middle,6263,874,30,256,1,31,0,256,5887,0,0,2,0
socialqueuing-row-highlight,6264,845,301,55,1,302,1,56,10324,0,0,0,0
socialqueuing-row-select,6265,845,301,55,1,302,58,113,10325,0,0,0,0
splash-710-botleft,6266,875,137,371,374,511,587,958,10364,0,0,0,0
splash-710-right,6267,875,510,584,1,511,1,585,10365,0,0,0,0
splash-710-topleft,6268,875,371,434,1,372,587,1021,10366,0,0,0,0
groupfinder-icon-class-demonhunter,6269,236,29,29,293,322,960,989,10326,0,0,0,0
AncientMana,6270,647,32,32,32,64,134,166,10367,0,0,0,0
quickjoin-button-group-down,6271,872,32,32,372,404,1,33,10327,0,0,0,0
quickjoin-button-group-up,6272,872,32,32,406,438,1,33,10328,0,0,0,0
socialqueuing-friendlist-summonbutton-disabled,6276,845,24,32,304,328,1,33,10368,0,0,0,0
socialqueuing-friendlist-summonbutton-down,6277,845,24,32,330,354,1,33,10369,0,0,0,0
socialqueuing-friendlist-summonbutton-up,6278,845,24,32,356,380,1,33,10370,0,0,0,0
worldquest-icon-burninglegion,6291,743,16,15,246,262,111,126,10393,0,0,0,0
worldquest-icon-raid,6292,743,16,17,434,450,23,40,10408,0,0,0,0
GarrMission-AbilityHighlight-Error,6293,156,58,58,444,502,859,917,9082,0,0,0,0
transmog-set-border-collected,6295,877,152,208,1,153,1,209,10409,0,0,0,0
transmog-set-border-current-transmogged,6296,877,132,188,301,433,1,189,10396,0,0,0,0
transmog-set-border-current,6297,877,132,188,155,287,203,391,10410,0,0,0,0
transmog-set-border-highlighted,6298,877,132,188,289,421,203,391,10411,0,0,0,0
transmog-set-border-selected,6299,877,150,206,1,151,211,417,10412,0,0,0,0
transmog-set-border-unusable,6300,877,144,200,155,299,1,201,10413,0,0,0,0
transmog-set-iconrow-background,6301,876,418,64,1,419,181,245,10414,0,0,0,0
ParagonReputation_Bag,6302,878,15,18,38,53,1,19,8595,0,0,0,0
ParagonReputation_Checkmark,6303,878,16,14,38,54,21,35,9083,0,0,0,0
ParagonReputation_Glow,6304,878,35,35,1,36,1,36,9084,0,0,0,0
Legionfall_Background,6305,879,871,576,1,872,1,577,10415,0,0,0,0
Legionfall_Banner,6306,879,252,39,586,838,745,784,10416,0,0,0,0
Legionfall_BarBackground,6307,879,230,18,606,836,861,879,10417,0,0,0,0
Legionfall_BarFrame,6308,879,240,31,397,637,828,859,10418,0,0,0,0
Legionfall_BarSpark,6309,879,16,64,874,890,48,112,10419,0,0,0,0
Legionfall_BuildingInfoBackground,6310,879,207,30,397,604,861,891,10420,0,0,0,0
Legionfall_GrayFrame,6311,879,205,97,1,206,579,676,10421,0,0,0,0
Legionfall_Padlock,6312,879,38,45,874,912,1,46,10422,0,0,0,0
_Legionfall_BarFill_Active,6313,880,256,17,0,256,1,18,10423,0,0,4,0
_Legionfall_BarFill_UnderAttack,6314,880,256,17,0,256,20,37,10424,0,0,4,0
_Legionfall_BarFill_UnderConstruction,6315,880,256,17,0,256,39,56,10425,0,0,4,0
legionmission-portraitring-epicplus,6316,783,68,61,64,132,158,219,10426,0,0,0,0
legionmission-portraitring_levelborder_epicplus,6317,783,58,24,1,59,221,245,10427,0,0,0,0
Legionfall_CommandCenter_Completed,6318,879,187,81,208,395,579,660,10428,0,0,0,0
Legionfall_CommandCenter_Destroyed,6319,879,187,81,397,584,579,660,10429,0,0,0,0
Legionfall_CommandCenter_UnderAttack,6320,879,187,81,586,773,579,660,10430,0,0,0,0
Legionfall_CommandCenter_UnderConstruction,6321,879,187,81,775,962,579,660,10431,0,0,0,0
Legionfall_MageTower_Completed,6322,879,187,81,208,395,662,743,10432,0,0,0,0
Legionfall_MageTower_Destroyed,6323,879,187,81,397,584,662,743,10433,0,0,0,0
Legionfall_MageTower_UnderAttack,6324,879,187,81,586,773,662,743,10329,0,0,0,0
Legionfall_MageTower_UnderConstruction,6325,879,187,81,775,962,662,743,10330,0,0,0,0
Legionfall_NetherDisruptor_Completed,6326,879,187,81,208,395,745,826,10331,0,0,0,0
Legionfall_NetherDisruptor_Destroyed,6327,879,187,81,208,395,828,909,10332,0,0,0,0
Legionfall_NetherDisruptor_UnderAttack,6328,879,187,81,208,395,911,992,10333,0,0,0,0
Legionfall_NetherDisruptor_UnderConstruction,6329,879,187,81,397,584,745,826,10334,0,0,0,0
Artifacts-DeathKnightFrost-BG-Rune,6330,677,204,204,1,205,745,949,10371,0,0,0,0
Artifacts-ItemIconBorder,6331,607,86,86,258,344,932,1018,10372,0,0,0,0
Artifacts-PerkRing-Final,6332,607,111,111,612,723,566,677,10335,0,0,0,0
Artifacts-DeathKnightFrost-FinalIcon,6333,677,86,86,899,985,1,87,10336,0,0,0,0
Legionfall_GrayBanner,6334,879,252,39,586,838,786,825,10373,0,0,0,0
Legionfall_GreenFrame,6335,879,205,97,1,206,678,775,10374,0,0,0,0
Legionfall_RedFrame,6336,879,205,97,1,206,777,874,10375,0,0,0,0
Legionfall_YellowFrame,6337,879,205,97,1,206,876,973,10376,0,0,0,0
Legionfall_ExitFrame,6338,879,33,32,955,988,1,33,10377,0,0,0,0
equipmentmanager-spec-border,6339,881,28,28,1,29,1,29,10378,0,0,0,0
Artifacts-DemonHunter-BG-rune,6340,649,270,270,1,271,746,1016,10337,0,0,0,0
Artifacts-Druid-BG-rune,6341,680,220,220,1,221,800,1020,10338,0,0,0,0
Artifacts-Hunter-BG-rune,6342,710,210,210,1,211,685,895,10339,0,0,0,0
Artifacts-MageArcane-BG-rune,6343,662,204,204,1,205,758,962,10340,0,0,0,0
Artifacts-Monk-BG-rune,6344,712,226,226,1,227,765,991,10341,0,0,0,0
Artifacts-Paladin-BG-rune,6345,650,204,204,1,205,703,907,10342,0,0,0,0
Artifacts-Priest-BG-rune,6346,711,246,246,1,247,730,976,10343,0,0,0,0
Artifacts-PriestShadow-BG-rune,6347,724,246,246,1,247,734,980,10344,0,0,0,0
Artifacts-Rogue-BG-rune,6348,679,204,204,1,205,699,903,10345,0,0,0,0
Artifacts-Shaman-BG-rune,6349,709,204,204,1,205,719,923,10346,0,0,0,0
Artifacts-Warlock-BG-rune,6350,713,204,204,1,205,712,916,10347,0,0,0,0
Artifacts-Warrior-BG-rune,6351,678,280,280,1,281,618,898,10348,0,0,0,0
Artifacts-PerkRing-Final-Shine,6352,607,111,111,725,836,566,677,10349,0,0,0,0
Talent-Selection-Legendary,6353,110,190,45,1,191,328,373,10350,0,0,0,0
Artifacts-DemonHunter-FinalIcon,6354,649,86,86,899,985,1,87,10351,0,0,0,0
Artifacts-Druid-FinalIcon,6355,680,86,86,899,985,1,87,10352,0,0,0,0
Artifacts-Hunter-FinalIcon,6356,710,86,86,899,985,1,87,10353,0,0,0,0
Artifacts-MageArcane-FinalIcon,6357,662,86,86,899,985,1,87,10354,0,0,0,0
Artifacts-Monk-FinalIcon,6358,712,86,86,899,985,1,87,10355,0,0,0,0
Artifacts-Paladin-FinalIcon,6359,650,86,86,899,985,1,87,10356,0,0,0,0
Artifacts-Priest-FinalIcon,6360,711,86,86,899,985,1,87,10357,0,0,0,0
Artifacts-PriestShadow-FinalIcon,6361,724,86,86,899,985,1,87,10358,0,0,0,0
Artifacts-Rogue-FinalIcon,6362,679,86,86,899,985,1,87,10359,0,0,0,0
Artifacts-Shaman-FinalIcon,6363,709,86,86,899,985,1,87,10360,0,0,0,0
Artifacts-Warlock-FinalIcon,6364,713,86,86,899,985,1,87,10361,0,0,0,0
Artifacts-Warrior-FinalIcon,6365,678,86,86,899,985,1,87,10362,0,0,0,0
Artifacts-CrestRune-Gold,6366,688,203,204,1,204,19,223,10363,0,0,0,0
LegionfallMapBanner,6367,647,64,64,1,65,1,65,10379,0,0,0,0
QuestBG-Legionfall,6368,843,299,407,302,601,1,408,10380,0,0,0,0
Quest-Legionfall-WaxSeal,6369,843,96,90,100,196,819,909,10381,0,0,0,0
poi-transmogrifier,6370,647,29,36,1,30,100,136,10382,0,0,0,0
Artifacts-Anim-Sparks,6371,882,680,680,1,681,1,681,10383,0,0,0,0
worldquest-emissary-ring,6372,743,30,30,384,414,33,63,10384,0,0,0,0
worldquest-emissary-tracker-checkmark,6373,743,18,16,226,244,111,127,10385,0,0,0,0
splash-720-botleft,6375,883,137,371,374,511,587,958,9352,0,0,0,0
splash-720-right,6376,883,510,584,1,511,1,585,9353,0,0,0,0
splash-720-topleft,6377,883,371,434,1,372,587,1021,9354,0,0,0,0
DemonShip,6378,647,31,56,431,462,1,57,10387,0,0,0,0
Artifacts-Anim-Orb,6379,882,256,256,683,939,341,597,10386,0,0,0,0
Artifacts-Anim-Glowies,6380,882,338,338,683,1021,1,339,10388,0,0,0,0
Legionfall_BarFrame-Glow,6381,879,240,31,639,879,828,859,10389,0,0,0,0
transmog-set-model-cutoff-fade,6382,876,403,178,1,404,1,179,9355,0,0,0,0
MountToast-Background,6383,884,276,109,1,277,1,110,9356,0,0,0,0
PetToast-background,6384,885,276,98,1,277,1,99,9357,0,0,0,0
honorsystem-icon-enlistmentbonus,6385,696,29,29,902,931,167,196,9358,0,0,0,0
Artifacts-Anim-CrackedGround,6386,886,510,510,1,511,1,511,10390,0,0,0,0
Legionfall_GrayFrame_Buffs,6387,879,39,39,914,953,1,40,10391,0,0,0,0
DemonShip_East,6388,647,56,31,1,57,67,98,10392,0,0,0,0
DK-Blood-Rune-CDFill,6460,894,34,37,1,35,1,38,10607,0,0,0,0
DK-BloodUnholy-Rune-CDSpark,6461,894,34,37,1,35,40,77,10608,0,0,0,0
DK-Frost-Rune-CDFill,6462,894,34,37,1,35,79,116,10609,0,0,0,0
DK-Frost-Rune-CDSpark,6463,894,34,37,37,71,1,38,10610,0,0,0,0
DK-Unholy-Rune-CDFill,6464,894,34,37,73,107,1,38,10611,0,0,0,0
Warlock-Bar-EmptyShards,6465,895,133,29,42,175,6,35,10691,0,0,0,0
Warlock-EmptyShard,6466,895,17,22,1,18,38,60,10692,0,0,0,0
Warlock-FillShard,6467,895,17,22,23,40,1,23,10693,0,0,0,0
Warlock-ReadyShard-Glow,6468,895,20,35,1,21,1,36,10694,0,0,0,0
Warlock-ReadyShard,6469,895,17,22,23,40,25,47,10695,0,0,0,0
Warlock-Shard-Spark,6470,895,21,3,42,63,1,4,10696,0,0,0,0
CastBar,6472,695,256,64,1,257,165,229,10563,0,0,0,0
CurrentPlayer-Glow,6473,695,128,128,325,453,35,163,10564,0,0,0,0
DarkTutorialFrameBackground,6474,695,32,32,259,291,1,33,10565,0,0,0,0
DeathIcon,6475,695,64,128,779,843,35,163,10566,0,0,0,0
HealerBadge,6476,695,64,64,455,519,35,99,10567,0,0,0,0
HealingDampening,6477,695,256,128,521,777,35,163,10568,0,0,0,0
InterruptOverlay,6478,695,256,128,1,257,231,359,10569,0,0,0,0
RedCCIconGlow,6479,695,128,128,845,973,35,163,10570,0,0,0,0
ScoreDivider,6480,695,64,128,259,323,231,359,10571,0,0,0,0
ScoreTeam,6481,695,512,128,325,837,231,359,10572,0,0,0,0
TankBadge,6482,695,64,64,259,323,35,99,10573,0,0,0,0
TargetCrosshairs,6483,695,128,128,839,967,231,359,10574,0,0,0,0
tournamentarena-frame-bg-corner-blue,6484,695,32,32,327,359,1,33,10575,0,0,0,0
tournamentarena-frame-bg-corner-red,6485,695,32,32,293,325,1,33,10576,0,0,0,0
UI-Feedback-Border,6486,695,256,32,1,257,1,33,10577,0,0,0,0
UnitFrame-NoMana,6487,695,256,128,1,257,361,489,10578,0,0,0,0
UnitFrame-NoTrinket,6488,695,256,128,259,515,361,489,10579,0,0,0,0
UnitFrame,6489,695,256,128,1,257,491,619,10580,0,0,0,0
UnitFrame_CCOverlay-NoMana,6490,695,256,128,1,257,621,749,10581,0,0,0,0
UnitFrame_CCOverlay,6491,695,256,128,517,773,361,489,10582,0,0,0,0
UnitFrame_DeathOverlay-NoMana,6492,695,256,128,1,257,35,163,10583,0,0,0,0
UnitFrame_DeathOverlay,6493,695,256,128,259,515,491,619,10584,0,0,0,0
UnitFrame_FocusFireOverlay-NoMana,6494,695,256,128,259,515,621,749,10585,0,0,0,0
UnitFrame_FocusFireOverlay,6495,695,256,128,517,773,621,749,10586,0,0,0,0
UnitFrame_CurrentPlayer_CCOverlay,6497,896,512,256,1,513,1,257,10588,0,0,0,0
UnitFrame_CurrentPlayer_DeathOverlay,6498,896,512,256,1,513,259,515,10589,0,0,0,0
UnitFrame_CurrentPlayer-NoMana,6499,896,345,130,339,684,670,800,10590,0,0,0,0
UnitFrame_CurrentPlayer-NoTrinket,6500,896,345,151,1,346,517,668,10591,0,0,0,0
UnitFrame_CurrentPlayer,6501,896,345,151,515,860,259,410,10592,0,0,0,0
UnitFrame_CurrentPlayerGlow,6502,896,336,142,1,337,670,812,10593,0,0,0,0
UnitFrame_CurrentPlayer_FocusFireOverlay-NoMana,6503,896,371,130,348,719,517,647,10594,0,0,0,0
UnitFrame_CurrentPlayer_FocusFireOverlay,6504,896,372,151,515,887,1,152,10595,0,0,0,0
UnitFrame_CurrentPlayer_CCOverlay-NoMana,6505,896,330,115,1,331,814,929,10596,0,0,0,0
UnitFrame_CurrentPlayer_DeathOverlay-NoMana,6506,896,330,115,686,1016,670,785,10597,0,0,0,0
UnitFrame_CurrentPlayerGlow-NoMana,6507,695,336,121,517,853,491,612,10587,0,0,0,0
DK-Blood-Rune-Ready,6508,893,32,32,1,33,1,33,10598,0,0,0,0
DK-Rune-CD,6509,893,32,32,69,101,1,33,10599,0,0,0,0
DK-Rune-Glow,6510,893,32,32,1,33,35,67,10600,0,0,0,0
DK-Unholy-Rune-Ready,6511,893,32,32,1,33,69,101,10601,0,0,0,0
DK-Frost-Rune-Ready,6512,893,32,32,35,67,1,33,10602,0,0,0,0
raceicon-bloodelf-male,6537,897,64,64,131,195,391,455,10541,0,0,0,0
raceicon-draenei-female,6538,897,64,64,261,325,391,455,10542,0,0,0,0
raceicon-draenei-male,6539,897,64,64,391,455,1,65,10543,0,0,0,0
raceicon-dwarf-female,6540,897,64,64,391,455,67,131,10544,0,0,0,0
raceicon-dwarf-male,6541,897,64,64,391,455,133,197,10545,0,0,0,0
raceicon-gnome-female,6542,897,64,64,391,455,199,263,10546,0,0,0,0
raceicon-gnome-male,6543,897,64,64,391,455,265,329,10547,0,0,0,0
raceicon-goblin-male,6544,897,64,64,391,455,397,461,10548,0,0,0,0
raceicon-human-female,6545,897,64,64,457,521,133,197,10549,0,0,0,0
raceicon-human-male,6546,897,64,64,457,521,199,263,10550,0,0,0,0
raceicon-nightelf-female,6547,897,64,64,589,653,1,65,10551,0,0,0,0
raceicon-nightelf-male,6548,897,64,64,655,719,1,65,10552,0,0,0,0
raceicon-orc-female,6549,897,64,64,721,785,1,65,10553,0,0,0,0
raceicon-orc-male,6550,897,64,64,787,851,1,65,10554,0,0,0,0
raceicon-pandaren-female,6551,897,64,64,853,917,1,65,10555,0,0,0,0
raceicon-pandaren-male,6552,897,64,64,919,983,1,65,10556,0,0,0,0
raceicon-tauren-female,6553,897,64,64,523,587,67,131,10557,0,0,0,0
raceicon-tauren-male,6554,897,64,64,523,587,133,197,10558,0,0,0,0
raceicon-troll-female,6555,897,64,64,523,587,199,263,10559,0,0,0,0
raceicon-troll-male,6556,897,64,64,523,587,265,329,10560,0,0,0,0
raceicon-undead-female,6557,897,64,64,523,587,331,395,10561,0,0,0,0
raceicon-undead-male,6558,897,64,64,523,587,397,461,10562,0,0,0,0
raceicon-worgen-female,6559,897,64,64,721,785,67,131,10517,0,0,0,0
raceicon-worgen-male,6560,897,64,64,787,851,67,131,10518,0,0,0,0
poi-graveyard-neutral,6561,647,12,16,499,511,1,17,10649,0,0,0,0
poi-door-arrow-down,6562,647,13,14,331,344,51,65,10650,0,0,0,0
poi-door-arrow-up,6563,647,13,14,346,359,51,65,10651,0,0,0,0
poi-door,6564,647,25,24,59,84,67,91,10652,0,0,0,0
tournamentarena-winnerline,6565,695,418,1,381,799,1,2,9395,0,0,0,0
ui-moneyframe-large,6566,898,172,120,1,173,1,121,6058,0,0,0,0
talenttree-chromie-background,6568,900,322,438,1,323,1,439,9396,0,0,0,0
worldstate-capturebar-blue,6569,901,46,9,176,222,1,10,10519,0,0,0,0
worldstate-capturebar-gray,6570,901,46,9,176,222,12,21,10520,0,0,0,0
worldstate-capturebar-green,6571,901,46,9,176,222,29,38,10521,0,0,0,0
worldstate-capturebar-purple,6572,901,46,9,176,222,40,49,10522,0,0,0,0
worldstate-capturebar-red,6573,901,46,9,30,76,57,66,10523,0,0,0,0
worldstate-capturebar-yellow,6574,901,46,9,78,124,57,66,10524,0,0,0,0
splash-725-botleft,6575,902,137,371,374,511,587,958,10525,0,0,0,0
splash-725-right,6576,902,510,584,1,511,1,585,10526,0,0,0,0
splash-725-topleft,6577,902,371,434,1,372,587,1021,10527,0,0,0,0
TaxiNode_Alliance,6617,647,18,18,493,511,35,53,10615,0,0,0,0
TaxiNode_Horde,6618,647,18,18,242,260,67,85,10616,0,0,0,0
TaxiNode_Neutral,6619,647,18,18,262,280,67,85,10617,0,0,0,0
FlightMaster_Argus-Taxi_Frame_Gray,6623,905,64,54,229,293,1,55,10618,0,0,0,0
FlightMaster_Argus-Taxi_Frame_Yellow,6625,905,64,54,295,359,1,55,10619,0,0,0,0
Darklink-ball,6627,906,44,44,425,469,558,602,10612,0,0,0,0
Darklink-glow,6628,906,87,101,913,1000,175,276,10613,0,0,0,0
Darklink,6629,906,61,82,599,660,752,834,10614,0,0,0,0
Darkstone1,6630,906,52,43,913,965,278,321,10620,0,0,0,0
Darkstone2,6631,906,27,29,995,1022,532,561,10621,0,0,0,0
Darkstone3,6632,906,29,39,992,1021,47,86,10622,0,0,0,0
Darkstone4,6633,906,43,35,425,468,782,817,10623,0,0,0,0
Darkstone5,6634,906,31,44,425,456,895,939,10624,0,0,0,0
Darkstone6,6635,906,47,40,822,869,420,460,10625,0,0,0,0
Darkstone7,6636,906,27,26,551,578,990,1016,10626,0,0,0,0
Darktrait-border,6637,906,56,54,414,470,958,1012,10627,0,0,0,0
Lightlink-ball,6638,906,44,44,425,469,604,648,10628,0,0,0,0
Lightlink-glow,6639,906,87,101,733,820,327,428,10629,0,0,0,0
Lightlink,6640,906,61,82,599,660,836,918,10630,0,0,0,0
Lightstone1,6641,906,34,35,980,1014,368,403,10631,0,0,0,0
Lightstone2,6642,906,28,32,995,1023,498,530,10632,0,0,0,0
Lightstone3,6643,906,31,31,992,1023,129,160,10633,0,0,0,0
Lightstone4,6644,906,31,29,765,796,430,459,10634,0,0,0,0
Lightstone5,6645,906,45,39,425,470,695,734,10635,0,0,0,0
Lightstone6,6646,906,33,39,980,1013,327,366,10636,0,0,0,0
Lightstone7,6647,906,38,44,425,463,736,780,10637,0,0,0,0
Lighttrait-border,6648,906,56,54,812,868,656,710,10638,0,0,0,0
simplecheckout-close-hover-1x,6649,907,20,20,1,21,43,63,10639,0,0,0,0
simplecheckout-close-hover-2x,6650,907,40,40,1,41,1,41,10640,0,0,0,0
simplecheckout-close-normal-1x,6651,907,20,20,43,63,43,63,10641,0,0,0,0
simplecheckout-close-normal-2x,6652,907,40,40,43,83,1,41,10642,0,0,0,0
simplecheckout-close-pressed-1x,6653,907,20,20,85,105,43,63,10643,0,0,0,0
simplecheckout-close-pressed-2x,6654,907,40,40,85,125,1,41,10644,0,0,0,0
Darktrait-Glow,6655,906,74,74,667,741,580,654,10528,0,0,0,0
Lighttrait-glow,6656,906,74,74,743,817,580,654,10529,0,0,0,0
Mixedtrait-border,6657,906,56,54,870,926,656,710,10530,0,0,0,0
Relic-Rankframe-glow,6658,906,30,30,733,763,430,460,10531,0,0,0,0
Relic-Rankframe,6659,906,23,23,871,894,420,443,10532,0,0,0,0
Relic-Rankselected-circle,6660,906,43,43,425,468,650,693,10533,0,0,0,0
Relic-Rankselected-UpperGlow,6661,906,151,150,625,776,175,325,10534,0,0,0,0
Relicforge-background,6662,906,469,555,1,470,1,556,10535,0,0,0,0
Relicforge-Bottomframe,6663,906,469,16,522,991,462,478,10536,0,0,0,0
Relicforge-Bottomleft-corner,6664,906,71,63,341,412,958,1021,10537,0,0,0,0
Relicforge-Bottomright-corner,6665,906,71,63,739,810,656,719,10538,0,0,0,0
Relicforge-Leftframe,6666,906,23,537,472,495,462,999,10539,0,0,0,0
Relicforge-Relicsbackground,6667,906,422,398,1,423,558,956,10540,0,0,0,0
Relicforge-Rightframe,6668,906,23,537,497,520,462,999,10603,0,0,0,0
Relicforge-Slot-background,6669,906,37,37,425,462,856,893,10604,0,0,0,0
Relicforge-Slot-frame,6670,906,67,67,667,734,886,953,10605,0,0,0,0
Relicforge-Topdecoration,6671,906,261,50,1,262,958,1008,10606,0,0,0,0
Relicforge-Topframe,6672,906,469,16,522,991,480,496,10645,0,0,0,0
Relicforge-Topleft-corner,6673,906,49,68,667,716,955,1023,10646,0,0,0,0
Relicforge-Topright-corner,6674,906,49,68,739,788,795,863,10647,0,0,0,0
Darklink-active,6675,906,66,84,522,588,904,988,10648,0,0,0,0
Disablelink,6676,906,66,84,599,665,666,750,10669,0,0,0,0
Lightlink-active,6677,906,67,85,522,589,817,902,10670,0,0,0,0
Darktrait-backglow,6678,906,172,172,472,644,1,173,10726,0,0,0,0
Lighttrait-backglow,6679,906,172,172,646,818,1,173,10727,0,0,0,0
dressingroom-background-deathknight,6680,908,478,500,1,479,1,501,10671,0,0,0,0
dressingroom-background-demonhunter,6681,909,478,500,1,479,1,501,10672,0,0,0,0
dressingroom-background-druid,6682,910,478,500,1,479,1,501,10673,0,0,0,0
dressingroom-background-hunter,6683,911,478,500,1,479,1,501,10674,0,0,0,0
dressingroom-background-mage,6684,912,478,500,1,479,1,501,10675,0,0,0,0
dressingroom-background-monk,6685,913,478,500,1,479,1,501,10676,0,0,0,0
dressingroom-background-paladin,6686,914,478,500,1,479,1,501,10677,0,0,0,0
dressingroom-background-priest,6687,915,478,500,1,479,1,501,10678,0,0,0,0
dressingroom-background-rogue,6688,916,478,500,1,479,1,501,10679,0,0,0,0
dressingroom-background-shaman,6689,917,478,500,1,479,1,501,10680,0,0,0,0
dressingroom-background-warlock,6690,918,478,500,1,479,1,501,10681,0,0,0,0
dressingroom-background-warrior,6691,919,478,500,1,479,1,501,10682,0,0,0,0
Darklink-blackinside,6692,906,66,84,599,665,580,664,10434,0,0,0,0
Lightlink-blackinside,6693,906,74,91,822,896,327,418,10435,0,0,0,0
worldstate-capturebar-frame-factions,6694,901,173,26,1,174,29,55,10683,0,0,0,0
worldstate-capturebar-frame,6695,901,173,26,1,174,1,27,10684,0,0,0,0
worldstate-capturebar-spark-green,6697,901,5,18,1,6,87,105,10685,0,0,0,0
worldstate-capturebar-spark-yellow,6698,901,5,18,1,6,107,125,10686,0,0,0,0
worldstate-capturebar-glow,6700,901,27,28,1,28,57,85,10687,0,0,0,0
worldstate-capturebar-arrow,6701,901,9,15,224,233,12,27,10688,0,0,0,0
worldstate-capturebar-frame-separater,6702,901,3,8,224,227,1,9,10689,0,0,0,0
poi-rift1,6703,647,27,26,464,491,35,61,10697,0,0,0,0
poi-rift2,6704,647,33,32,464,497,1,33,10698,0,0,0,0
countdown-swords,6707,920,256,256,1,257,1,257,10699,0,0,0,0
countdown-swords-glow,6708,920,256,256,259,515,1,257,10700,0,0,0,0
AlliedRace-TraitsBorder,6709,921,35,35,765,800,1,36,10701,0,0,0,0
AlliedRace-UnlockingFrame-Background,6710,921,680,583,1,681,1,584,10702,0,0,0,0
AlliedRace-UnlockingFrame-BottomButtonsMouseOverGlow,6711,921,34,32,802,836,1,33,10703,0,0,0,0
AlliedRace-UnlockingFrame-BottomButtonsSelectionGlow,6712,921,34,32,838,872,1,33,10704,0,0,0,0
AlliedRace-UnlockingFrame-Female,6713,921,35,31,874,909,1,32,10705,0,0,0,0
AlliedRace-UnlockingFrame-GenderMouseOverGlow,6714,921,39,36,683,722,1,37,10706,0,0,0,0
AlliedRace-UnlockingFrame-GenderSelectionGlow,6715,921,39,36,724,763,1,37,10707,0,0,0,0
AlliedRace-UnlockingFrame-LeftRotation,6716,921,26,22,948,974,1,23,10708,0,0,0,0
AlliedRace-UnlockingFrame-Male,6717,921,35,31,911,946,1,32,10709,0,0,0,0
AlliedRace-UnlockingFrame-RightRotation,6719,921,26,22,976,1002,1,23,10710,0,0,0,0
AlliedRace-UnlockingFrame-ZoomIn,6720,921,26,22,683,709,39,61,10711,0,0,0,0
AlliedRace-UnlockingFrame-ZoomOut,6721,921,26,22,711,737,39,61,10712,0,0,0,0
AlliedRace-UnlockingFrame-ModelBackground-Highmountain,6722,922,314,578,1,315,1,579,10713,0,0,0,0
AlliedRace-UnlockingFrame-ModelBackground-Nightborne,6724,922,314,578,317,631,1,579,10714,0,0,0,0
AlliedRace-UnlockingFrame-ModelBackground-Voidelf,6725,922,314,578,633,947,1,579,10715,0,0,0,0
AlliedRace-Crest-Highmountain,6726,923,64,64,1,65,1,65,10716,0,0,0,0
AlliedRace-Crest-Lightforge,6727,923,64,64,67,131,1,65,10717,0,0,0,0
AlliedRace-Crest-Nightborne,6728,923,64,64,133,197,1,65,10718,0,0,0,0
AlliedRace-Crest-Voidelf,6729,923,64,64,1,65,67,131,10719,0,0,0,0
FlightMaster_VindicaarArgus-Taxi_Frame_Gray,6732,905,74,79,1,75,1,80,10721,0,0,0,0
FlightMaster_VindicaarArgus-Taxi_Frame_Green,6733,905,74,79,1,75,82,161,10722,0,0,0,0
FlightMaster_VindicaarArgus-Taxi_Frame_Yellow,6734,905,74,79,1,75,163,242,10723,0,0,0,0
FlightMaster_VindicaarMacAree-Taxi_Frame_Gray,6735,905,74,79,77,151,1,80,10724,0,0,0,0
FlightMaster_VindicaarMacAree-Taxi_Frame_Green,6736,905,74,79,77,151,82,161,10725,0,0,0,0
FlightMaster_VindicaarMacAree-Taxi_Frame_Yellow,6737,905,74,79,77,151,163,242,10728,0,0,0,0
FlightMaster_VindicaarStygianWake-Taxi_Frame_Gray,6738,905,74,79,153,227,1,80,10729,0,0,0,0
FlightMaster_VindicaarStygianWake-Taxi_Frame_Green,6739,905,74,79,153,227,82,161,10730,0,0,0,0
FlightMaster_VindicaarStygianWake-Taxi_Frame_Yellow,6740,905,74,79,153,227,163,242,10731,0,0,0,0
Relic-Rankdisable-DarkGlow,6741,906,151,150,472,623,175,325,10732,0,0,0,0
ArtifactsFX-PointSideBurstLeft-Purple,6756,906,33,35,986,1019,656,691,10436,0,0,0,0
ArtifactsFX-PointSideBurstRight-Purple,6757,906,33,35,799,832,721,756,10437,0,0,0,0
ArtifactsFX-SpinningGlowys-Purple,6758,906,70,70,895,965,580,650,10438,0,0,0,0
ArtifactsFX-StarBurst-Purple,6759,906,133,133,472,605,327,460,10439,0,0,0,0
ArtifactsFX-Whirls-Purple,6760,906,76,76,686,762,498,574,10440,0,0,0,0
ArtifactsFX-YellowRing-Purple,6761,906,50,50,739,789,917,967,10441,0,0,0,0
AdventureMap_TileBg_Parchment,6762,925,512,512,0,512,0,512,10733,0,0,6,0
_GarrMissionLocation-Argus-Mid,6763,926,1024,285,0,1024,1,286,10734,0,0,4,0
GarrMissionLocation-Argus-List,6764,832,792,78,1,793,561,639,10735,0,0,0,0
Darktrait-border-selected,6769,906,80,80,898,978,327,407,10736,0,0,0,0
Lighttrait-border-selected,6771,906,80,80,522,602,498,578,10737,0,0,0,0
Neutralstone1,6772,906,52,43,967,1019,278,321,10738,0,0,0,0
Neutralstone2,6773,906,27,29,522,549,990,1019,10739,0,0,0,0
Neutralstone3,6774,906,29,39,992,1021,88,127,10740,0,0,0,0
Neutralstone4,6775,906,43,35,425,468,819,854,10741,0,0,0,0
Neutralstone5,6776,906,31,44,992,1023,1,45,10742,0,0,0,0
Neutralstone6,6777,906,47,40,739,786,969,1009,10743,0,0,0,0
Neutralstone7,6778,906,27,26,986,1013,693,719,10744,0,0,0,0
Neutraltrait-border-selected,6779,906,80,80,604,684,498,578,10745,0,0,0,0
Neutraltrait-border,6780,906,56,54,928,984,656,710,10746,0,0,0,0
poi-door-down,6781,647,25,24,86,111,67,91,10442,0,0,0,0
poi-door-left,6782,647,25,24,113,138,67,91,10443,0,0,0,0
poi-door-right,6783,647,25,24,140,165,67,91,10444,0,0,0,0
poi-door-up,6784,647,25,24,167,192,67,91,10445,0,0,0,0
QuestBG-TheHandofFate,6786,843,299,407,603,902,1,408,10486,0,0,0,0
splash-730-botleft,6787,927,137,371,374,511,587,958,10747,0,0,0,0
splash-730-right,6788,927,510,584,1,511,1,585,10748,0,0,0,0
splash-730-topleft,6789,927,371,434,1,372,587,1021,10749,0,0,0,0
Neutraltrait-backglow,6790,906,170,169,820,990,1,170,10750,0,0,0,0
Neutraltrait-Glow,6791,906,74,74,819,893,580,654,10751,0,0,0,0
AftLevelup-NeutralStarBurst,6792,906,124,123,607,731,327,450,10752,0,0,0,0
AftLevelup-PurpleStarBurst,6793,906,133,133,778,911,175,308,10447,0,0,0,0
Artifacts-PerkRing-NeutralGlow,6794,906,50,50,898,948,409,459,10448,0,0,0,0
Artifacts-PerkRing-PurpleGlow,6795,906,50,50,950,1000,409,459,10449,0,0,0,0
ArtifactsFX-Whirls-Neutral,6796,906,67,76,667,734,734,810,10450,0,0,0,0
ArtifactsFX-YellowRing-Neutral,6797,906,50,50,739,789,865,915,10451,0,0,0,0
Rune-01-neutral,6798,906,67,72,667,734,812,884,10452,0,0,0,0
Rune-01-purple,6799,906,75,77,764,839,498,575,10453,0,0,0,0
Rune-02-neutral,6800,906,75,64,264,339,958,1022,10454,0,0,0,0
Rune-02-purple,6801,906,75,77,841,916,498,575,10455,0,0,0,0
Rune-03-neutral,6802,906,70,76,667,737,656,732,10456,0,0,0,0
Rune-03-purple,6803,906,75,77,918,993,498,575,10457,0,0,0,0
Rune-04-neutral,6804,906,60,77,599,659,920,997,10458,0,0,0,0
Rune-04-purple,6805,906,75,77,522,597,580,657,10459,0,0,0,0
Rune-05-neutral,6806,906,52,74,967,1019,580,654,10460,0,0,0,0
Rune-05-purple,6807,906,75,77,522,597,659,736,10461,0,0,0,0
Rune-06-neutral,6808,906,58,72,739,797,721,793,10462,0,0,0,0
Rune-06-purple,6809,906,75,77,522,597,738,815,10463,0,0,0,0
GarrMission_ClassIcon-Voidscarred,6816,823,55,49,58,113,52,101,10464,0,0,0,0
GarrMission_ClassIcon-ArgussianReach,6817,823,55,49,1,56,460,509,10465,0,0,0,0
GarrMission_ClassIcon-ArmyoftheLight,6818,823,55,49,58,113,103,152,10466,0,0,0,0
AntoranWastes_Highlight,6819,928,512,512,0,512,0,512,10477,0,0,6,0
Relicforge-Relicsbackground-Previewtraits,6824,929,412,387,1,413,1,388,10467,0,0,0,0
Relicforge-Slot-frame-Active,6825,929,67,67,415,482,1,68,10468,0,0,0,0
Krokuun_Highlight,6826,930,768,512,1,769,0,512,10469,0,0,2,0
MacAree_Highlight,6829,933,768,512,1,769,0,512,10470,0,0,2,0
FlightMaster_Argus-Taxi_Frame_Green,6830,905,64,54,361,425,1,55,10478,0,0,0,0
BrokenIslesHightlight,6869,939,413,413,1,414,1,414,10446,0,0,0,0
hud-MainMenuBar-arrowdown-disabled,6870,940,21,19,1,22,22,41,6236,0,0,0,0
hud-MainMenuBar-arrowdown-down,6871,940,21,19,1,22,1,20,6237,0,0,0,0
hud-MainMenuBar-arrowdown-highlight,6872,940,21,19,1,22,43,62,6238,0,0,0,0
hud-MainMenuBar-arrowdown-up,6873,940,21,19,1,22,127,146,6239,0,0,0,0
hud-MainMenuBar-arrowup-disabled,6874,940,21,19,1,22,106,125,6240,0,0,0,0
hud-MainMenuBar-arrowup-down,6875,940,21,19,1,22,148,167,6241,0,0,0,0
hud-MainMenuBar-arrowup-highlight,6876,940,21,19,1,22,64,83,6242,0,0,0,0
hud-MainMenuBar-arrowup-up,6877,940,21,19,1,22,85,104,6243,0,0,0,0
hud-MainMenuBar-gryphon,6880,940,128,76,84,212,49,125,6244,0,0,0,0
AlliedRace-UnlockingFrame-ModelFrame,6882,941,328,589,1,329,1,590,10471,0,0,0,0
AlliedRace-UnlockingFrame-RaceBanner,6883,941,130,584,331,461,1,585,10472,0,0,0,0
AlliedRace-UnlockingFrame-ModelBackground-Lightforge,6884,942,314,578,1,315,1,579,10473,0,0,0,0
shop-card-half-brownbox,6891,943,286,471,1,287,1,472,10481,0,0,0,0
shop-card-half-brownboxlegionbundle,6892,943,286,471,289,575,1,472,10482,0,0,0,0
shop-card-half-legion,6895,944,286,471,1,287,1,472,10485,0,0,0,0
shop-card-half-legiondeluxe,6896,944,286,471,289,575,1,472,10487,0,0,0,0
shop-card-full-legiondeluxe,6897,945,568,463,1,569,1,464,10488,0,0,0,0
hud-MainMenuBar-experiencebar-large-double,6898,940,804,14,54,858,33,47,6015,0,0,0,0
hud-MainMenuBar-experiencebar-large-single,6899,940,804,14,24,828,1,15,6016,0,0,0,0
hud-MainMenuBar-experiencebar-small-double,6900,940,550,14,54,604,17,31,6020,0,0,0,0
hud-MainMenuBar-experiencebar-small-single,6901,940,550,14,214,764,49,63,6021,0,0,0,0
hud-MainMenuBar-large,6902,940,804,49,214,1018,65,114,6022,0,0,0,0
hud-MainMenuBar-small,6903,940,550,49,244,794,116,165,6023,0,0,0,0
shop-card-half-hover,6908,946,278,463,1,279,1,464,10474,0,0,0,0
hud-microbutton-LFG-Up,6909,940,28,36,114,142,203,239,6029,0,0,0,0
hud-microbutton-Achievement-Disabled,6910,940,28,36,84,112,127,163,6344,0,0,0,0
hud-microbutton-LFG-Down,6911,940,28,36,214,242,192,228,6345,0,0,0,0
hud-microbutton-BStore-Down,6912,940,28,36,24,52,55,91,6346,0,0,0,0
hud-microbutton-Socials-Disabled,6913,940,28,36,214,242,116,152,6347,0,0,0,0
hud-microbutton-MainMenu-Up,6914,940,28,36,174,202,203,239,6348,0,0,0,0
hud-microbutton-Quest-Disabled,6915,940,28,36,114,142,165,201,6349,0,0,0,0
hud-microbutton-Achievement-Down,6916,940,28,36,84,112,165,201,6350,0,0,0,0
hud-microbutton-BStore-Up,6917,940,28,36,24,52,93,129,6351,0,0,0,0
hud-microbutton-Quest-Up,6918,940,28,36,826,854,116,152,6352,0,0,0,0
hud-microbutton-Quest-Down,6919,940,28,36,214,242,154,190,6353,0,0,0,0
hud-microbutton-Spellbook-Down,6920,940,28,36,24,52,169,205,6354,0,0,0,0
hud-microbutton-EJ-Down,6921,940,28,36,174,202,127,163,6355,0,0,0,0
hud-microbutton-Socials-Up,6922,940,28,36,886,914,116,152,6356,0,0,0,0
hud-microbutton-LFG-Disabled,6923,940,28,36,174,202,165,201,6357,0,0,0,0
hud-microbutton-StreamDL-Up,6924,940,28,36,946,974,116,152,6358,0,0,0,0
hud-microbutton-Character-Down,6925,940,28,36,54,82,49,85,6359,0,0,0,0
hud-microbutton-StreamDL-Down,6926,940,28,36,54,82,163,199,6360,0,0,0,0
hud-microbutton-MainMenu-Down,6927,940,28,36,24,52,207,243,6361,0,0,0,0
hud-microbutton-MainMenu-Disabled,6928,940,28,36,144,172,203,239,6362,0,0,0,0
hud-microbutton-Talents-Disabled,6929,940,28,36,916,944,116,152,6363,0,0,0,0
hud-microbutton-BStore-Disabled,6930,940,28,36,84,112,203,239,6364,0,0,0,0
hud-microbutton-Mounts-Disabled,6931,940,28,36,24,52,131,167,6365,0,0,0,0
hud-microbutton-Mounts-Up,6932,940,28,36,54,82,125,161,6366,0,0,0,0
hud-microbutton-Character-Up,6933,940,28,36,144,172,127,163,6367,0,0,0,0
hud-microbutton-Socials-Down,6934,940,28,36,796,824,116,152,6368,0,0,0,0
hud-microbutton-Spellbook-Up,6935,940,28,36,856,884,116,152,6369,0,0,0,0
hud-microbutton-Talents-Down,6936,940,28,36,976,1004,116,152,6370,0,0,0,0
hud-microbutton-Mounts-Down,6937,940,28,36,54,82,201,237,6371,0,0,0,0
hud-microbutton-EJ-Disabled,6938,940,28,36,54,82,87,123,6372,0,0,0,0
hud-microbutton-EJ-Up,6939,940,28,36,24,52,17,53,6373,0,0,0,0
hud-microbutton-Spellbook-Disabled,6940,940,28,36,244,272,167,203,6374,0,0,0,0
hud-microbutton-Talents-Up,6941,940,28,36,274,302,209,245,6375,0,0,0,0
hud-MicroBagBar,6942,940,298,88,309,607,167,255,6376,0,0,0,0
hud-microbutton-Achievement-Up,6943,940,28,36,114,142,127,163,6377,0,0,0,0
AlliedRaces-AllianceHordeBanner,6944,947,212,520,1,213,1,521,10690,0,0,0,0
loottoast-itemborder-gold,6946,332,58,58,869,927,181,239,10480,0,0,0,0
hud-microbutton-highlight,6947,940,28,36,244,272,205,241,6419,0,0,0,0
shop-card-bundle-hover,7015,971,284,201,295,579,1,202,10653,0,0,0,0
shop-card-bundle-legion,7016,971,292,158,1,293,212,370,10654,0,0,0,0
shop-card-bundle-reaver-argi,7017,971,292,145,581,873,1,146,10655,0,0,0,0
shop-card-bundle,7018,971,292,209,1,293,1,210,10656,0,0,0,0
shop-card-bundle-selected,7019,971,284,201,295,579,204,405,10657,0,0,0,0
raceicon-voidelf-male,7020,897,64,64,655,719,67,131,10475,0,0,0,0
raceicon-goblin-female,7021,897,64,64,391,455,331,395,10476,0,0,0,0
raceicon-nightborne-male,7022,897,64,64,523,587,1,65,10483,0,0,0,0
raceicon-lightforged-male,7023,897,64,64,457,521,331,395,10658,0,0,0,0
raceicon-nightborne-female,7024,897,64,64,457,521,397,461,10659,0,0,0,0
raceicon-highmountain-female,7025,897,64,64,457,521,1,65,10660,0,0,0,0
raceicon-voidelf-female,7026,897,64,64,589,653,67,131,10661,0,0,0,0
raceicon-lightforged-female,7027,897,64,64,457,521,265,329,10662,0,0,0,0
raceicon-bloodelf-female,7028,897,64,64,1,65,391,455,10663,0,0,0,0
raceicon-highmountain-male,7029,897,64,64,457,521,67,131,10664,0,0,0,0
bags-icon-addslots,7030,202,42,42,93,135,47,89,10665,0,0,0,0
shop-card-bundle-alteracpup-feydragon,7031,971,292,153,581,873,293,446,10666,0,0,0,0
shop-card-bundle-starseekers,7032,971,292,143,581,873,148,291,10667,0,0,0,0
bags-static,7033,202,178,43,1,179,93,136,10484,0,0,0,0
category-icon-ring,7043,654,74,74,149,223,123,197,10668,0,0,0,0
vas-receipt-icon-characterborder,7045,654,34,34,1,35,212,246,10489,0,0,0,0
warboard-header-alliance,7047,975,708,210,1,709,262,472,10491,0,0,0,0
warboard-header-horde,7048,975,638,240,353,991,474,714,10492,0,0,0,0
warboard-parchment-answerborder,7049,975,190,93,711,901,349,442,10493,0,0,0,0
warboard-parchment,7050,975,350,473,1,351,474,947,10494,0,0,0,0
warboard-title-alliance-left,7051,975,202,85,557,759,716,801,10495,0,0,0,0
warboard-title-alliance-right,7052,975,202,85,353,555,716,801,10496,0,0,0,0
warboard-title-horde-left,7053,975,202,85,711,913,262,347,10497,0,0,0,0
warboard-title-horde-right,7054,975,202,85,761,963,716,801,10498,0,0,0,0
warboard-title-neutral-left,7055,975,202,85,353,555,803,888,10499,0,0,0,0
warboard-title-neutral-right,7056,975,202,85,353,555,890,975,10500,0,0,0,0
_warboard-title-alliance-middle,7057,975,128,85,0,128,1,86,10501,0,0,4,0
_warboard-title-horde-middle,7058,975,128,85,0,128,175,260,10502,0,0,4,0
_warboard-title-neutral-middle,7059,975,128,85,0,128,88,173,10503,0,0,4,0
warboard-background,7060,976,597,502,1,598,1,503,10504,0,0,0,0
warboard-zone-classic-Ashenvale,7061,977,268,122,1,269,1,123,10505,0,0,0,0
warboard-zone-classic-Azshara,7062,977,268,122,271,539,1,123,10490,0,0,0,0
warboard-zone-classic-AzuremystIsle,7063,977,268,122,541,809,1,123,10506,0,0,0,0
warboard-zone-classic-BloodmystIsle,7064,977,268,122,1,269,125,247,10507,0,0,0,0
warboard-zone-classic-Darkshore,7065,977,268,122,271,539,125,247,10508,0,0,0,0
warboard-zone-classic-DunMorogh,7066,977,268,122,541,809,125,247,10509,0,0,0,0
warboard-zone-classic-Durotar,7067,977,268,122,1,269,249,371,10510,0,0,0,0
warboard-zone-classic-ElwynnForest,7068,977,268,122,271,539,249,371,10511,0,0,0,0
warboard-zone-classic-EversongWoods,7069,977,268,122,541,809,249,371,10512,0,0,0,0
warboard-zone-classic-Ghostlands,7070,977,268,122,1,269,373,495,10513,0,0,0,0
warboard-zone-classic-Gilneas,7071,977,268,122,271,539,373,495,10514,0,0,0,0
warboard-zone-classic-HillsbradFoothills,7072,977,268,122,541,809,373,495,10515,0,0,0,0
warboard-zone-classic-LochModan,7073,977,268,122,1,269,497,619,10516,0,0,0,0
warboard-zone-classic-LostIsles,7074,977,268,122,271,539,497,619,10764,0,0,0,0
warboard-zone-classic-Mulgore,7075,977,268,122,541,809,497,619,10765,0,0,0,0
warboard-zone-classic-NorthernBarrens,7076,977,268,122,1,269,621,743,10766,0,0,0,0
warboard-zone-classic-RedridgeMountains,7077,977,268,122,1,269,745,867,10767,0,0,0,0
warboard-zone-classic-SilverpineForest,7078,977,268,122,1,269,869,991,10768,0,0,0,0
warboard-zone-classic-SouthernBarrens,7079,977,268,122,271,539,621,743,10769,0,0,0,0
warboard-zone-classic-Teldrassil,7080,977,268,122,541,809,621,743,10770,0,0,0,0
warboard-zone-classic-TirisfalGlades,7081,977,268,122,271,539,745,867,10771,0,0,0,0
warboard-zone-classic-WanderingIsle,7082,977,268,122,271,539,869,991,10772,0,0,0,0
warboard-zone-classic-Westfall,7083,977,268,122,541,809,745,867,10773,0,0,0,0
warboard-zone-classic-ArathiHighlands,7084,978,268,122,1,269,1,123,10774,0,0,0,0
warboard-zone-classic-Badlands,7085,978,268,122,271,539,1,123,10775,0,0,0,0
warboard-zone-classic-BlastedLands,7086,978,268,122,541,809,1,123,10776,0,0,0,0
warboard-zone-classic-BurningSteppes,7087,978,268,122,1,269,125,247,10777,0,0,0,0
warboard-zone-classic-CapeofStranglethorn,7088,978,268,122,271,539,125,247,10778,0,0,0,0
warboard-zone-classic-Desolace,7089,978,268,122,541,809,125,247,10779,0,0,0,0
warboard-zone-classic-Duskwood,7090,978,268,122,1,269,249,371,10780,0,0,0,0
warboard-zone-classic-DustwallowMarsh,7091,978,268,122,271,539,249,371,10781,0,0,0,0
warboard-zone-classic-EasternPlaguelands,7092,978,268,122,541,809,249,371,10782,0,0,0,0
warboard-zone-classic-Felwood,7093,978,268,122,1,269,373,495,10783,0,0,0,0
warboard-zone-classic-Feralas,7094,978,268,122,271,539,373,495,10784,0,0,0,0
warboard-zone-classic-Hinterlands,7095,978,268,122,541,809,373,495,10785,0,0,0,0
warboard-zone-classic-NorthernStranglethorn,7096,978,268,122,1,269,497,619,10786,0,0,0,0
warboard-zone-classic-SearingGorge,7097,978,268,122,271,539,497,619,10787,0,0,0,0
warboard-zone-classic-Silithus,7098,978,268,122,541,809,497,619,10788,0,0,0,0
warboard-zone-classic-StonetalonMountains,7099,978,268,122,1,269,621,743,10789,0,0,0,0
warboard-zone-classic-SwampofSorrows,7100,978,268,122,1,269,745,867,10790,0,0,0,0
warboard-zone-classic-Tanaris,7101,978,268,122,1,269,869,991,10791,0,0,0,0
warboard-zone-classic-ThousandNeedles,7102,978,268,122,271,539,621,743,10792,0,0,0,0
warboard-zone-classic-UngoroCrater,7103,978,268,122,541,809,621,743,10793,0,0,0,0
warboard-zone-classic-WesternPlaguelands,7104,978,268,122,271,539,745,867,10794,0,0,0,0
warboard-zone-classic-Wetlands,7105,978,268,122,271,539,869,991,10795,0,0,0,0
warboard-zone-classic-Winterspring,7106,978,268,122,541,809,745,867,10796,0,0,0,0
warboard-zone-bc-BladesEdgeMountains,7107,979,268,122,1,269,1,123,10797,0,0,0,0
warboard-zone-bc-HellfirePeninsula,7108,979,268,122,271,539,1,123,10798,0,0,0,0
warboard-zone-bc-IsleofQuelDanas,7109,979,268,122,541,809,1,123,10799,0,0,0,0
warboard-zone-bc-Nagrand,7110,979,268,122,1,269,125,247,10800,0,0,0,0
warboard-zone-bc-Netherstorm,7111,979,268,122,1,269,249,371,10801,0,0,0,0
warboard-zone-bc-ShadowmoonValley,7112,979,268,122,1,269,373,495,10802,0,0,0,0
warboard-zone-bc-TerokkarForest,7113,979,268,122,271,539,125,247,10803,0,0,0,0
warboard-zone-bc-Zangarmarsh,7114,979,268,122,541,809,125,247,10804,0,0,0,0
warboard-zone-wotlk-BoreanTundra,7115,980,268,122,1,269,1,123,10805,0,0,0,0
warboard-zone-wotlk-CrystalsongForest,7116,980,268,122,271,539,1,123,10806,0,0,0,0
warboard-zone-wotlk-Dalaran,7117,980,268,122,541,809,1,123,10807,0,0,0,0
warboard-zone-wotlk-Dragonblight,7118,980,268,122,1,269,125,247,10808,0,0,0,0
warboard-zone-wotlk-GrizzlyHills,7119,980,268,122,1,269,249,371,10809,0,0,0,0
warboard-zone-wotlk-HowlingFjord,7120,980,268,122,1,269,373,495,10810,0,0,0,0
warboard-zone-wotlk-Icecrown,7121,980,268,122,271,539,125,247,10811,0,0,0,0
warboard-zone-wotlk-SholazarBasin,7122,980,268,122,541,809,125,247,10812,0,0,0,0
warboard-zone-wotlk-StormPeaks,7123,980,268,122,271,539,249,371,10813,0,0,0,0
warboard-zone-wotlk-ZulDrak,7124,980,268,122,271,539,373,495,10814,0,0,0,0
warboard-zone-cata-TwilightHighlands,7125,981,268,122,1,269,1,123,10815,0,0,0,0
warboard-zone-cata-Deepholm,7126,981,268,122,271,539,1,123,10816,0,0,0,0
warboard-zone-cata-MountHyjal,7127,981,268,122,541,809,1,123,10817,0,0,0,0
warboard-zone-cata-ElementalBonds,7128,981,268,122,1,269,125,247,10818,0,0,0,0
warboard-zone-cata-Vashjir,7129,981,268,122,1,269,249,371,10819,0,0,0,0
warboard-zone-cata-MoltenFront,7130,981,268,122,1,269,373,495,10820,0,0,0,0
warboard-zone-cata-Uldum,7131,981,268,122,271,539,125,247,10821,0,0,0,0
warboard-zone-mop-DreadWastes,7132,982,268,122,1,269,1,123,10822,0,0,0,0
warboard-zone-mop-IsleofGiants,7133,982,268,122,271,539,1,123,10823,0,0,0,0
warboard-zone-mop-IsleoftheThunderKing,7134,982,268,122,541,809,1,123,10824,0,0,0,0
warboard-zone-mop-JadeForest,7135,982,268,122,1,269,125,247,10825,0,0,0,0
warboard-zone-mop-KrasarangWilds,7136,982,268,122,1,269,249,371,10826,0,0,0,0
warboard-zone-mop-KunLaiSummit,7137,982,268,122,1,269,373,495,10827,0,0,0,0
warboard-zone-mop-TimelessIsle,7138,982,268,122,271,539,125,247,10828,0,0,0,0
warboard-zone-mop-TownlongSteppes,7139,982,268,122,541,809,125,247,10829,0,0,0,0
warboard-zone-mop-ValeofEternalBlossoms,7140,982,268,122,271,539,249,371,10830,0,0,0,0
warboard-zone-mop-ValleyoftheFourWinds,7141,982,268,122,271,539,373,495,10831,0,0,0,0
warboard-zone-wod-FrostfireRidge,7142,983,268,122,1,269,1,123,10832,0,0,0,0
warboard-zone-wod-Gorgrond,7143,983,268,122,271,539,1,123,10833,0,0,0,0
warboard-zone-wod-Nagrand,7144,983,268,122,541,809,1,123,10834,0,0,0,0
warboard-zone-wod-ShadowmoonValley,7145,983,268,122,1,269,125,247,10835,0,0,0,0
warboard-zone-wod-SpiresofArak,7146,983,268,122,1,269,249,371,10836,0,0,0,0
warboard-zone-wod-Talador,7147,983,268,122,1,269,373,495,10837,0,0,0,0
warboard-zone-wod-TanaanJungle,7148,983,268,122,271,539,125,247,10838,0,0,0,0
warboard-zone-wod-TanaanJungleIntro,7149,983,268,122,541,809,125,247,10753,0,0,0,0
AzeriteReady,7152,647,32,32,32,64,304,336,10762,0,0,0,0
AzeriteSpawning,7153,647,32,32,32,64,338,370,10763,0,0,0,0
splash-735-botleft,7154,984,137,371,374,511,587,958,10754,0,0,0,0
splash-735-right,7155,984,510,584,1,511,1,585,10755,0,0,0,0
splash-735-topleft,7156,984,371,434,1,372,587,1021,10756,0,0,0,0
shop-card-full-bfadeluxe,7174,986,568,463,1,569,1,464,10757,0,0,0,0
accountupgradebanner-bfa,7175,986,200,134,571,771,162,296,10758,0,0,0,0
shop-card-half-brownboxbfabundle,7176,987,286,471,289,575,1,472,10759,0,0,0,0
shop-card-half-bfadeluxe,7177,987,286,471,1,287,474,945,10760,0,0,0,0
shop-card-half-bfa,7178,987,286,471,1,287,1,472,10761,0,0,0,0
hud-microbutton-highlightalert,7209,940,33,40,274,307,167,207,6556,0,0,0,0
communities-icon-notification,7365,1017,24,24,227,251,485,509,6651,0,0,0,0
communities-create-button-bnet-down,7484,1017,116,67,713,829,1,68,6920,0,0,0,0
communities-create-button-bnet-up,7485,1017,116,67,616,732,99,166,6921,0,0,0,0
communities-create-button-highlight,7486,1017,132,70,343,475,339,409,6922,0,0,0,0
communities-create-button-wow-down,7487,1017,132,70,477,609,339,409,6923,0,0,0,0
communities-create-button-wow-up,7488,1017,132,70,343,475,411,481,6924,0,0,0,0
communities-create-avatar-border-hover,7489,1017,64,64,734,798,99,163,6928,0,0,0,0
communities-create-avatar-border-selected,7490,1017,64,64,800,864,99,163,6929,0,0,0,0
communities-ring-blue,7491,1017,95,96,477,572,411,507,6930,0,0,0,0
communities-ring-gold,7492,1017,95,96,616,711,1,97,6931,0,0,0,0
alliance_icon_and_flag-dynamicIcon,7631,1018,32,32,1,33,199,231,6946,0,0,0,0
alliance_icon_and_flag-flash,7632,1018,32,32,67,99,199,231,6940,0,0,0,0
alliance_icon_and_flag-icon,7633,1018,64,64,1,65,1,65,6943,0,0,0,0
alliance_icon_horde_flag-dynamicIcon,7634,1018,32,32,133,165,199,231,6974,0,0,0,0
alliance_icon_horde_flag-flash,7635,1018,32,32,199,231,199,231,6975,0,0,0,0
alliance_icon_horde_flag-icon,7636,1018,64,64,1,65,67,131,6976,0,0,0,0
alliance_tower-icon,7637,1018,32,32,331,363,1,33,6977,0,0,0,0
coin-icon,7638,1018,64,64,1,65,133,197,6978,0,0,0,0
combat_swords-dynamicIcon,7639,1018,64,64,67,131,1,65,6944,0,0,0,0
combat_swords-flash,7640,1018,64,64,67,131,67,131,6935,0,0,0,0
combat_swords-icon,7641,1018,64,64,67,131,133,197,6934,0,0,0,0
dreadlord-icon,7642,1018,64,64,133,197,1,65,6936,0,0,0,0
horde_icon_alliance_flag-dynamicIcon,7643,1018,32,32,365,397,1,33,6979,0,0,0,0
horde_icon_alliance_flag-flash,7644,1018,32,32,399,431,1,33,6980,0,0,0,0
horde_icon_alliance_flag-icon,7645,1018,64,64,133,197,67,131,6973,0,0,0,0
horde_icon_and_flag-dynamicIcon,7646,1018,32,32,433,465,1,33,6941,0,0,0,0
horde_icon_and_flag-flash,7647,1018,32,32,467,499,1,33,6942,0,0,0,0
horde_icon_and_flag-icon,7648,1018,64,64,133,197,133,197,6945,0,0,0,0
horde_tower-icon,7649,1018,32,32,265,297,67,99,6981,0,0,0,0
neutral_tower-icon,7650,1018,32,32,265,297,101,133,6937,0,0,0,0
placeholder-icon,7651,1018,64,64,199,263,1,65,6933,0,0,0,0
pvp_ffa-icon,7652,1018,64,64,199,263,67,131,6939,0,0,0,0
skull_bones-icon,7653,1018,64,64,199,263,133,197,6938,0,0,0,0
sniper_shot-icon,7654,1018,64,64,265,329,1,65,6932,0,0,0,0
communities-create-button-wow-alliance,7707,1017,22,28,261,283,483,511,6998,0,0,0,0
communities-create-button-wow-horde,7708,1017,22,28,287,309,451,479,6999,0,0,0,0
communities-icon-addgroupplus,7719,1017,64,64,866,930,99,163,7010,0,0,0,0
communities-icon-lock,7720,1017,24,30,261,285,451,481,7011,0,0,0,0
communities-icon-invitemail,7743,1017,114,110,227,341,339,449,7036,0,0,0,0
communities-widebackground,7744,1017,613,336,1,614,1,337,7037,0,0,0,0
macropopup-bottomright-nobuttons,7950,873,18,39,81,99,213,252,7219,0,0,0,0
macropopup-intersect-left,7951,873,18,17,41,59,228,245,7220,0,0,0,0
macropopup-intersect-right,7952,873,18,17,61,79,228,245,7221,0,0,0,0
macropopup-topleft2,7953,873,18,54,41,59,172,226,7222,0,0,0,0
macropopup-topright2,7954,873,18,54,61,79,172,226,7223,0,0,0,0
_macropopup-top2,7955,873,256,17,0,256,112,129,7224,0,0,4,0
communities-chat-date-line-orange,8211,1017,256,8,692,948,178,186,7478,0,0,0,0
communities-chat-date-line,8212,1017,256,8,692,948,168,176,7479,0,0,0,0
communities-guildbanner-background,8334,1017,74,69,949,1023,1,70,7565,0,0,0,0
communities-guildbanner-border,8335,1017,74,69,616,690,168,237,7566,0,0,0,0
communities-nav-button-green-normal,8338,1017,224,80,1,225,339,419,7569,0,0,0,0
communities-nav-button-green-pressed,8339,1017,224,80,1,225,421,501,7570,0,0,0,0
hud-microbutton-Guild-Banner,8403,940,28,36,144,172,165,201,7632,0,0,0,0
communities-icon-chat,8409,1017,64,64,932,996,99,163,7638,0,0,0,0
communities-icon-addchannelplus,8417,1017,32,32,227,259,451,483,7646,0,0,0,0
communities-create-button-bnet-highlight,8418,1017,116,67,831,947,1,68,7647,0,0,0,0
communities-icon-redx,8419,1017,24,24,311,335,451,475,7648,0,0,0,0
hud-microbutton-communities-icon-notification,8420,940,36,36,609,645,167,203,7649,0,0,0,0
guildfinder-card-guildbanner-background,8790,1428,246,168,181,427,82,250,7877,0,0,0,0
guildfinder-card-guildbanner-border,8791,1428,246,168,181,427,252,420,7878,0,0,0,0
guildfinder-card-guildbanner-shadow,8792,1428,246,168,429,675,82,250,7879,0,0,0,0
guildfinder-card,8793,1428,178,264,1,179,1,265,7880,0,0,0,0
chatframe-button-down,8883,924,27,26,100,127,1,27,10839,0,0,0,0
chatframe-button-highlight,8884,924,27,26,95,122,66,92,10840,0,0,0,0
chatframe-button-highlightalert,8885,924,34,32,1,35,1,33,10841,0,0,0,0
chatframe-button-icon-headset,8886,924,29,29,69,98,1,30,10842,0,0,0,0
chatframe-button-icon-mic-off,8887,924,29,29,1,30,35,64,10843,0,0,0,0
chatframe-button-icon-mic-on,8888,924,29,29,1,30,66,95,10844,0,0,0,0
chatframe-button-icon-mic-silenced-off,8889,924,29,29,32,61,35,64,10845,0,0,0,0
chatframe-button-icon-mic-silenced,8890,924,29,29,1,30,97,126,10846,0,0,0,0
chatframe-button-icon-speaker-off,8891,924,29,29,32,61,66,95,10847,0,0,0,0
chatframe-button-icon-speaker-on,8892,924,29,29,32,61,97,126,10848,0,0,0,0
chatframe-button-icon-speaker-silenced,8893,924,29,29,63,92,35,64,10849,0,0,0,0
chatframe-button-icon-voicechat,8894,924,29,29,94,123,35,64,10850,0,0,0,0
chatframe-button-up,8895,924,27,26,63,90,94,120,10851,0,0,0,0
chatframe-scrollbar-knob,8896,924,21,19,92,113,94,113,10852,0,0,0,0
voicechat-channellist-category-background,8897,1442,173,20,307,480,1,21,10853,0,0,0,0
voicechat-channellist-category-highlight,8898,1442,117,16,307,424,35,51,10854,0,0,0,0
voicechat-channellist-category-minus,8899,1442,7,7,504,511,1,8,10855,0,0,0,0
voicechat-channellist-category-plus,8900,1442,7,7,504,511,10,17,10856,0,0,0,0
voicechat-channellist-icon-headphone-off,8901,1442,42,42,87,129,201,243,10857,0,0,0,0
voicechat-channellist-icon-headphone-on,8902,1442,42,42,153,195,201,243,10858,0,0,0,0
voicechat-channellist-row-background,8903,1442,20,20,482,502,1,21,10859,0,0,0,0
voicechat-channellist-row-background2,8904,1442,20,20,48,68,235,255,10860,0,0,0,0
voicechat-channellist-row-highlight,8905,1442,304,32,1,305,1,33,10861,0,0,0,0
voicechat-channellist-row-selected,8906,1442,304,32,1,305,35,67,10862,0,0,0,0
voicechat-icon-headphone-off,8907,1442,64,64,1,65,135,199,10863,0,0,0,0
voicechat-icon-headphone-on,8908,1442,64,64,87,151,69,133,10864,0,0,0,0
voicechat-icon-headphone-pending,8909,1442,64,64,87,151,135,199,10865,0,0,0,0
voicechat-icon-headphone-pendingdot-1,8910,1442,64,64,153,217,69,133,10866,0,0,0,0
voicechat-icon-headphone-pendingdot-2,8911,1442,64,64,153,217,135,199,10867,0,0,0,0
voicechat-icon-headphone-pendingdot-3,8912,1442,64,64,219,283,69,133,10868,0,0,0,0
voicechat-icon-headphone-switch,8913,1442,84,64,1,85,69,133,10869,0,0,0,0
voicechat-icon-loudnessbar-1,8914,1442,32,32,48,80,201,233,10870,0,0,0,0
voicechat-icon-loudnessbar-2,8915,1442,32,32,219,251,223,255,10871,0,0,0,0
voicechat-icon-loudnessbar-3,8916,1442,32,32,285,317,69,101,10872,0,0,0,0
voicechat-icon-mic-mute,8917,1442,32,32,285,317,137,169,10873,0,0,0,0
voicechat-icon-mic-mutesilenced,8918,1442,32,32,285,317,171,203,10874,0,0,0,0
voicechat-icon-mic-silenced,8919,1442,32,32,285,317,205,237,10875,0,0,0,0
voicechat-icon-mic,8920,1442,32,32,285,317,103,135,10876,0,0,0,0
voicechat-icon-speaker-mute,8921,1442,32,32,319,351,103,135,10877,0,0,0,0
voicechat-icon-speaker-mutesilenced,8922,1442,32,32,319,351,137,169,10878,0,0,0,0
voicechat-icon-speaker-silenced,8923,1442,32,32,319,351,171,203,10879,0,0,0,0
voicechat-icon-speaker,8924,1442,32,32,319,351,69,101,10880,0,0,0,0
voicechat-icon-textchat-silenced,8925,1442,32,32,319,351,205,237,10881,0,0,0,0
voicechat-portrait-drag,8926,1442,16,16,426,442,35,51,10882,0,0,0,0
voicechat-portrait-ring,8927,1442,45,45,1,46,201,246,10883,0,0,0,0
communitiesfinder-card,8946,1428,570,71,429,999,252,323,10902,0,0,0,0
battlefieldminimap-border-bottom,9010,1449,208,16,1,209,20,36,10966,0,0,0,0
battlefieldminimap-border-bottomleft,9011,1449,16,16,211,227,20,36,10967,0,0,0,0
battlefieldminimap-border-bottomright,9012,1449,16,16,229,245,20,36,10968,0,0,0,0
battlefieldminimap-border-left,9013,1449,16,134,1,17,38,172,10969,0,0,0,0
battlefieldminimap-border-right,9014,1449,16,134,19,35,38,172,10970,0,0,0,0
battlefieldminimap-border-top,9015,1449,208,17,1,209,1,18,10971,0,0,0,0
battlefieldminimap-border-topleft,9016,1449,16,17,211,227,1,18,10972,0,0,0,0
battlefieldminimap-border-topright,9017,1449,16,17,229,245,1,18,10973,0,0,0,0
auctionhouse-background-auctions,9539,1499,595,314,370,965,1,315,11464,0,0,0,0
auctionhouse-background-buy-commodities-market,9540,1499,221,396,1,222,399,795,11465,0,0,0,0
auctionhouse-background-buy-commodities,9541,1499,367,396,1,368,1,397,11466,0,0,0,0
auctionhouse-background-buy-noncommodities-header,9542,1499,617,81,967,1584,1,82,11467,0,0,0,0
auctionhouse-background-buy-noncommodities-market,9543,1499,595,277,370,965,732,1009,11468,0,0,0,0
auctionhouse-background-categories,9544,1499,138,433,224,362,399,832,11469,0,0,0,0
auctionhouse-background-index,9545,1499,595,413,370,965,317,730,11470,0,0,0,0
auctionhouse-background-sell-left,9546,1499,357,437,1508,1865,317,754,11471,0,0,0,0
auctionhouse-background-sell-right,9547,1499,399,418,1107,1506,317,735,11472,0,0,0,0
communitiesfinder_card_highlight,9624,1428,578,79,181,759,1,80,11538,0,0,0,0
auctionhouse-background-summarylist,9738,1499,138,433,967,1105,317,750,11645,0,0,0,0
CGuy_AOI,9862,1545,32,32,199,231,1,33,11771,0,0,0,0
CGuy_AOIAsset,9863,1545,32,32,1,33,199,231,11772,0,0,0,0
CGuy_Arrow,9864,1545,64,64,1,65,1,65,11773,0,0,0,0
CGuy_BottomArrow,9865,1545,16,16,233,249,1,17,11774,0,0,0,0
CGuy_BottomArrowHighlight,9866,1545,16,16,199,215,35,51,11775,0,0,0,0
CGuy_ConfigReplace,9867,1545,32,32,101,133,67,99,11776,0,0,0,0
CGuy_Control,9868,1545,32,32,135,167,67,99,11777,0,0,0,0
CGuy_ControlDefaults,9869,1545,32,32,169,201,67,99,11778,0,0,0,0
CGuy_Export,9870,1545,32,32,203,235,67,99,11779,0,0,0,0
CGuy_GafferPushed,9871,1545,64,64,67,131,1,65,11780,0,0,0,0
CGuy_GafferUp,9872,1545,64,64,133,197,1,65,11781,0,0,0,0
CGuy_Import,9873,1545,32,32,67,99,135,167,11782,0,0,0,0
CGuy_New,9874,1545,32,32,67,99,169,201,11783,0,0,0,0
CGuy_NewConfig,9875,1545,32,32,67,99,203,235,11784,0,0,0,0
CGuy_Path,9876,1545,16,16,217,233,35,51,11785,0,0,0,0
CGuy_Pause,9877,1545,64,64,1,65,67,131,11786,0,0,0,0
CGuy_Play,9878,1545,32,32,101,133,101,133,11787,0,0,0,0
CGuy_Point,9879,1545,16,16,235,251,35,51,11788,0,0,0,0
CGuy_Record,9880,1545,32,32,135,167,101,133,11789,0,0,0,0
CGuy_Rename,9881,1545,64,64,1,65,133,197,11790,0,0,0,0
CGuy_Replace,9882,1545,32,32,203,235,101,133,11791,0,0,0,0
CGuy_Stop,9883,1545,32,32,101,133,135,167,11792,0,0,0,0
CGuy_TopArrow,9884,1545,16,16,1,17,233,249,11793,0,0,0,0
CGuy_TopArrowHighlight,9885,1545,16,16,35,51,199,215,11794,0,0,0,0
CGuy_AOIFollowsCamera,9886,1545,32,32,67,99,67,99,11795,0,0,0,0
CGuy_FixedTimeStep,9887,1545,32,32,67,99,101,133,11796,0,0,0,0
CGuy_ReorientToUnit,9888,1545,32,32,169,201,101,133,11797,0,0,0,0
CGuy_AOIFollowsCameraActive,10029,1545,32,32,101,133,169,201,11930,0,0,0,0
CGuy_CalcOrientation,10030,1545,32,32,101,133,203,235,11931,0,0,0,0
CGuy_FixedTimeStepActive,10031,1545,32,32,135,167,135,167,11932,0,0,0,0
CGuy_PlayActive,10032,1545,32,32,169,201,135,167,11933,0,0,0,0
CGuy_RecordActive,10033,1545,32,32,203,235,135,167,11934,0,0,0,0
CGuy_ReorientToUnitActive,10034,1545,32,32,135,167,169,201,11935,0,0,0,0
CGuy_StopActive,10035,1545,32,32,135,167,203,235,11936,0,0,0,0
bar-end,10667,1637,15,18,200,215,627,645,12728,0,0,0,0
cast-bar-end,10668,1637,15,25,183,198,627,652,12729,0,0,0,0
health-bar-end,10669,1637,15,35,227,242,655,690,12730,0,0,0,0
health_end,10670,1637,6,18,242,248,204,222,12731,0,0,0,0
metal-bar,10672,1637,239,80,1,240,184,264,12733,0,0,0,0
portrait-frame-nameplate,10673,1637,50,50,133,183,787,837,12734,0,0,0,0
portrait-frame,10674,1637,119,119,131,250,348,467,12735,0,0,0,0
trinket-frame,10675,1637,65,65,183,248,560,625,12736,0,0,0,0
_bar-mid,10676,1637,15,18,0,15,134,152,12737,0,0,4,0
_cast-bar-mid,10677,1637,15,25,0,15,87,112,12738,0,0,4,0
_health-bar-mid,10678,1637,15,35,0,15,50,85,12739,0,0,4,0
cast-bar-fill-end,10708,1637,6,8,242,248,224,232,12824,0,0,0,0
portrait-frame-color,10710,1637,79,79,175,254,478,557,12826,0,0,0,0
_cast-bar-fill-mid,10711,1637,6,8,0,6,174,182,12827,0,0,4,0
armor-fill-end,10714,1637,7,18,242,249,184,202,12830,0,0,0,0
flag-1,10715,1637,64,64,155,219,709,773,12831,0,0,0,0
flag-2,10716,1637,64,64,1,65,787,851,12832,0,0,0,0
icon-healer,10717,1637,64,64,1,65,919,983,12833,0,0,0,0
icon-tank,10718,1637,64,64,67,131,787,851,12834,0,0,0,0
_armor-fill-mid,10719,1637,8,18,0,8,114,132,12835,0,0,4,0
_health_mid,10720,1637,5,18,0,5,154,172,12836,0,0,4,0
commentatorspellborder,10721,1637,50,50,175,225,655,705,12837,0,0,0,0
frame-timer,10735,1637,118,52,1,119,655,707,15686,0,0,0,0
healing-bg,10736,1637,75,76,1,76,709,785,15687,0,0,0,0
score-team,10739,1637,52,52,121,173,655,707,15689,0,0,0,0
_score-team-mid,10740,1637,28,47,0,28,1,48,15690,0,0,4,0
portrait-frame-nameplate-scaledup,10741,1637,92,93,1,93,560,653,15691,0,0,0,0
flag-outline,10742,1637,64,64,1,65,853,917,15692,0,0,0,0
icon-death,10756,1637,128,128,1,129,348,476,15706,0,0,0,0
icon-wow,10778,1637,75,72,78,153,709,781,15728,0,0,0,0
metal-bar-small,10842,1637,172,80,1,173,478,558,15791,0,0,0,0
portrait-frame-small,10843,1637,86,86,95,181,560,646,15792,0,0,0,0
classic-announcementpopup-bcinfographic-zhcn,12019,1761,477,258,1068,1545,1,259,16801,0,0,0,0
classic-announcementpopup-bcinfographic-zhtw,12020,1761,477,258,1547,2024,1,259,16802,0,0,0,0
classic-announcementpopup-bcinfographic,12021,1761,477,258,589,1066,1,259,16803,0,0,0,0
classic-announcementpopup-frame,12022,1761,586,819,1,587,1,820,16804,0,0,0,0
classic-announcementpopup-line,12023,1761,411,2,589,1000,261,263,16805,0,0,0,0
classic-burningcrusade-infoicon-zhcn,12024,1761,177,178,180,357,822,1000,16806,0,0,0,0
classic-burningcrusade-infoicon-zhtw,12025,1761,177,178,359,536,822,1000,16807,0,0,0,0
classic-burningcrusade-infoicon,12026,1761,177,178,1,178,822,1000,16808,0,0,0,0
classic-burningcrusadetransition-choice-frame-classic,12089,1765,1316,757,1,1317,1,758,16862,0,0,0,0
classic-burningcrusadetransition-choice-line-bc,12090,1765,411,2,1319,1730,407,409,16863,0,0,0,0
classic-burningcrusadetransition-choice-line-classic,12091,1765,411,2,1319,1730,411,413,16864,0,0,0,0
classic-burningcrusadetransition-choice-logo-bc-zhcn,12092,1765,588,404,1,589,760,1164,16865,294,202,0,0
classic-burningcrusadetransition-choice-logo-bc-zhtw,12093,1765,588,404,1,589,1166,1570,16866,294,202,0,0
classic-burningcrusadetransition-choice-logo-bc,12094,1765,588,404,1319,1907,1,405,16867,294,202,0,0
classic-burningcrusadetransition-choice-logo-classic-zhcn,12095,1765,588,404,591,1179,760,1164,16868,294,202,0,0
classic-burningcrusadetransition-choice-logo-classic-zhtw,12096,1765,588,404,1181,1769,760,1164,16869,294,202,0,0
classic-burningcrusadetransition-choice-logo-classic,12097,1765,588,404,1,589,1572,1976,16870,294,202,0,0
ui-paidcharactercustomization-button-activatecharacter,12108,1767,64,64,1,65,1,65,16881,0,0,0,0
classicon-druid,12522,897,128,128,1,129,1,129,17208,0,0,0,0
classicon-hunter,12523,897,128,128,1,129,131,259,17209,0,0,0,0
classicon-mage,12524,897,128,128,1,129,261,389,17210,0,0,0,0
classicon-paladin,12525,897,128,128,131,259,1,129,17211,0,0,0,0
classicon-priest,12526,897,128,128,131,259,131,259,17212,0,0,0,0
classicon-rogue,12527,897,128,128,131,259,261,389,17213,0,0,0,0
classicon-shaman,12528,897,128,128,261,389,1,129,17214,0,0,0,0
classicon-warlock,12529,897,128,128,261,389,131,259,17215,0,0,0,0
classicon-warrior,12530,897,128,128,261,389,261,389,17216,0,0,0,0
circlemaskscalable,12573,1641,64,64,0,64,0,64,17259,0,0,16,0
coin-copper-20x20,12587,898,20,20,175,195,1,21,17562,0,0,0,0
coin-gold-20x20,12588,898,20,20,197,217,1,21,17563,0,0,0,0
coin-silver-20x20,12589,898,20,20,219,239,1,21,17564,0,0,0,0
metal-bar-battlegrounds,12592,1637,239,80,1,240,266,346,17299,0,0,0,0
auctionhouse-icon-checkmark,12622,1495,18,22,1002,1020,259,281,17335,0,0,0,0
auctionhouse-icon-clock,12623,1495,24,24,953,977,347,371,17336,0,0,0,0
auctionhouse-icon-coin-copper,12624,1495,24,28,999,1023,49,77,17337,0,0,0,0
auctionhouse-icon-coin-gold,12625,1495,24,28,999,1023,79,107,17338,0,0,0,0
auctionhouse-icon-coin-silver,12626,1495,24,28,999,1023,109,137,17339,0,0,0,0
auctionhouse-icon-favorite-off,12627,1495,26,26,953,979,303,329,17340,0,0,0,0
auctionhouse-icon-favorite,12628,1495,26,26,981,1007,303,329,17341,0,0,0,0
auctionhouse-icon-socket,12629,1495,14,14,411,425,491,505,17342,0,0,0,0
auctionhouse-itemheaderframe,12630,1495,684,144,1,685,1,145,17343,0,0,0,0
auctionhouse-itemicon-border-account,12631,1495,136,136,687,823,1,137,17344,0,0,0,0
auctionhouse-itemicon-border-artifact,12632,1495,136,136,825,961,1,137,17345,0,0,0,0
auctionhouse-itemicon-border-blue,12633,1495,136,136,293,429,215,351,17346,0,0,0,0
auctionhouse-itemicon-border-gray,12634,1495,136,136,293,429,353,489,17347,0,0,0,0
auctionhouse-itemicon-border-green,12635,1495,136,136,431,567,215,351,17348,0,0,0,0
auctionhouse-itemicon-border-orange,12636,1495,136,136,431,567,353,489,17349,0,0,0,0
auctionhouse-itemicon-border-purple,12637,1495,136,136,569,705,215,351,17350,0,0,0,0
auctionhouse-itemicon-border-white,12638,1495,136,136,569,705,353,489,17351,0,0,0,0
auctionhouse-itemicon-cover,12639,1495,64,64,919,983,147,211,17352,0,0,0,0
auctionhouse-itemicon-empty,12640,1495,100,100,707,807,391,491,17353,0,0,0,0
auctionhouse-itemicon-small-border,12641,1495,32,32,985,1017,147,179,17354,0,0,0,0
auctionhouse-nav-button-highlight,12642,1495,264,42,707,971,215,257,17355,0,0,0,0
auctionhouse-nav-button-secondary-highlight,12643,1495,244,42,707,951,303,345,17356,0,0,0,0
auctionhouse-nav-button-secondary-select,12644,1495,244,42,707,951,347,389,17357,0,0,0,0
auctionhouse-nav-button-secondary,12645,1495,266,64,651,917,147,211,17358,0,0,0,0
auctionhouse-nav-button-select,12646,1495,264,42,707,971,259,301,17359,0,0,0,0
auctionhouse-nav-button-tertiary-filterline,12647,1495,5,11,286,291,475,486,17360,0,0,0,0
auctionhouse-nav-button,12648,1495,272,64,1,273,439,503,17361,0,0,0,0
auctionhouse-rowstripe-1,12649,1495,16,18,963,979,117,135,17362,0,0,0,0
auctionhouse-rowstripe-2,12650,1495,16,18,981,997,117,135,17363,0,0,0,0
auctionhouse-selltab-left,12651,1495,9,23,1011,1020,1,24,17364,0,0,0,0
auctionhouse-selltab-middle,12652,1495,95,23,894,989,391,414,17365,0,0,0,0
auctionhouse-selltab-right,12653,1495,9,23,275,284,475,498,17366,0,0,0,0
auctionhouse-ui-dropdown-arrow-disabled,12654,1495,27,26,985,1012,181,207,17367,0,0,0,0
auctionhouse-ui-dropdown-arrow-down,12655,1495,27,26,973,1000,215,241,17368,0,0,0,0
auctionhouse-ui-dropdown-arrow-up,12656,1495,27,26,973,1000,259,285,17369,0,0,0,0
auctionhouse-ui-dropdown-left,12657,1495,14,34,275,289,439,473,17370,0,0,0,0
auctionhouse-ui-dropdown-middle,12658,1495,83,34,809,892,391,425,17371,0,0,0,0
auctionhouse-ui-dropdown-right,12659,1495,14,34,1002,1016,215,249,17372,0,0,0,0
auctionhouse-ui-filter-redx,12660,1495,46,46,963,1009,1,47,17373,0,0,0,0
auctionhouse-ui-inputfield-left,12661,1495,16,66,963,979,49,115,17374,0,0,0,0
auctionhouse-ui-inputfield-middle,12662,1495,356,66,293,649,147,213,17375,0,0,0,0
auctionhouse-ui-inputfield-right,12663,1495,16,66,981,997,49,115,17376,0,0,0,0
auctionhouse-ui-loadingspinner,12664,1495,290,290,1,291,147,437,17377,0,0,0,0
auctionhouse-ui-row-highlight,12665,1495,116,18,293,409,491,509,17378,0,0,0,0
auctionhouse-ui-row-select,12666,1495,116,18,431,547,491,509,17379,0,0,0,0
auctionhouse-ui-sortarrow,12667,1495,9,9,1011,1020,26,35,17380,0,0,0,0
ui-scrollbar-button-overlay-horizontal,12668,1769,25,27,35,60,1,28,17381,0,0,0,0
ui-scrollbar-button-overlay,12669,1769,27,25,62,89,1,26,17382,0,0,0,0
ui-scrollbar-endcap-bottom,12670,1769,25,31,1,26,62,93,17383,0,0,0,0
ui-scrollbar-endcap-left,12671,1769,31,25,1,32,95,120,17384,0,0,0,0
ui-scrollbar-endcap-right,12672,1769,32,25,1,33,1,26,17385,0,0,0,0
ui-scrollbar-endcap-top,12673,1769,25,32,1,26,28,60,17386,0,0,0,0
ui-scrollbar-knob-endcap-bottom-disabled,12674,1769,18,21,35,53,30,51,17387,0,0,0,0
ui-scrollbar-knob-endcap-bottom,12675,1769,18,21,35,53,53,74,17388,0,0,0,0
ui-scrollbar-knob-endcap-left-disabled,12676,1769,21,18,35,56,76,94,17389,0,0,0,0
ui-scrollbar-knob-endcap-left,12677,1769,21,18,35,56,96,114,17390,0,0,0,0
ui-scrollbar-knob-endcap-right-disabled,12678,1769,21,18,62,83,28,46,17391,0,0,0,0
ui-scrollbar-knob-endcap-right,12679,1769,21,18,62,83,48,66,17392,0,0,0,0
ui-scrollbar-knob-endcap-top-disabled,12680,1769,18,21,62,80,68,89,17393,0,0,0,0
ui-scrollbar-knob-endcap-top,12681,1769,18,21,62,80,91,112,17394,0,0,0,0
ui-scrollbar-knob-mouseover-endcap-bottom,12682,1769,18,21,91,109,1,22,17395,0,0,0,0
ui-scrollbar-knob-mouseover-endcap-left,12683,1769,21,18,111,132,1,19,17396,0,0,0,0
ui-scrollbar-knob-mouseover-endcap-right,12684,1769,21,18,134,155,1,19,17397,0,0,0,0
ui-scrollbar-knob-mouseover-endcap-top,12685,1769,18,21,91,109,24,45,17398,0,0,0,0
ui-scrollbar-scrolldownbutton-disabled,12686,1769,18,16,91,109,47,63,17399,0,0,0,0
ui-scrollbar-scrolldownbutton-down,12687,1769,18,16,91,109,65,81,17400,0,0,0,0
ui-scrollbar-scrolldownbutton-highlight,12688,1769,18,16,91,109,83,99,17401,0,0,0,0
ui-scrollbar-scrolldownbutton-up,12689,1769,18,16,91,109,101,117,17402,0,0,0,0
ui-scrollbar-scrollleftbutton-disabled,12690,1769,16,18,157,173,1,19,17403,0,0,0,0
ui-scrollbar-scrollleftbutton-down,12691,1769,16,18,175,191,1,19,17404,0,0,0,0
ui-scrollbar-scrollleftbutton-highlight,12692,1769,16,18,193,209,1,19,17405,0,0,0,0
ui-scrollbar-scrollleftbutton-up,12693,1769,16,18,211,227,1,19,17406,0,0,0,0
ui-scrollbar-scrollrightbutton-disabled,12694,1769,16,18,229,245,1,19,17407,0,0,0,0
ui-scrollbar-scrollrightbutton-down,12695,1769,16,18,111,127,21,39,17408,0,0,0,0
ui-scrollbar-scrollrightbutton-highlight,12696,1769,16,18,111,127,41,59,17409,0,0,0,0
ui-scrollbar-scrollrightbutton-up,12697,1769,16,18,111,127,61,79,17410,0,0,0,0
ui-scrollbar-scrollupbutton-disabled,12698,1769,18,16,129,147,21,37,17411,0,0,0,0
ui-scrollbar-scrollupbutton-down,12699,1769,18,16,129,147,39,55,17412,0,0,0,0
ui-scrollbar-scrollupbutton-highlight,12700,1769,18,16,129,147,57,73,17413,0,0,0,0
ui-scrollbar-scrollupbutton-up,12701,1769,18,16,129,147,75,91,17414,0,0,0,0
ui-scrollbar-knob-center-disabled-horizontal,12702,1770,1022,18,1,1023,28,46,17415,0,0,0,0
ui-scrollbar-knob-center-horizontal,12703,1770,1022,18,1,1023,48,66,17416,0,0,0,0
ui-scrollbar-knob-mouseover-center-horizontal,12704,1770,1022,18,1,1023,68,86,17417,0,0,0,0
_ui-scrollbar-center,12705,1770,32,25,0,32,1,26,17418,0,0,4,0
!ui-scrollbar-center,12706,1763,25,32,34,59,0,32,17419,0,0,2,0
ui-scrollbar-knob-center-disabled,12707,1763,18,1022,81,99,1,1023,17420,0,0,0,0
ui-scrollbar-knob-center,12708,1763,18,1022,61,79,1,1023,17421,0,0,0,0
ui-scrollbar-knob-mouseover-center,12709,1763,18,1022,101,119,1,1023,17422,0,0,0,0
tooltip-nineslice-cornerbottomleft,12716,1825,7,7,1,8,15,22,17433,0,0,0,0
tooltip-nineslice-cornerbottomright,12717,1825,7,7,1,8,24,31,17434,0,0,0,0
tooltip-nineslice-cornertopleft,12718,1825,7,7,1,8,33,40,17435,0,0,0,0
tooltip-nineslice-cornertopright,12719,1825,7,7,1,8,42,49,17436,0,0,0,0
_tooltip-nineslice-edgebottom,12720,1825,8,5,0,8,1,6,17437,0,0,4,0
_tooltip-nineslice-edgetop,12721,1825,8,5,0,8,8,13,17438,0,0,4,0
!tooltip-nineslice-edgeleft,12723,1827,5,16,1,6,0,16,17440,0,0,2,0
!tooltip-nineslice-edgeright,12724,1827,5,16,8,13,0,16,17441,0,0,2,0
tooltip-glues-nineslice-cornerbottomleft,12725,1828,18,16,1,19,30,46,17442,0,0,0,0
tooltip-glues-nineslice-cornerbottomright,12726,1828,14,16,1,15,66,82,17443,0,0,0,0
tooltip-glues-nineslice-cornertopleft,12727,1828,18,16,1,19,48,64,17444,0,0,0,0
tooltip-glues-nineslice-cornertopright,12728,1828,14,16,17,31,66,82,17445,0,0,0,0
_tooltip-glues-nineslice-edgebottom,12729,1828,16,12,0,16,16,28,17446,0,0,4,0
_tooltip-glues-nineslice-edgetop,12730,1828,16,13,0,16,1,14,17447,0,0,4,0
!tooltip-glues-nineslice-edgeleft,12731,1829,13,16,1,14,0,16,17448,0,0,2,0
!tooltip-glues-nineslice-edgeright,12732,1829,13,16,16,29,0,16,17449,0,0,2,0
tooltip-glues-nineslice-center,12733,1830,64,64,0,64,0,64,17610,0,0,6,0
sliderbar-nineslice-cornerbottomleft,12774,1839,8,8,1,9,42,50,17480,0,0,0,0
sliderbar-nineslice-cornerbottomright,12775,1839,8,8,1,9,52,60,17481,0,0,0,0
sliderbar-nineslice-cornertopleft,12776,1839,8,8,1,9,62,70,17482,0,0,0,0
sliderbar-nineslice-cornertopright,12777,1839,8,8,1,9,72,80,17483,0,0,0,0
_sliderbar-nineslice-edgebottom,12778,1839,8,8,0,8,1,9,17484,0,0,4,0
_sliderbar-nineslice-edgetop,12779,1839,8,8,0,8,11,19,17485,0,0,4,0
ui-frame-sliderbar-backgroundtile,12782,1841,8,8,1,9,1,9,17488,0,0,0,0
ui-frame-diamondmetal-cornerbottomleft,12857,1860,32,32,1,33,69,101,17566,0,0,0,0
ui-frame-diamondmetal-cornerbottomright,12858,1860,32,32,1,33,103,135,17567,0,0,0,0
ui-frame-diamondmetal-cornertopleft,12859,1860,32,32,1,33,137,169,17568,0,0,0,0
ui-frame-diamondmetal-cornertopright,12860,1860,32,32,1,33,171,203,17569,0,0,0,0
_ui-frame-diamondmetal-edgebottom,12861,1860,32,32,0,32,1,33,17570,0,0,4,0
_ui-frame-diamondmetal-edgetop,12862,1860,32,32,0,32,35,67,17571,0,0,4,0
!ui-frame-diamondmetal-edgeleft,12863,1861,32,32,1,33,0,32,17572,0,0,2,0
!ui-frame-diamondmetal-edgeright,12864,1861,32,32,35,67,0,32,17573,0,0,2,0
tooltip-nineslice-center,12873,1826,64,64,0,64,0,64,17582,0,0,6,0
chatbubble-nineslice-center,12901,1862,32,32,67,99,69,101,17574,0,0,0,0
chatbubble-nineslice-cornerbottomleft,12902,1862,32,32,1,33,135,167,17575,16,16,0,0
chatbubble-nineslice-cornerbottomright,12903,1862,32,32,1,33,169,201,17576,16,16,0,0
chatbubble-nineslice-cornertopleft,12904,1862,32,32,1,33,203,235,17577,16,16,0,0
chatbubble-nineslice-cornertopright,12905,1862,32,32,35,67,135,167,17578,16,16,0,0
chatbubble-tail,12906,1862,64,64,1,65,69,133,17579,16,16,0,0
_chatbubble-nineslice-edgebottom,12907,1862,32,32,0,32,1,33,17580,16,16,4,0
_chatbubble-nineslice-edgetop,12908,1862,32,32,0,32,35,67,17581,16,16,4,0
!chatbubble-nineslice-edgeleft,13253,1887,32,32,1,33,0,32,17932,16,16,2,0
!chatbubble-nineslice-edgeright,13254,1887,32,32,35,67,0,32,17933,16,16,2,0
sliderbar-button,13269,1839,13,19,1,14,21,40,17947,0,0,0,0
gmchat-icon-alert,13394,1905,20,20,1,21,192,212,18037,0,0,0,0
gmchat-icon-blizz,13395,1905,20,20,1,21,214,234,18038,0,0,0,0
gmchat-icon-wow,13396,1905,20,20,23,43,192,212,18039,0,0,0,0
gmchat-nineslice-cornerbottomleft,13397,1905,7,7,1,8,236,243,18040,0,0,0,0
gmchat-nineslice-cornerbottomright,13398,1905,7,7,1,8,245,252,18041,0,0,0,0
gmchat-nineslice-cornertopleft,13399,1905,7,7,10,17,236,243,18042,0,0,0,0
gmchat-nineslice-cornertopright,13400,1905,7,7,10,17,245,252,18043,0,0,0,0
gmchat-watermark-blizzard,13401,1905,305,161,1,306,29,190,18044,0,0,0,0
gmglow-nineslice-cornerbottomleft,13402,1905,7,7,23,30,214,221,18045,0,0,0,0
gmglow-nineslice-cornerbottomright,13403,1905,7,7,32,39,214,221,18046,0,0,0,0
gmglow-nineslice-cornertopleft,13404,1905,7,7,23,30,223,230,18047,0,0,0,0
gmglow-nineslice-cornertopright,13405,1905,7,7,32,39,223,230,18048,0,0,0,0
_gmchat-nineslice-edgebottom,13406,1905,8,5,0,8,1,6,18049,0,0,4,0
_gmchat-nineslice-edgetop,13407,1905,8,5,0,8,8,13,18050,0,0,4,0
_gmglow-nineslice-edgebottom,13408,1905,8,5,0,8,15,20,18051,0,0,4,0
_gmglow-nineslice-edgetop,13409,1905,8,5,0,8,22,27,18052,0,0,4,0
!ui-frame-newplayertutorial-edgeleft,13414,1907,128,128,1074,1202,341,469,18056,64,64,0,0
!ui-frame-newplayertutorial-edgeright,13415,1907,128,128,915,1043,747,875,18057,64,64,0,0
newplayertutorial-drag-cursor,13416,1907,157,144,915,1072,341,485,18058,0,0,0,0
newplayertutorial-drag-slotblue,13417,1907,152,152,693,845,697,849,18059,0,0,0,0
newplayertutorial-drag-slotgreen,13418,1907,152,152,693,845,851,1003,18060,0,0,0,0
newplayertutorial-greenglow-redbutton-left,13419,1907,40,98,43,83,902,1000,18061,20,42,0,0
newplayertutorial-greenglow-redbutton-middle,13420,1907,2,98,2009,2011,131,229,18062,1,42,0,0
newplayertutorial-greenglow-redbutton-right,13421,1907,40,98,1,41,902,1000,18063,20,42,0,0
newplayertutorial-icon-key,13422,1907,80,70,963,1043,261,331,18064,0,0,0,0
newplayertutorial-icon-mouse-leftbutton,13423,1907,152,202,385,537,697,899,18065,0,0,0,0
newplayertutorial-icon-mouse-middlebutton,13424,1907,152,202,231,383,697,899,18066,0,0,0,0
newplayertutorial-icon-mouse-rightbutton,13425,1907,152,202,539,691,697,899,18067,0,0,0,0
newplayertutorial-icon-mouse-turn,13426,1907,228,203,1,229,697,900,18068,0,0,0,0
newplayertutorial-keyboard,13427,1907,960,338,1,961,1,339,18069,480,169,0,0
npe_arrowdown,13428,1907,64,64,1441,1505,261,325,9121,0,0,0,0
npe_arrowdownglow,13429,1907,64,64,1375,1439,261,325,9118,0,0,0,0
npe_arrowleft,13430,1907,64,64,1111,1175,261,325,9126,0,0,0,0
npe_arrowleftglow,13431,1907,64,64,1309,1373,261,325,9125,0,0,0,0
npe_arrowright,13432,1907,64,64,1573,1637,261,325,9124,0,0,0,0
npe_arrowrightglow,13433,1907,64,64,1045,1109,261,325,9122,0,0,0,0
npe_arrowup,13434,1907,64,64,1177,1241,261,325,9120,0,0,0,0
npe_arrowupglow,13435,1907,64,64,1243,1307,261,325,9119,0,0,0,0
npe_exclamationpoint,13436,1907,32,32,2009,2041,69,101,9113,0,0,0,0
npe_icon,13437,1907,64,64,1507,1571,261,325,9114,0,0,0,0
npe_keyboard,13438,1907,912,354,1,913,341,695,9123,0,0,0,0
npe_leftclick,13439,1907,32,32,2009,2041,1,33,9115,0,0,0,0
npe_rightclick,13440,1907,32,32,2009,2041,35,67,9116,0,0,0,0
npe_turnin,13441,1907,20,20,2009,2029,103,123,9117,0,0,0,0
ui-frame-newplayertutorial-center,13442,1907,1,1,2043,2044,1,2,18070,0,0,0,0
ui-frame-newplayertutorial-cornerbottomleft,13443,1907,128,128,915,1043,877,1005,18071,64,64,0,0
ui-frame-newplayertutorial-cornerbottomright,13444,1907,128,128,915,1043,617,745,18072,64,64,0,0
ui-frame-newplayertutorial-cornertopleft,13445,1907,128,128,1074,1202,471,599,18073,64,64,0,0
ui-frame-newplayertutorial-cornertopright,13446,1907,128,128,915,1043,487,615,18074,64,64,0,0
_ui-frame-newplayertutorial-edgebottom,13447,1907,1044,128,963,2007,1,129,18075,522,64,0,0
_ui-frame-newplayertutorial-edgetop,13448,1907,1044,128,963,2007,131,259,18076,522,64,0,0
friendslist-invitebutton-alliance-disabled,13857,869,24,32,1,25,29,61,18297,0,0,0,0
friendslist-invitebutton-alliance-normal,13858,869,24,32,27,51,29,61,18298,0,0,0,0
friendslist-invitebutton-alliance-pressed,13859,869,24,32,53,77,29,61,18299,0,0,0,0
friendslist-invitebutton-default-disabled,13860,869,24,32,79,103,29,61,18300,0,0,0,0
friendslist-invitebutton-default-normal,13861,869,24,32,105,129,29,61,18301,0,0,0,0
friendslist-invitebutton-default-pressed,13862,869,24,32,131,155,29,61,18302,0,0,0,0
friendslist-invitebutton-highlight,13863,869,24,32,157,181,29,61,18303,0,0,0,0
friendslist-invitebutton-horde-disabled,13864,869,24,32,183,207,29,61,18304,0,0,0,0
friendslist-invitebutton-horde-normal,13865,869,24,32,209,233,29,61,18305,0,0,0,0
friendslist-invitebutton-horde-pressed,13866,869,24,32,235,259,29,61,18306,0,0,0,0
common-search-border-left,13874,1932,16,40,227,243,1,41,18314,0,0,0,0
common-search-border-middle,13875,1932,224,40,1,225,1,41,18315,0,0,0,0
common-search-border-right,13876,1932,16,40,1,17,43,83,18316,0,0,0,0
common-search-clearbutton,13877,1932,20,20,19,39,69,89,18317,0,0,0,0
common-search-magnifyingglass,13878,1932,24,24,19,43,43,67,18318,0,0,0,0
chatframe-button-icon-tts,14065,1442,29,29,253,282,223,252,18370,0,0,0,0
voicechat-channellist-icon-stt-off,14066,1442,42,42,219,261,135,177,18371,0,0,0,0
voicechat-channellist-icon-stt-on,14067,1442,42,42,219,261,179,221,18372,0,0,0,0
voicechat-icon-stt,14068,1442,32,32,353,385,69,101,18373,0,0,0,0
ui-classicscrollbar-center,14218,1763,31,28,1,32,0,28,18422,0,0,2,0
ui-classicscrollbar-endcap-bottom-rounded,14220,1941,31,28,76,107,20,48,18424,0,0,0,0
ui-classicscrollbar-endcap-bottom,14221,1941,31,28,1,32,1,29,18425,0,0,0,0
ui-classicscrollbar-endcap-top,14222,1941,31,28,1,32,31,59,18426,0,0,0,0
ui-scrollbar-classicscrolldownbutton-disabled,14223,1941,19,17,34,53,1,18,18427,0,0,0,0
ui-scrollbar-classicscrolldownbutton-down,14224,1941,19,17,34,53,20,37,18428,0,0,0,0
ui-scrollbar-classicscrolldownbutton-highlight,14225,1941,19,17,34,53,39,56,18429,0,0,0,0
ui-scrollbar-classicscrolldownbutton-up,14226,1941,19,17,55,74,1,18,18430,0,0,0,0
ui-scrollbar-classicscrollupbutton-disabled,14227,1941,19,17,55,74,20,37,18431,0,0,0,0
ui-scrollbar-classicscrollupbutton-down,14228,1941,19,17,97,116,1,18,18432,0,0,0,0
ui-scrollbar-classicscrollupbutton-highlight,14229,1941,19,17,55,74,39,56,18433,0,0,0,0
ui-scrollbar-classicscrollupbutton-up,14230,1941,19,17,76,95,1,18,18434,0,0,0,0
ui-chaticon-app,14410,1971,32,32,1,33,1,33,18622,0,0,0,0
ui-chaticon-blizzardarcadecollection,14411,1971,32,32,1,33,205,237,18603,0,0,0,0
ui-chaticon-vipr,14412,1971,32,32,103,135,35,67,18604,0,0,0,0
ui-chaticon-callofdutyblackopscoldwaricon,14413,1971,32,32,35,67,103,135,18605,0,0,0,0
ui-chaticon-callofdutymw2icon,14414,1971,32,32,1,33,69,101,18606,0,0,0,0
ui-chaticon-callofdutymwicon,14415,1971,32,32,35,67,1,33,18607,0,0,0,0
ui-chaticon-callofdutyvanguard,14416,1971,32,32,171,203,1,33,18608,0,0,0,0
ui-chaticon-crashbandicoot4,14417,1971,32,32,171,203,35,67,18609,0,0,0,0
ui-chaticon-d3,14418,1971,32,32,69,101,1,33,18610,0,0,0,0
ui-chaticon-dst2,14419,1971,32,32,137,169,1,33,18611,0,0,0,0
ui-chaticon-diabloiiresurrected,14420,1971,32,32,1,33,103,135,18612,0,0,0,0
ui-chaticon-diabloimmortal,14421,1971,32,32,103,135,1,33,18613,0,0,0,0
ui-chaticon-hero,14422,1971,32,32,1,33,35,67,18614,0,0,0,0
ui-chaticon-s1,14424,1971,32,32,35,67,35,67,18616,0,0,0,0
ui-chaticon-s2,14425,1971,32,32,69,101,35,67,18617,0,0,0,0
ui-chaticon-warcraft3reforged,14426,1971,32,32,137,169,35,67,18618,0,0,0,0
ui-chaticon-warcraftarclightrumble,14427,1971,32,32,205,237,1,33,18619,0,0,0,0
ui-chaticon-wow,14428,1971,32,32,205,237,35,67,18620,0,0,0,0
ui-chaticon-wtcg,14429,1971,32,32,35,67,69,101,18621,0,0,0,0
battlenet-clienticon-app,14430,1972,32,32,69,101,1,33,18623,0,0,0,0
battlenet-blizzardarcadecollectionicon,14431,1972,32,32,1,33,171,203,18624,0,0,0,0
battlenet-clienticon-vipr,14432,1972,32,32,69,101,35,67,18625,0,0,0,0
battlenet-callofdutyblackopscoldwaricon,14433,1972,32,32,205,237,35,67,18626,0,0,0,0
battlenet-callofdutymw2icon,14434,1972,32,32,1,33,35,67,18627,0,0,0,0
battlenet-callofdutymwicon,14435,1972,32,32,1,33,1,33,18628,0,0,0,0
battlenet-callofdutyvanguardicon,14436,1972,32,32,35,67,1,33,18629,0,0,0,0
battlenet-crashbandicoot4icon,14437,1972,32,32,103,135,35,67,18630,0,0,0,0
battlenet-clienticon-d3,14438,1972,32,32,103,135,1,33,18631,0,0,0,0
battlenet-clienticon-dst2,14439,1972,32,32,137,169,1,33,18632,0,0,0,0
battlenet-diabloiiresurrectedicon,14440,1972,32,32,1,33,69,101,18633,0,0,0,0
battlenet-diabloimmortalicon,14441,1972,32,32,35,67,69,101,18634,0,0,0,0
battlenet-clienticon-hero,14442,1972,32,32,205,237,1,33,18635,0,0,0,0
battlenet-clienticon-s2,14444,1972,32,32,35,67,35,67,18637,0,0,0,0
battlenet-clienticon-s1,14445,1972,32,32,1,33,205,237,18638,0,0,0,0
battlenet-warcraft3reforged,14446,1972,32,32,35,67,103,135,18639,0,0,0,0
battlenet-warcraftarclightrumbleicon,14447,1972,32,32,171,203,1,33,18640,0,0,0,0
battlenet-clienticon-wow,14448,1972,32,32,137,169,35,67,18641,0,0,0,0
battlenet-clienticon-wtcg,14449,1972,32,32,171,203,35,67,18642,0,0,0,0
squaremask,17654,2200,64,64,0,64,0,64,21007,0,0,16,0
battlenet-clienticon-pro,17740,1972,32,32,1,33,103,135,18636,0,0,0,0
battlenet-clienticon-pro-zhcn,17741,1972,32,32,1,33,137,169,21062,0,0,0,0
ui-chaticon-pro,17742,1971,32,32,1,33,137,169,18615,0,0,0,0
ui-chaticon-pro-zhcn,17743,1971,32,32,1,33,171,203,21061,0,0,0,0
uiframebackground-nineslice-cornerbottomleft,21398,2409,16,16,1,17,1,17,23580,0,0,0,0
uiframebackground-nineslice-cornerbottomright,21399,2409,16,16,19,35,1,17,23581,0,0,0,0
options_categoryheader_1,21400,2410,199,144,1,200,1,145,23582,0,0,0,0
options_categoryheader_2,21401,2410,199,144,202,401,1,145,23583,0,0,0,0
options_categoryheader_3,21402,2410,199,144,1,200,770,914,23584,0,0,0,0
options_horizontaldivider,21403,2410,630,1,1,631,147,148,23585,0,0,0,0
options_innerframe,21404,2410,886,618,1,887,150,768,23586,0,0,0,0
options_list_active,21405,2410,187,21,592,779,1,22,23587,0,0,0,0
options_list_hover,21406,2410,187,21,403,590,1,22,23588,0,0,0,0
options_tab_active_left,21407,2410,7,26,403,410,24,50,23589,0,0,0,0
options_tab_active_middle,21408,2410,1,26,403,404,77,103,23590,0,0,0,0
options_tab_active_right,21409,2410,7,26,412,419,49,75,23591,0,0,0,0
options_tab_left,21410,2410,7,23,403,410,52,75,23592,0,0,0,0
options_tab_middle,21411,2410,1,23,403,404,105,128,23593,0,0,0,0
options_tab_right,21412,2410,7,23,412,419,24,47,23594,0,0,0,0
minimal-scrollbar-arrow-bottom-down,21416,2412,17,11,31,48,52,63,23595,0,0,0,0
minimal-scrollbar-arrow-bottom-over,21417,2412,17,11,50,67,1,12,23596,0,0,0,0
minimal-scrollbar-arrow-bottom-over_alt,21418,2412,17,11,69,86,1,12,23597,0,0,0,0
minimal-scrollbar-arrow-bottom,21419,2412,17,11,88,105,1,12,23598,0,0,0,0
minimal-scrollbar-arrow-returntobottom-down,21420,2412,17,15,31,48,1,16,23599,0,0,0,0
minimal-scrollbar-arrow-returntobottom-over,21421,2412,17,15,31,48,18,33,23600,0,0,0,0
minimal-scrollbar-arrow-returntobottom,21422,2412,17,15,31,48,35,50,23601,0,0,0,0
minimal-scrollbar-arrow-top-down,21423,2412,17,11,107,124,1,12,23602,0,0,0,0
minimal-scrollbar-arrow-top-over,21424,2412,17,11,50,67,14,25,23603,0,0,0,0
minimal-scrollbar-arrow-top,21425,2412,17,11,50,67,27,38,23604,0,0,0,0
minimal-scrollbar-thumb-bottom-down,21426,2412,8,36,1,9,1,37,23605,0,0,0,0
minimal-scrollbar-thumb-bottom-over,21427,2412,8,36,11,19,1,37,23606,0,0,0,0
minimal-scrollbar-thumb-bottom,21428,2412,8,36,21,29,1,37,23607,0,0,0,0
minimal-scrollbar-thumb-top-down,21429,2412,8,8,1,9,39,47,23608,0,0,0,0
minimal-scrollbar-thumb-top-over,21430,2412,8,8,1,9,49,57,23609,0,0,0,0
minimal-scrollbar-thumb-top,21431,2412,8,8,11,19,39,47,23610,0,0,0,0
minimal-scrollbar-track-bottom,21432,2412,8,8,11,19,49,57,23611,0,0,0,0
minimal-scrollbar-track-top,21433,2412,8,8,21,29,39,47,23612,0,0,0,0
!minimal-scrollbar-track-middle,21435,2414,8,1,1,9,0,1,23613,0,0,2,0
minimal-scrollbar-thumb-middle-down,21436,2414,8,715,11,19,1,716,23614,0,0,0,0
minimal-scrollbar-thumb-middle-over,21437,2414,8,715,21,29,1,716,23615,0,0,0,0
minimal-scrollbar-thumb-middle,21438,2414,8,715,31,39,1,716,23616,0,0,0,0
ui-frame-neutral-cardparchment,21439,2415,254,439,1,255,559,998,23617,0,0,0,0
ui-frame-neutral-cardparchmentwider,21440,2415,515,438,257,772,559,997,23618,0,0,0,0
ui-frame-neutral-corner,21441,2415,166,166,785,951,350,516,23619,0,0,0,0
ui-frame-neutral-exitbuttonborder,21442,2415,33,32,415,448,152,184,23620,0,0,0,0
ui-frame-neutral-portrait,21443,2415,205,109,208,413,152,261,23621,0,0,0,0
ui-frame-neutral-portraitdisable,21444,2415,205,109,1,206,152,261,23622,0,0,0,0
ui-frame-neutral-portraitwider,21445,2415,390,207,1,391,350,557,23623,0,0,0,0
ui-frame-neutral-portraitwiderdisable,21446,2415,390,207,393,783,350,557,23624,0,0,0,0
ui-frame-neutral-ribbon,21447,2415,281,84,450,731,152,236,23625,0,0,0,0
ui-frame-neutral-titleleft,21448,2415,202,85,733,935,152,237,23626,0,0,0,0
ui-frame-neutral-titleright,21449,2415,202,85,1,203,263,348,23627,0,0,0,0
_ui-frame-neutral-tilebottom,21450,2415,256,30,0,256,88,118,23628,0,0,4,0
_ui-frame-neutral-tiletop,21451,2415,256,30,0,256,120,150,23629,0,0,4,0
_ui-frame-neutral-titlemiddle,21452,2415,128,85,0,128,1,86,23630,0,0,4,0
minimal_sliderbar_button,21641,2433,20,19,1,21,20,39,23821,0,0,0,0
minimal_sliderbar_button_left,21642,2433,11,19,1,12,41,60,23822,0,0,0,0
minimal_sliderbar_button_right,21643,2433,9,18,1,10,81,99,23823,0,0,0,0
minimal_sliderbar_left,21644,2433,11,17,14,25,41,58,23824,0,0,0,0
minimal_sliderbar_right,21645,2433,11,17,1,12,62,79,23825,0,0,0,0
_minimal_sliderbar_middle,21646,2433,1,17,0,1,1,18,23826,0,0,4,0
checkbox-minimal,21647,2434,30,29,1,31,1,30,23827,0,0,0,0
checkmark-minimal-disabled,21648,2434,30,29,33,63,1,30,23828,0,0,0,0
checkmark-minimal,21649,2434,30,29,1,31,32,61,23829,0,0,0,0
options_listexpand_left,21650,2435,12,26,1,13,85,111,23830,0,0,0,0
options_listexpand_right,21651,2435,28,26,1,29,29,55,23831,0,0,0,0
options_listexpand_right_expanded,21652,2435,28,26,1,29,57,83,23832,0,0,0,0
_options_listexpand_middle,21653,2435,1,26,0,1,1,27,23833,0,0,4,0
!ui-frame-charactercreatedropdown-edgeleft,21654,2436,124,408,256,380,1,409,23834,62,204,0,0
!ui-frame-charactercreatedropdown-edgeright,21655,2436,124,408,4,128,1,409,23835,62,204,0,0
ui-frame-charactercreatedropdown-center,21656,2436,1,1,1,2,1,2,23836,0,0,0,0
ui-frame-charactercreatedropdown-cornerbottomleft,21657,2436,124,144,130,254,253,397,23837,62,72,0,0
ui-frame-charactercreatedropdown-cornerbottomright,21658,2436,124,144,130,254,107,251,23838,62,72,0,0
ui-frame-charactercreatedropdown-cornertopleft,21659,2436,124,104,130,254,1,105,23839,62,52,0,0
ui-frame-charactercreatedropdown-cornertopright,21660,2436,124,104,130,254,399,503,23840,62,52,0,0
_ui-frame-charactercreatedropdown-edgebottom,21661,2436,432,144,382,814,1,145,23841,216,72,0,0
_ui-frame-charactercreatedropdown-edgetop,21662,2436,432,104,382,814,147,251,23842,216,52,0,0
options_categoryheader_1,21663,2437,199,144,1,200,1,145,23582,0,0,0,0
options_categoryheader_2,21664,2437,199,144,202,401,1,145,23583,0,0,0,0
options_categoryheader_3,21665,2437,199,144,403,602,1,145,23584,0,0,0,0
options_horizontaldivider,21666,2437,630,1,1,631,147,148,23585,0,0,0,0
options_innerframe,21667,2437,886,618,1,887,150,768,23586,0,0,0,0
options_list_active,21668,2437,187,21,613,800,1,22,23587,0,0,0,0
options_list_hover,21669,2437,187,21,802,989,1,22,23588,0,0,0,0
options_tab_active_left,21670,2437,7,26,604,611,1,27,23589,0,0,0,0
options_tab_active_middle,21671,2437,1,26,604,605,57,83,23590,0,0,0,0
options_tab_active_right,21672,2437,7,26,604,611,29,55,23591,0,0,0,0
options_tab_left,21673,2437,7,23,604,611,85,108,23592,0,0,0,0
options_tab_middle,21674,2437,1,23,607,608,57,80,23593,0,0,0,0
options_tab_right,21675,2437,7,23,604,611,110,133,23594,0,0,0,0
charactercreate-customize-backbutton-disabled,21676,708,76,76,1723,1799,419,495,23843,38,38,0,0
charactercreate-customize-backbutton-down,21677,708,76,76,1801,1877,419,495,23844,38,38,0,0
charactercreate-customize-backbutton,21678,708,76,76,1881,1957,419,495,23845,38,38,0,0
charactercreate-customize-button-redglow,21679,708,106,102,281,387,1777,1879,23846,53,51,0,0
charactercreate-customize-dropdown-icon-lock,21680,708,30,43,389,419,1777,1820,23847,8,12,0,0
charactercreate-customize-dropdown-linemouseover-middle,21681,708,1,40,2043,2044,1,41,23848,1,20,0,0
charactercreate-customize-dropdown-linemouseover-side,21682,708,12,40,2029,2041,1,41,23849,6,20,0,0
charactercreate-customize-dropdown-newtagglow,21683,708,40,40,1149,1189,455,495,23850,0,0,0,0
charactercreate-customize-dropdownbox-hover,21684,708,300,76,439,739,497,573,23851,150,38,0,0
charactercreate-customize-dropdownbox-open,21685,708,300,76,741,1041,497,573,23852,150,38,0,0
charactercreate-customize-dropdownbox,21686,708,300,76,1043,1343,497,573,23853,150,38,0,0
charactercreate-customize-nextbutton-disabled,21687,708,76,76,1959,2035,419,495,23854,38,38,0,0
charactercreate-customize-nextbutton-down,21688,708,76,76,281,357,1881,1957,23855,38,38,0,0
charactercreate-customize-nextbutton,21689,708,76,76,359,435,1881,1957,23856,38,38,0,0
charactercreate-customize-palette-glow,21690,708,84,20,1923,2007,213,233,23857,42,10,0,0
charactercreate-customize-palette-half,21691,708,84,20,1923,2007,235,255,23858,42,10,0,0
charactercreate-customize-palette-selected,21692,708,102,40,1819,1921,213,253,23859,51,20,0,0
charactercreate-customize-palette,21693,708,84,20,519,603,471,491,23860,42,10,0,0
charactercreate-customize-playbutton-down,21694,708,76,76,281,357,1959,2035,23861,38,38,0,0
charactercreate-customize-playbutton,21695,708,76,76,359,435,1959,2035,23862,38,38,0,0
charactercreate-customize-speakeroffbutton-down,21696,708,76,76,1547,1623,497,573,23863,38,38,0,0
charactercreate-customize-speakeroffbutton,21697,708,76,76,1625,1701,497,573,23864,38,38,0,0
charactercreate-customize-speakeronbutton-down,21698,708,76,76,1703,1779,497,573,23865,38,38,0,0
charactercreate-customize-speakeronbutton,21699,708,76,76,1781,1857,497,573,23866,38,38,0,0
charactercreate-gendericon-female-selected,21700,708,256,256,281,537,1,257,23867,0,0,0,0
charactercreate-gendericon-female,21701,708,256,256,539,795,1,257,23868,0,0,0,0
charactercreate-gendericon-male-selected,21702,708,256,256,797,1053,1,257,23869,0,0,0,0
charactercreate-gendericon-male,21703,708,256,256,1055,1311,1,257,23870,0,0,0,0
charactercreate-icon-alliance,21704,708,184,200,1351,1535,259,459,23871,92,100,0,0
charactercreate-icon-customize-accessories-selected,21705,708,156,158,1723,1879,259,417,23872,104,105,0,0
charactercreate-icon-customize-accessories,21706,708,156,158,1881,2037,259,417,23873,104,105,0,0
charactercreate-icon-customize-body-selected,21707,708,156,158,281,437,497,655,11986,104,105,0,0
charactercreate-icon-customize-body,21708,708,156,158,281,437,657,815,11987,104,105,0,0
charactercreate-icon-customize-hair-selected,21709,708,208,210,1819,2027,1,211,11988,104,105,0,0
charactercreate-icon-customize-hair,21710,708,208,210,519,727,259,469,11989,104,105,0,0
charactercreate-icon-customize-head-selected,21711,708,156,158,281,437,817,975,11990,104,105,0,0
charactercreate-icon-customize-head,21712,708,156,158,281,437,977,1135,11991,0,0,0,0
charactercreate-icon-customize-mirror-selected,21713,708,156,158,281,437,1137,1295,23874,0,0,0,0
charactercreate-icon-customize-mirror,21714,708,156,158,281,437,1297,1455,23875,0,0,0,0
charactercreate-icon-customize-speechbubble-selected,21715,708,156,158,281,437,1457,1615,23876,0,0,0,0
charactercreate-icon-customize-speechbubble,21716,708,156,158,281,437,1617,1775,23877,0,0,0,0
charactercreate-icon-customize-torso-selected,21717,708,208,210,729,937,259,469,23878,104,105,0,0
charactercreate-icon-customize-torso,21718,708,208,210,939,1147,259,469,23879,104,105,0,0
charactercreate-icon-dice,21719,708,256,256,1313,1569,1,257,23880,24,24,0,0
charactercreate-icon-horde,21720,708,184,200,1537,1721,259,459,23881,92,100,0,0
charactercreate-icon-requiredarrow,21721,708,80,66,1859,1939,497,563,23882,40,33,0,0
charactercreate-ring-alliance-disabled,21722,708,278,280,1,279,1,281,23883,0,0,0,0
charactercreate-ring-alliance,21723,708,278,280,1,279,283,563,23884,0,0,0,0
charactercreate-ring-customizebackground,21724,708,246,246,1571,1817,1,247,23885,123,123,0,0
charactercreate-ring-horde-disabled,21725,708,278,280,1,279,565,845,23886,0,0,0,0
charactercreate-ring-horde,21726,708,278,280,1,279,847,1127,23887,0,0,0,0
charactercreate-ring-metaldark-disabled,21727,708,278,280,1,279,1129,1409,23888,0,0,0,0
charactercreate-ring-metaldark,21728,708,278,280,1,279,1411,1691,23889,0,0,0,0
charactercreate-ring-metallight,21729,708,278,280,1,279,1693,1973,23890,0,0,0,0
charactercreate-ring-racialtrait,21730,708,38,38,1191,1229,455,493,23891,0,0,0,0
charactercreate-ring-select,21731,708,236,236,281,517,259,495,23892,0,0,0,0
charactercreate-tooltip-background,21732,708,1,1,92,93,2041,2042,23893,0,0,0,0
charactercreate-tooltip-corner,21733,708,68,68,203,271,1975,2043,23894,0,0,0,0
charactercreate-tooltip-side,21734,708,1,68,273,274,1975,2043,23895,0,0,0,0
charactercreate-tooltip-top,21735,708,1,68,276,277,1975,2043,23896,0,0,0,0
charactercreate-vignette-bottom,21736,708,1,577,439,440,578,1155,23897,0,0,0,0
charactercreate-vignette-sides-widescreen,21737,708,89,1,1,90,2041,2042,23898,0,0,0,0
charactercreate-vignette-sides,21738,708,703,1,439,1142,575,576,23899,0,0,0,0
charactercreate-vignette-top,21739,708,1,451,439,440,1157,1608,23900,0,0,0,0
minimal-scrollbar-small-arrow-bottom-down,21992,2452,17,11,1,18,18,29,24082,0,0,0,0
minimal-scrollbar-small-arrow-bottom-over,21993,2452,17,11,20,37,18,29,24083,0,0,0,0
minimal-scrollbar-small-arrow-bottom,21994,2452,17,11,39,56,18,29,24084,0,0,0,0
minimal-scrollbar-small-arrow-returntobottom-down,21995,2452,17,15,1,18,1,16,24085,0,0,0,0
minimal-scrollbar-small-arrow-returntobottom-over,21996,2452,17,15,20,37,1,16,24086,0,0,0,0
minimal-scrollbar-small-arrow-returntobottom,21997,2452,17,15,39,56,1,16,24087,0,0,0,0
minimal-scrollbar-small-arrow-top-down,21998,2452,17,11,1,18,31,42,24088,0,0,0,0
minimal-scrollbar-small-arrow-top-over,21999,2452,17,11,1,18,44,55,24089,0,0,0,0
minimal-scrollbar-small-arrow-top,22000,2452,17,11,20,37,31,42,24090,0,0,0,0
minimal-scrollbar-small-thumb-bottom-down,22001,2452,8,8,39,47,31,39,24091,0,0,0,0
minimal-scrollbar-small-thumb-bottom-over,22002,2452,8,8,49,57,31,39,24092,0,0,0,0
minimal-scrollbar-small-thumb-bottom,22003,2452,8,8,20,28,44,52,24093,0,0,0,0
minimal-scrollbar-small-thumb-top-down,22004,2452,8,8,20,28,54,62,24094,0,0,0,0
minimal-scrollbar-small-thumb-top-over,22005,2452,8,8,30,38,44,52,24095,0,0,0,0
minimal-scrollbar-small-thumb-top,22006,2452,8,8,30,38,54,62,24096,0,0,0,0
minimal-scrollbar-small-track-bottom,22007,2452,8,8,40,48,44,52,24097,0,0,0,0
minimal-scrollbar-small-track-top,22008,2452,8,8,40,48,54,62,24098,0,0,0,0
!minimal-scrollbar-small-track-middle,22009,2453,8,1,1,9,0,1,24099,0,0,2,0
minimal-scrollbar-small-thumb-middle-down,22010,2453,8,715,11,19,1,716,24100,0,0,0,0
minimal-scrollbar-small-thumb-middle-over,22011,2453,8,715,21,29,1,716,24101,0,0,0,0
minimal-scrollbar-small-thumb-middle,22012,2453,8,715,31,39,1,716,24102,0,0,0,0
ui-frame-botcornerleft,22066,2461,14,14,57,71,81,95,24153,0,0,0,0
ui-frame-botcornerright,22067,2461,11,11,116,127,63,74,24154,0,0,0,0
ui-frame-btncornerleft,22068,2461,12,32,1,13,81,113,24155,0,0,0,0
ui-frame-btncornerright,22069,2461,12,32,15,27,81,113,24156,0,0,0,0
ui-frame-btndivleft,22070,2461,11,25,116,127,36,61,24157,0,0,0,0
ui-frame-btndivmiddle,22071,2461,13,25,29,42,81,106,24158,0,0,0,0
ui-frame-btndivright,22072,2461,11,25,44,55,81,106,24159,0,0,0,0
ui-frame-innerbotleftcorner,22073,2461,6,6,81,87,71,77,24160,0,0,0,0
ui-frame-innerbotright,22074,2461,6,6,89,95,71,77,24161,0,0,0,0
ui-frame-innersplitleft,22075,2461,9,14,117,126,1,15,24162,0,0,0,0
ui-frame-innersplitright,22076,2461,9,14,117,126,17,31,24163,0,0,0,0
ui-frame-innertopleft,22077,2461,6,6,97,103,71,77,24164,0,0,0,0
ui-frame-innertopright,22078,2461,6,6,105,111,71,77,24165,0,0,0,0
ui-frame-portrait,22079,2461,78,78,1,79,1,79,24166,0,0,0,0
ui-frame-topcornerright,22080,2461,33,33,81,114,36,69,24167,0,0,0,0
ui-frame-topcornerrightsimple,22081,2461,11,11,1,12,115,126,24168,0,0,0,0
ui-frame-topleftcorner,22082,2461,14,14,57,71,97,111,24169,0,0,0,0
ui-frame-topleftcornernoportrait,22083,2461,34,33,81,115,1,34,24170,0,0,0,0
optionsframe-nineslice-cornerbottomleft,22119,2464,32,32,1,33,69,101,24206,0,0,0,0
optionsframe-nineslice-cornerbottomright,22120,2464,32,32,1,33,103,135,24207,0,0,0,0
optionsframe-nineslice-cornertopleft,22121,2464,32,32,1,33,137,169,24208,0,0,0,0
optionsframe-nineslice-cornertopright,22122,2464,32,32,1,33,171,203,24209,0,0,0,0
_optionsframe-nineslice-edgebottom,22123,2464,32,32,0,32,1,33,24210,0,0,4,0
_optionsframe-nineslice-edgetop,22124,2464,32,32,0,32,35,67,24211,0,0,4,0
!optionsframe-nineslice-edgeleft,22128,2466,32,32,1,33,0,32,24216,0,0,2,0
!optionsframe-nineslice-edgeright,22129,2466,32,32,35,67,0,32,24217,0,0,2,0
!ui-frame-innerlefttile,22130,2467,3,256,31,34,0,256,24218,0,0,2,0
!ui-frame-innerrighttile,22131,2467,3,256,36,39,0,256,24219,0,0,2,0
!ui-frame-lefttile,22132,2467,16,256,1,17,0,256,24220,0,0,2,0
!ui-frame-righttile,22133,2467,10,256,19,29,0,256,24221,0,0,2,0
_ui-frame-bot,22134,2468,256,9,0,256,95,104,24222,0,0,4,0
_ui-frame-btnbottile,22135,2468,256,3,0,256,106,109,24223,0,0,4,0
_ui-frame-innerbottile,22136,2468,256,3,0,256,111,114,24224,0,0,4,0
_ui-frame-innertoptile,22137,2468,256,3,0,256,116,119,24225,0,0,4,0
_ui-frame-titletile,22138,2468,256,28,0,256,46,74,24226,0,0,4,0
_ui-frame-titletilebg,22139,2468,256,17,0,256,76,93,24227,0,0,4,0
_ui-frame-toptilestreaks,22140,2468,256,43,0,256,1,44,24228,0,0,4,0
battlenet-diablo4icon,22469,1972,32,32,35,67,137,169,24484,0,0,0,0
ui-chaticon-diablo4,22470,1971,32,32,35,67,137,169,24485,0,0,0,0
clickcastlist-buttonbackground,23521,117,393,46,1,394,1,47,24907,0,0,0,0
clickcastlist-buttonhighlight,23522,117,393,46,1,394,49,95,24908,0,0,0,0
clickcastlist-buttonnew,23523,117,393,46,1,394,97,143,24909,0,0,0,0
reportlist-buttonselect,23524,117,393,46,1,394,145,191,24910,0,0,0,0
uitools-button-background-active,23764,2561,90,34,121,211,40,74,25514,0,0,0,0
uitools-button-background-default,23765,2561,90,34,121,211,4,38,25515,0,0,0,0
uitools-button-background-disabled,23766,2561,90,34,121,211,76,110,25516,0,0,0,0
uitools-tab-background-default,23777,2561,128,32,331,459,38,70,25527,0,0,0,0
uitools-tab-background-active,23778,2561,128,32,331,459,4,36,25528,0,0,0,0
uitools-title-bar-background,23781,2561,34,34,365,399,72,106,25529,0,0,0,0
ui-lfg-declinemark-raid,23953,2597,64,64,1947,2011,259,323,25207,0,0,0,0
ui-lfg-declinemark,23954,2597,200,200,1801,2001,1,201,25208,40,40,0,0
ui-lfg-dividerline,23955,2597,368,4,517,885,773,777,25209,0,0,0,0
ui-lfg-pendingmark-raid,23956,2597,64,64,1947,2011,325,389,25210,0,0,0,0
ui-lfg-pendingmark,23957,2597,200,200,1543,1743,259,459,25211,40,40,0,0
ui-lfg-readymark-raid,23958,2597,64,64,1947,2011,391,455,25212,0,0,0,0
ui-lfg-readymark,23959,2597,200,200,1745,1945,259,459,25213,40,40,0,0
ui-lfg-roleicon-decline,23960,2597,256,256,1543,1799,1,257,25214,70,70,0,0
ui-lfg-roleicon-dps-background,23961,2597,512,512,1,513,1,513,25215,100,100,0,0
ui-lfg-roleicon-dps-disabled,23962,2597,256,256,1,257,515,771,25216,70,70,0,0
ui-lfg-roleicon-dps-micro-raid,23963,2597,12,12,2022,2034,1,13,25217,0,0,0,0
ui-lfg-roleicon-dps-micro,23964,2597,61,61,1,62,1805,1866,25218,0,0,0,0
ui-lfg-roleicon-dps,23965,2597,256,256,1,257,773,1029,25219,70,70,0,0
ui-lfg-roleicon-generic-disabled,23966,2597,256,256,1,257,1031,1287,25220,70,70,0,0
ui-lfg-roleicon-generic-micro-raid,23967,2597,12,12,2003,2015,20,32,25221,0,0,0,0
ui-lfg-roleicon-generic-micro,23968,2597,61,61,1,62,1868,1929,25222,0,0,0,0
ui-lfg-roleicon-generic,23969,2597,256,256,1,257,1289,1545,25223,70,70,0,0
ui-lfg-roleicon-healer-background,23970,2597,512,512,515,1027,1,513,25224,100,100,0,0
ui-lfg-roleicon-healer-disabled,23971,2597,256,256,1,257,1547,1803,25225,70,70,0,0
ui-lfg-roleicon-healer-micro-raid,23972,2597,12,12,2017,2029,20,32,25226,0,0,0,0
ui-lfg-roleicon-healer-micro,23973,2597,61,61,1,62,1931,1992,25227,0,0,0,0
ui-lfg-roleicon-healer,23974,2597,256,256,259,515,515,771,25228,70,70,0,0
ui-lfg-roleicon-incentive,23975,2597,256,256,259,515,773,1029,25229,70,70,0,0
ui-lfg-roleicon-leader-disabled,23976,2597,256,256,259,515,1031,1287,25230,70,70,0,0
ui-lfg-roleicon-leader-micro-raid,23977,2597,12,12,2031,2043,20,32,25231,0,0,0,0
ui-lfg-roleicon-leader-micro,23978,2597,61,61,64,125,1805,1866,25232,0,0,0,0
ui-lfg-roleicon-leader,23979,2597,256,256,259,515,1289,1545,25233,70,70,0,0
ui-lfg-roleicon-pending,23980,2597,256,256,259,515,1547,1803,25234,70,70,0,0
ui-lfg-roleicon-rangeddps-disabled,23981,2597,256,256,517,773,515,771,25235,70,70,0,0
ui-lfg-roleicon-rangeddps-micro-raid,23982,2597,12,12,2003,2015,34,46,25236,0,0,0,0
ui-lfg-roleicon-rangeddps-micro,23983,2597,61,61,127,188,1805,1866,25237,0,0,0,0
ui-lfg-roleicon-rangeddps,23984,2597,256,256,775,1031,515,771,25238,70,70,0,0
ui-lfg-roleicon-ready,23985,2597,256,256,1033,1289,515,771,25239,70,70,0,0
ui-lfg-roleicon-tank-background,23986,2597,512,512,1029,1541,1,513,25240,100,100,0,0
ui-lfg-roleicon-tank-disabled,23987,2597,256,256,1291,1547,515,771,25241,70,70,0,0
ui-lfg-roleicon-tank-micro-raid-role,23988,2597,17,17,2003,2020,1,18,25242,0,0,0,0
ui-lfg-roleicon-tank-micro-raid,23989,2597,12,12,2017,2029,34,46,25243,0,0,0,0
ui-lfg-roleicon-tank-micro,23990,2597,61,61,190,251,1805,1866,25244,0,0,0,0
ui-lfg-roleicon-tank,23991,2597,256,256,1549,1805,515,771,25245,70,70,0,0
uiframe-activetab-left,23998,2599,35,42,1,36,127,169,25252,0,0,0,0
uiframe-activetab-right,23999,2599,37,42,1,38,83,125,25253,0,0,0,0
uiframe-tab-left,24000,2599,35,36,1,36,209,245,25254,0,0,0,0
uiframe-tab-right,24001,2599,37,36,1,38,171,207,25255,0,0,0,0
_uiframe-activetab-center,24002,2599,1,42,0,1,1,43,25256,0,0,4,0
_uiframe-tab-center,24003,2599,1,36,0,1,45,81,25257,0,0,4,0
groupfinder-background-arenas,24071,2601,333,96,1,334,1,97,9086,0,0,0,0
groupfinder-background-ashran,24072,2601,333,96,1,334,273,369,9087,0,0,0,0
groupfinder-background-battlegrounds,24073,2601,333,96,336,669,77,173,9088,0,0,0,0
groupfinder-background-custom-pve,24074,2601,333,96,336,669,175,271,9089,0,0,0,0
groupfinder-background-custom-pvp,24075,2601,333,96,671,1004,77,173,9090,0,0,0,0
groupfinder-background-dungeons,24076,2601,333,96,1,334,99,195,9091,0,0,0,0
groupfinder-background-islands,24077,2601,333,96,1341,1674,77,173,25269,0,0,0,0
groupfinder-background-questing,24078,2601,333,96,1,334,410,506,9092,0,0,0,0
groupfinder-background-raids-battleforazeroth,24079,2601,333,96,336,669,273,369,25270,0,0,0,0
groupfinder-background-raids-dragonflight,24080,2601,333,96,336,669,371,467,25271,0,0,0,0
groupfinder-background-raids-legion,24081,2601,333,96,671,1004,175,271,10055,0,0,0,0
groupfinder-background-raids-shadowlands,24082,2601,333,96,1006,1339,77,173,25272,0,0,0,0
groupfinder-background-raids-warlords,24083,2601,333,96,671,1004,371,467,9101,0,0,0,0
groupfinder-background-ratedbgs,24084,2601,333,96,1676,2009,77,173,9098,0,0,0,0
groupfinder-background-scenarios,24085,2601,333,96,671,1004,273,369,9099,0,0,0,0
groupfinder-background-skirmishes,24086,2601,333,96,1671,2004,175,271,9100,0,0,0,0
groupfinder-background-torghast,24087,2601,333,96,1336,1669,175,271,25273,0,0,0,0
groupfinder-background,24088,2601,328,336,1006,1334,175,511,8386,0,0,0,0
groupfinder-button-arenas,24089,2601,290,36,1,291,235,271,8387,0,0,0,0
groupfinder-button-ashran,24090,2601,290,36,982,1272,1,37,9085,0,0,0,0
groupfinder-button-battlegrounds,24091,2601,290,36,336,626,1,37,8388,0,0,0,0
groupfinder-button-cover-down,24092,2601,300,46,1336,1636,273,319,8195,0,0,0,0
groupfinder-button-cover,24093,2601,300,46,1638,1938,273,319,8389,0,0,0,0
groupfinder-button-custom-pve,24094,2601,290,36,1336,1626,359,395,8390,0,0,0,0
groupfinder-button-custom-pvp,24095,2601,290,36,628,918,39,75,8391,0,0,0,0
groupfinder-button-dungeons,24096,2601,290,36,336,626,469,505,8392,0,0,0,0
groupfinder-button-highlight,24097,2601,292,37,671,963,469,506,8193,0,0,0,0
groupfinder-button-islands,24098,2601,290,36,1243,1533,39,75,25274,0,0,0,0
groupfinder-button-questing,24099,2601,290,36,336,626,39,75,8393,0,0,0,0
groupfinder-button-raids-battleforazeroth,24100,2601,290,36,1611,1901,39,75,25275,0,0,0,0
groupfinder-button-raids-dragonflight,24101,2601,290,36,951,1241,39,75,25276,0,0,0,0
groupfinder-button-raids-legion,24102,2601,290,36,1336,1626,321,357,10056,0,0,0,0
groupfinder-button-raids-shadowlands,24103,2601,290,36,1628,1918,321,357,25277,0,0,0,0
groupfinder-button-raids-warlords,24104,2601,290,36,1274,1564,1,37,9102,0,0,0,0
groupfinder-button-ratedbgs,24105,2601,290,36,690,980,1,37,8399,0,0,0,0
groupfinder-button-scenarios,24106,2601,290,36,1489,1779,397,433,8400,0,0,0,0
groupfinder-button-select,24107,2601,292,37,1,293,371,408,8194,0,0,0,0
groupfinder-button-skirmishes,24108,2601,290,36,1,291,197,233,8401,0,0,0,0
groupfinder-button-torghast,24109,2601,290,36,1566,1856,1,37,25278,0,0,0,0
groupfinder-eye-highlight,24110,2601,86,86,1336,1422,397,483,8596,0,0,0,0
groupfinder-highlightbar-blue,24111,2601,304,32,1628,1932,359,391,8402,0,0,0,0
groupfinder-highlightbar-green,24112,2601,304,32,1489,1793,469,501,8382,0,0,0,0
groupfinder-highlightbar-yellow,24113,2601,304,32,1489,1793,435,467,8383,0,0,0,0
groupfinder-icon-class-deathknight,24114,2601,29,29,1924,1953,1,30,8770,0,0,0,0
groupfinder-icon-class-demonhunter,24115,2601,29,29,1549,1578,39,68,10326,0,0,0,0
groupfinder-icon-class-druid,24116,2601,29,29,920,949,39,68,8781,0,0,0,0
groupfinder-icon-class-hunter,24117,2601,29,29,1858,1887,1,30,8782,0,0,0,0
groupfinder-icon-class-mage,24118,2601,29,29,2017,2046,1,30,8783,0,0,0,0
groupfinder-icon-class-monk,24119,2601,29,29,1955,1984,1,30,8784,0,0,0,0
groupfinder-icon-class-paladin,24120,2601,29,29,1580,1609,39,68,9071,0,0,0,0
groupfinder-icon-class-priest,24121,2601,29,29,659,688,1,30,9072,0,0,0,0
groupfinder-icon-class-rogue,24122,2601,29,29,293,322,197,226,9073,0,0,0,0
groupfinder-icon-class-shaman,24123,2601,29,29,293,322,235,264,9074,0,0,0,0
groupfinder-icon-class-warlock,24124,2601,29,29,628,657,1,30,9075,0,0,0,0
groupfinder-icon-class-warrior,24125,2601,29,29,295,324,371,400,9076,0,0,0,0
groupfinder-icon-emptyslot,24126,2601,29,29,1986,2015,1,30,9077,0,0,0,0
groupfinder-icon-friend,24127,2601,20,19,1902,1922,1,20,8206,0,0,0,0
groupfinder-icon-greencheckmark,24128,2601,11,13,1889,1900,1,14,8384,0,0,0,0
groupfinder-icon-leader,24129,2601,14,9,1902,1916,22,31,8444,0,0,0,0
groupfinder-icon-lock,24130,2601,63,76,1424,1487,397,473,25279,28,34,0,0
groupfinder-icon-quest,24131,2601,14,14,1934,1948,39,53,9078,0,0,0,0
groupfinder-icon-redx,24132,2601,12,12,1535,1547,39,51,8385,0,0,0,0
groupfinder-icon-role-large-dps,24133,2601,29,29,1950,1979,39,68,9079,0,0,0,0
groupfinder-icon-role-large-heal,24134,2601,29,29,2002,2031,39,68,9080,0,0,0,0
groupfinder-icon-role-large-tank,24135,2601,29,29,1903,1932,39,68,9081,0,0,0,0
groupfinder-icon-voice,24136,2601,16,14,1981,1997,59,73,8205,0,0,0,0
groupfinder-waitdot,24137,2601,19,18,1981,2000,39,57,9127,0,0,0,0
bag-arrow-2x,24148,2603,20,32,484,504,1,33,25290,0,0,0,1
bag-border-2x,24149,2603,61,61,295,356,1,62,25291,0,0,0,1
bag-border-empty-2x,24150,2603,61,61,295,356,64,125,25292,0,0,0,1
bag-border-highlight-2x,24151,2603,61,61,358,419,1,62,25293,0,0,0,1
bag-border-search-2x,24152,2603,61,61,358,419,64,125,25294,0,0,0,1
bag-main-2x,24153,2603,96,96,1,97,1,97,25295,0,0,0,1
bag-main-highlight-2x,24154,2603,96,96,99,195,1,97,25296,0,0,0,1
bag-main-search-2x,24155,2603,96,96,197,293,1,97,25297,0,0,0,0
bag-reagent-border-2x,24156,2603,61,61,421,482,1,62,25298,0,0,0,0
bag-reagent-border-empty-2x,24157,2603,61,61,421,482,64,125,25299,0,0,0,0
redbutton-condense-disabled,24171,2605,18,19,1,19,1,20,25313,0,0,0,0
redbutton-condense-pressed,24172,2605,18,19,1,19,22,41,25314,0,0,0,0
redbutton-condense,24173,2605,18,19,1,19,43,62,25315,0,0,0,0
redbutton-exit-disabled,24174,2605,18,19,21,39,1,20,25316,0,0,0,0
redbutton-exit-pressed,24175,2605,18,19,21,39,22,41,25317,0,0,0,0
redbutton-exit,24176,2605,18,19,21,39,43,62,25318,0,0,0,0
redbutton-expand-disabled,24177,2605,18,19,41,59,1,20,25319,0,0,0,0
redbutton-expand-pressed,24178,2605,18,19,41,59,22,41,25320,0,0,0,0
redbutton-expand,24179,2605,18,19,41,59,43,62,25321,0,0,0,0
redbutton-highlight,24180,2605,18,19,61,79,1,20,25322,0,0,0,0
redbutton-minicondense-disabled,24181,2605,18,19,61,79,22,41,25323,0,0,0,0
redbutton-minicondense-pressed,24182,2605,18,19,61,79,43,62,25324,0,0,0,0
redbutton-minicondense,24183,2605,18,19,81,99,1,20,25325,0,0,0,0
groupfinder-eye-backglow,24221,2612,82,82,1905,1987,1,83,25364,0,0,0,0
groupfinder-eye-circshine,24222,2612,41,41,1465,1506,267,308,25365,0,0,0,0
groupfinder-eye-flipbook-found-initial,24223,2612,484,308,933,1417,1,309,25366,0,0,0,0
groupfinder-eye-flipbook-found-loop,24224,2612,484,176,487,971,535,711,25367,0,0,0,0
groupfinder-eye-flipbook-foundfx,24225,2612,930,310,1,931,1,311,25368,0,0,0,0
groupfinder-eye-flipbook-initial,24226,2612,484,220,487,971,313,533,25369,0,0,0,0
groupfinder-eye-flipbook-mouseover,24227,2612,516,43,973,1489,313,356,25370,0,0,0,0
groupfinder-eye-flipbook-poke-end,24228,2612,484,176,487,971,713,889,25371,0,0,0,0
groupfinder-eye-flipbook-poke-initial,24229,2612,484,264,1419,1903,1,265,25372,0,0,0,0
groupfinder-eye-flipbook-poke-loop,24230,2612,484,264,1,485,667,931,25373,0,0,0,0
groupfinder-eye-flipbook-searching,24231,2612,484,352,1,485,313,665,25374,0,0,0,0
groupfinder-eye-frame,24232,2612,52,52,1989,2041,1,53,25375,0,0,0,0
groupfinder-eye-frontglow,24233,2612,50,50,1905,1955,85,135,25376,0,0,0,0
groupfinder-eye-single,24234,2612,44,44,1419,1463,267,311,25377,0,0,0,0
uitools-window-background-shadow,24560,2561,94,94,235,329,4,98,25532,0,0,0,0
uitools-search-background,24562,2561,24,24,235,259,100,124,25534,0,0,0,0
uitools-scrollbar-thumb,24565,2561,8,9,1,9,111,120,25537,0,0,0,0
uitools-scrollbar-track,24566,2561,8,9,141,149,112,121,25538,0,0,0,0
uitools-tab-gradient,24570,2561,32,32,331,363,72,104,25541,0,0,0,0
uitools-scrollbar-thumb-down,24603,2561,8,9,11,19,111,120,25566,0,0,0,0
uitools-scrollbar-thumb-over,24604,2561,8,9,131,139,112,121,25567,0,0,0,0
uitools-icon-highlight,24605,2561,24,24,48,72,77,101,25568,0,0,0,0
nineslicetool-dottedline-horizontal,24616,2561,23,1,45,68,1,2,25577,0,0,0,0
nineslicetool-dottedline-vertical,24617,2561,1,23,45,46,4,27,25578,0,0,0,0
uitools-scrollbar-chevron-bottom-disabled,24786,2561,20,20,23,43,23,43,25569,0,0,0,0
uitools-scrollbar-chevron-bottom-down,24787,2561,20,20,1,21,89,109,25570,0,0,0,0
uitools-scrollbar-chevron-bottom-over,24788,2561,20,20,23,43,45,65,25571,0,0,0,0
uitools-scrollbar-chevron-bottom,24789,2561,20,20,1,21,1,21,25572,0,0,0,0
uitools-scrollbar-chevron-top-disabled,24790,2561,20,20,213,233,48,68,25573,0,0,0,0
uitools-scrollbar-chevron-top-down,24791,2561,20,20,213,233,92,112,25574,0,0,0,0
uitools-scrollbar-chevron-top-over,24792,2561,20,20,213,233,70,90,25575,0,0,0,0
uitools-scrollbar-chevron-top,24793,2561,20,20,23,43,67,87,25576,0,0,0,0
uitools-icon-checkbox,24797,2561,20,20,48,68,103,123,25517,0,0,0,0
uitools-icon-checkmark,24798,2561,22,20,96,118,77,97,25518,0,0,0,0
uitools-icon-chevron-down,24799,2561,20,20,23,43,89,109,25727,0,0,0,0
uitools-icon-chevron-left,24800,2561,20,20,23,43,1,21,25519,0,0,0,0
uitools-icon-chevron-right,24801,2561,20,20,1,21,67,87,25520,0,0,0,0
uitools-icon-close,24802,2561,20,20,1,21,45,65,25521,0,0,0,0
uitools-icon-minimize,24803,2561,20,20,74,94,77,97,25533,0,0,0,0
uitools-icon-refresh,24804,2561,20,20,96,116,99,119,25522,0,0,0,0
uitools-icon-search,24805,2561,20,20,213,233,26,46,25523,0,0,0,0
common-dropdown-a-button-disabled,24812,2634,27,27,1,28,29,56,25588,0,0,0,0
common-dropdown-a-button-hover,24813,2634,27,27,1,28,87,114,25553,0,0,0,0
common-dropdown-a-button-open,24814,2634,27,27,1,28,145,172,25559,0,0,0,0
common-dropdown-a-button-pressed,24815,2634,27,27,1,28,174,201,25554,0,0,0,0
common-dropdown-a-button-pressedhover,24816,2634,27,27,1,28,116,143,25555,0,0,0,0
common-dropdown-a-button,24817,2634,27,27,1,28,58,85,25556,0,0,0,0
common-dropdown-b-button-disabled,24818,2634,97,26,129,226,29,55,25589,0,0,0,0
common-dropdown-b-button-hover,24819,2634,97,26,30,127,29,55,25548,0,0,0,0
common-dropdown-b-button-open,24820,2634,97,26,30,127,57,83,25560,0,0,0,0
common-dropdown-b-button-pressed,24821,2634,97,26,129,226,57,83,25549,0,0,0,0
common-dropdown-b-button-pressedhover,24822,2634,97,26,1,98,1,27,25550,0,0,0,0
common-dropdown-b-button,24823,2634,97,26,100,197,1,27,25551,0,0,0,0
common-dropdown-bg,24824,2634,68,68,112,180,177,245,25557,0,0,0,0
common-dropdown-c-bg,24825,2634,90,90,112,202,85,175,25590,0,0,0,0
common-dropdown-c-button-disabled,24826,2634,39,39,30,69,126,165,25591,0,0,0,0
common-dropdown-c-button-hover-1,24827,2634,39,39,30,69,167,206,25728,0,0,0,0
common-dropdown-c-button-hover-2,24828,2634,39,39,71,110,167,206,25729,0,0,0,0
common-dropdown-c-button-hover-arrow,24829,2634,12,5,199,211,20,25,25565,0,0,0,0
common-dropdown-c-button-open,24830,2634,39,39,30,69,208,247,25513,0,0,0,0
common-dropdown-c-button-pressed-1,24831,2634,39,39,71,110,126,165,25730,0,0,0,0
common-dropdown-c-button-pressed-2,24832,2634,39,39,71,110,85,124,25731,0,0,0,0
common-dropdown-c-button-pressedhover-1,24833,2634,39,39,204,243,85,124,25732,0,0,0,0
common-dropdown-c-button-pressedhover-2,24834,2634,39,39,71,110,208,247,25733,0,0,0,0
common-dropdown-c-button,24835,2634,39,39,30,69,85,124,25502,0,0,0,0
common-dropdown-icon-checkmark-yellow,24836,2634,15,14,228,243,57,71,25561,0,0,0,0
common-dropdown-icon-radialtick-yellow,24837,2634,18,18,237,255,1,19,25562,0,0,0,0
common-dropdown-textholder,24838,2634,54,41,182,236,197,238,25558,0,0,0,0
common-dropdown-tickradial,24839,2634,18,18,182,200,177,195,25563,0,0,0,0
common-dropdown-ticksquare,24840,2634,12,12,242,254,126,138,25564,0,0,0,0
common-dropdown-icon-back-disabled,24841,2634,17,17,228,245,29,46,25734,0,0,0,0
common-dropdown-icon-back,24842,2634,17,17,218,235,1,18,25735,0,0,0,0
common-dropdown-icon-next-disabled,24843,2634,17,17,199,216,1,18,25736,0,0,0,0
common-dropdown-icon-next,24844,2634,17,17,204,221,126,143,25737,0,0,0,0
common-dropdown-icon-play,24845,2634,17,17,1,18,225,242,25738,0,0,0,0
common-dropdown-icon-sound-off,24846,2634,17,17,223,240,145,162,25739,0,0,0,0
common-dropdown-icon-sound-on,24847,2634,17,17,204,221,145,162,25740,0,0,0,0
common-dropdown-icon-stop,24848,2634,17,17,223,240,126,143,25741,0,0,0,0
common-icon-undo,24925,2653,256,256,1,257,1,257,25838,25,25,0,0
common-icon-zoomout,24926,2653,256,256,1,257,259,515,25839,25,25,0,0
common-icon-checkmark-yellow,24927,2653,256,256,1,257,517,773,25840,25,25,0,0
common-icon-forwardarrow_alt,24928,2653,256,256,259,515,1,257,25841,45,45,0,0
common-icon-zoomout-disable,24929,2653,256,256,259,515,259,515,25842,25,25,0,0
common-icon-zoomin-disable,24930,2653,256,256,259,515,517,773,25843,25,25,0,0
common-icon-rotateleft,24931,2653,100,100,1,101,775,875,25844,20,20,0,0
common-icon-checkmark,24932,2653,256,256,517,773,1,257,25845,25,25,0,0
common-icon-redx,24933,2653,256,256,517,773,259,515,25846,25,25,0,0
common-icon-forwardarrow,24934,2653,256,256,517,773,517,773,25847,45,45,0,0
common-icon-rotateright,24935,2653,100,100,1,101,877,977,25848,20,20,0,0
common-icon-forwardarrow-disable,24936,2653,256,256,775,1031,1,257,25849,45,45,0,0
common-icon-zoomin,24937,2653,256,256,775,1031,259,515,25850,25,25,0,0
common-icon-backarrow-disable,24938,2653,256,256,775,1031,517,773,25851,45,45,0,0
common-icon-backarrow,24939,2653,256,256,1033,1289,1,257,25852,45,45,0,0
common-dropdown-c-bg-2x,24978,2658,180,180,1,181,1,181,25590,0,0,0,0
common-dropdown-c-button-2x,24979,2658,78,78,431,509,1,79,25502,0,0,0,0
common-dropdown-c-button-disabled-2x,24980,2658,78,78,321,399,85,163,25591,0,0,0,0
common-dropdown-c-button-hover-1-2x,24981,2658,78,78,401,479,85,163,25728,0,0,0,0
common-dropdown-c-button-hover-2-2x,24982,2658,78,78,1,79,345,423,25729,0,0,0,0
common-dropdown-c-button-hover-arrow-2x,24983,2658,24,10,321,345,165,175,25565,0,0,0,0
common-dropdown-c-button-open-2x,24984,2658,78,78,1,79,425,503,25513,0,0,0,0
common-dropdown-c-button-pressed-1-2x,24985,2658,78,78,81,159,345,423,25730,0,0,0,0
common-dropdown-c-button-pressed-2-2x,24986,2658,78,78,81,159,425,503,25731,0,0,0,0
common-dropdown-c-button-pressedhover-1-2x,24987,2658,78,78,161,239,345,423,25732,0,0,0,0
common-dropdown-c-button-pressedhover-2-2x,24988,2658,78,78,161,239,425,503,25733,0,0,0,0
common-dropdown-icon-back-2x,24989,2658,34,34,393,427,183,217,25735,0,0,0,0
common-dropdown-icon-back-disabled-2x,24990,2658,34,34,429,463,183,217,25734,0,0,0,0
common-dropdown-icon-next-2x,24991,2658,34,34,465,499,183,217,25737,0,0,0,0
common-dropdown-icon-next-disabled-2x,24992,2658,34,34,393,427,237,271,25736,0,0,0,0
common-dropdown-icon-play-2x,24993,2658,34,34,429,463,237,271,25738,0,0,0,0
common-dropdown-icon-sound-off-2x,24994,2658,34,34,465,499,237,271,25739,0,0,0,0
common-dropdown-icon-sound-on-2x,24995,2658,34,34,393,427,291,325,25740,0,0,0,0
common-dropdown-icon-stop-2x,24996,2658,34,34,429,463,291,325,25741,0,0,0,0
spinner_ring,25017,2664,142,142,204,346,1,143,25899,0,0,0,0
spinner_sparks,25018,2664,142,142,348,490,1,143,25900,0,0,0,0
uitools-icon-window-resize-down,25020,2561,8,8,33,41,111,119,25902,0,0,0,0
uitools-icon-window-resize-over,25021,2561,8,8,23,31,111,119,25905,0,0,0,0
uitools-icon-window-resize,25022,2561,8,8,121,129,112,120,25540,0,0,0,0
common-dropdown-a-button-2x,25023,2658,54,54,241,295,345,399,25556,0,0,0,0
common-dropdown-a-button-disabled-2x,25024,2658,54,54,241,295,401,455,25588,0,0,0,0
common-dropdown-a-button-hover-2x,25025,2658,54,54,241,295,457,511,25553,0,0,0,0
common-dropdown-a-button-open-2x,25026,2658,54,54,297,351,345,399,25559,0,0,0,0
common-dropdown-a-button-pressed-2x,25027,2658,54,54,297,351,401,455,25554,0,0,0,0
common-dropdown-a-button-pressedhover-2x,25028,2658,54,54,297,351,457,511,25555,0,0,0,0
common-dropdown-b-button-2x,25029,2658,194,52,1,195,183,235,25551,0,0,0,0
common-dropdown-b-button-disabled-2x,25030,2658,194,52,197,391,183,235,25589,0,0,0,0
common-dropdown-b-button-hover-2x,25031,2658,194,52,1,195,237,289,25548,0,0,0,0
common-dropdown-b-button-open-2x,25032,2658,194,52,197,391,237,289,25560,0,0,0,0
common-dropdown-b-button-pressed-2x,25033,2658,194,52,1,195,291,343,25549,0,0,0,0
common-dropdown-b-button-pressedhover-2x,25034,2658,194,52,197,391,291,343,25550,0,0,0,0
common-dropdown-bg-2x,25035,2658,136,136,183,319,1,137,25557,0,0,0,0
common-dropdown-icon-checkmark-yellow-2x,25036,2658,30,28,481,511,85,113,25561,0,0,0,0
common-dropdown-icon-radialtick-yellow-2x,25037,2658,36,36,225,261,139,175,25562,0,0,0,0
common-dropdown-textholder-2x,25038,2658,108,82,321,429,1,83,25558,0,0,0,0
common-dropdown-tickradial-2x,25039,2658,36,36,263,299,139,175,25563,0,0,0,0
common-dropdown-ticksquare-2x,25040,2658,24,24,481,505,115,139,25564,0,0,0,0
common-button-square-gray-down,25041,2666,256,256,1,257,291,547,25906,42,42,0,0
common-button-square-gray-up,25042,2666,256,256,1,257,549,805,25907,42,42,0,0
common-gray-button-entrybox-center,25043,2666,48,143,0,48,1,144,25908,16,48,4,0
common-gray-button-entrybox-left,25044,2666,39,143,938,977,146,289,25909,13,48,0,0
common-gray-button-entrybox-right,25045,2666,935,143,1,936,146,289,25910,314,48,0,0
common-dropdown-customize-mouseover-2x,25062,2658,40,40,183,223,139,179,25927,0,0,0,0
common-dropdown-customize-mouseover,25063,2634,20,20,1,21,203,223,25927,0,0,0,0
wowlabs-ability-icon-frame,25126,2683,60,60,329,389,1981,2041,25983,0,0,0,0
wowlabs-currency-container-2x,25127,2683,196,76,1039,1235,1482,1558,25954,0,0,0,0
wowlabs-currency-container-highlight-2x,25128,2683,196,76,1237,1433,1482,1558,25955,0,0,0,0
wowlabs-rarity-pip-bg,25129,2683,48,16,1951,1999,539,555,25972,0,0,0,0
wowlabs-rarity-pip,25130,2683,7,7,1377,1384,605,612,25973,0,0,0,0
wowlabs-spell-icon-frame-highlight,25131,2683,80,80,1039,1119,1560,1640,25984,0,0,0,0
wowlabs-switch-slots-key,25132,2683,64,32,323,387,1706,1738,25985,0,0,0,0
ui-hud-wowlabs-actionbar-bookend-left,25133,2683,152,80,237,389,1899,1979,25986,0,0,0,0
ui-hud-wowlabs-actionbar-bookend-right,25134,2683,152,80,879,1031,1596,1676,25987,0,0,0,0
ui-hud-wowlabs-actionbar-levelnumber-default,25135,2683,108,108,1919,2027,672,780,25988,0,0,0,0
ui-hud-wowlabs-actionbar-levelnumber-levelup,25136,2683,108,108,1919,2027,782,890,25989,0,0,0,0
ui-hud-wowlabs-actionbar-offense-cap,25137,2683,148,36,1197,1345,625,661,25990,0,0,0,0
ui-hud-wowlabs-actionbar-utility-cap,25138,2683,148,36,1719,1867,994,1030,25991,0,0,0,0
ui-hud-wowlabs-actionbar-xp-bg,25139,2683,320,320,1597,1917,672,992,25992,0,0,0,0
ui-hud-wowlabs-actionbar-xp-fill,25140,2683,320,320,1,321,1433,1753,25993,0,0,0,0
ui-hud-wowlabs-actionbar-xp-frame,25141,2683,320,320,395,715,1274,1594,25994,0,0,0,0
ui-hud-wowlabs-actionbar-xp-futurefill,25142,2683,320,320,395,715,1596,1916,25995,0,0,0,0
ui-hud-wowlabs-actionbar-xp-threshold,25143,2683,320,320,717,1037,1274,1594,25996,0,0,0,0
uitools-window-background,25158,2561,34,34,401,435,72,106,25530,0,0,0,0
classic_blizzcon23_splash,25194,2690,1974,1166,1,1975,1,1167,26033,493,291,0,0
spinner_shadow,25696,2664,201,201,1,202,1,202,26104,0,0,0,0
uitools-icon-minus,25699,2561,20,20,74,94,99,119,26107,0,0,0,0
uitools-icon-plus,25700,2561,20,20,213,233,4,24,26108,0,0,0,0
ui-debug-tool-icon-large,25788,2561,71,71,48,119,4,75,26167,0,0,0,0
ui-debug-tool-icon-small,25789,2561,20,20,1,21,23,43,26168,0,0,0,0
uitools-row-background-01,25793,2561,552,28,461,1013,34,62,25524,0,0,0,0
uitools-row-background-02,25794,2561,552,28,461,1013,64,92,25525,0,0,0,0
uitools-row-background-hover,25795,2561,552,28,461,1013,4,32,25526,0,0,0,0
plunderstorm-actionbar-topper-attack,26004,2683,160,96,1197,1357,527,623,26318,80,48,0,0
plunderstorm-actionbar-topper-offensive,26005,2683,708,96,945,1653,1050,1146,26319,354,48,0,0
plunderstorm-actionbar-topper-potion,26006,2683,160,96,1827,1987,561,657,26320,80,48,0,0
plunderstorm-actionbar-slot-background,26007,2683,84,84,1951,2035,189,273,26321,0,0,0,0
plunderstorm-actionbar-slot-border,26008,2683,84,84,1951,2035,281,365,26322,0,0,0,0
plunderstorm-actionbar-slot-corners,26009,2683,84,84,1951,2035,453,537,26323,0,0,0,0
plunderstorm-actionbar-slot-pip,26010,2683,16,16,1359,1375,605,621,26324,8,8,0,0
plunderstorm-actionbar-slot-pipbackground,26011,2683,84,84,879,963,1882,1966,26325,0,0,0,0
plunderstorm-stormbar-background,26014,2683,464,55,1470,1934,1148,1203,26328,0,0,0,0
plunderstorm-stormbar-border,26015,2683,464,55,1470,1934,1205,1260,26329,0,0,0,0
plunderstorm-stormbar-fill,26016,2683,464,55,1039,1503,1274,1329,26330,0,0,0,0
plunderstorm-stormbar-spark,26017,2683,58,40,1989,2047,627,667,26331,29,20,0,0
plunderstorm-spectate-arrow,26027,2683,21,33,1377,1398,625,658,26341,0,0,0,0
plunderstorm-spectate-background,26028,2683,523,65,945,1468,1148,1213,26342,0,0,0,0
plunderstorm-scenariotracker-active,26029,2683,263,91,1655,1918,1050,1141,26343,0,0,0,0
plunderstorm-scenariotracker-decoration,26030,2683,90,53,1936,2026,1148,1201,26344,0,0,0,0
plunderstorm-scenariotracker-waiting,26031,2683,263,91,1039,1302,1331,1422,26345,0,0,0,0
plunderstorm-toast-levelup-background,26032,2683,600,524,799,1399,1,525,26346,0,0,0,0
plunderstorm-icon-item,26041,2683,56,64,981,1037,1678,1742,26358,0,0,0,0
plunderstorm-icon-offensive,26042,2683,56,64,981,1037,1780,1844,26359,0,0,0,0
plunderstorm-icon-utility,26043,2683,56,64,1907,1963,1482,1546,26360,0,0,0,0
plunderstorm-icon-upgrade,26044,2683,56,64,965,1021,1882,1946,26361,0,0,0,0
plunderstorm-landingpagebutton-down,26081,2683,100,100,879,979,1678,1778,26398,0,0,0,0
plunderstorm-landingpagebutton-up,26082,2683,100,100,879,979,1780,1880,26399,0,0,0,0
plunderstorm-actionbar-slot-border-swappable,26087,2683,84,84,1951,2035,367,451,26403,0,0,0,0
plunderstorm-actionbar-tabswappable-background,26088,2683,148,72,717,865,1973,2045,26404,0,0,0,0
plunderstorm-toast-finish-lose,26089,2683,548,278,1401,1949,1,279,26405,0,0,0,0
plunderstorm-toast-finish-win,26090,2683,548,278,1401,1949,281,559,26406,0,0,0,0
plunderstorm-nameplates-icon-1,26091,2683,76,76,879,955,1968,2044,26407,0,0,0,0
plunderstorm-nameplates-icon-2,26092,2683,76,76,957,1033,1968,2044,26408,0,0,0,0
plunderstorm-nameplates-icon-3,26093,2683,76,76,1829,1905,1482,1558,26409,0,0,0,0
plunderstorm-scenariotracker-active-frame,26113,2683,263,91,395,658,1918,2009,26425,0,0,0,0
plunderstorm-scenariotracker-waiting-frame,26124,2683,263,91,1304,1567,1331,1422,26436,0,0,0,0
glues-characterselect-button-card-down-disabled-2x,26128,2727,64,64,1863,1927,1209,1273,26440,0,0,0,0
glues-characterselect-button-card-up-disabled-2x,26132,2727,64,64,659,723,1423,1487,26444,0,0,0,0
glues-characterselect-card-camp-2x,26135,2727,632,190,1345,1977,253,443,26447,0,0,0,0
glues-characterselect-card-drag-2x,26136,2727,632,190,635,1267,499,689,26448,0,0,0,0
glues-characterselect-card-empty-2x,26137,2727,632,190,1269,1901,499,689,26449,0,0,0,0
glues-characterselect-card-glow-2x,26138,2727,656,214,1381,2037,1,215,26450,0,0,0,0
glues-characterselect-card-glow-swap-2x,26139,2727,656,214,687,1343,253,467,26451,0,0,0,0
glues-characterselect-card-singles-2x,26140,2727,620,178,1,621,883,1061,26452,0,0,0,0
glues-characterselect-divider-2x,26141,2727,784,20,807,1591,1187,1207,26453,0,0,0,0
glues-characterselect-icon-addcard-2x,26142,2727,156,156,1887,2043,691,847,26454,0,0,0,0
glues-characterselect-icon-addcard-glow-2x,26143,2727,156,156,1,157,1887,2043,26455,0,0,0,0
glues-characterselect-icon-faction-alliance-2x,26144,2727,72,92,305,377,1701,1793,26456,0,0,0,0
glues-characterselect-icon-faction-alliance-selected-2x,26145,2727,86,112,499,585,1401,1513,26457,0,0,0,0
glues-characterselect-icon-faction-horde-2x,26146,2727,72,92,499,571,1723,1815,26458,0,0,0,0
glues-characterselect-icon-faction-horde-selected-2x,26147,2727,86,112,499,585,1515,1627,26459,0,0,0,0
glues-characterselect-icon-minus-2x,26148,2727,62,62,725,787,1423,1485,26460,0,0,0,0
glues-characterselect-icon-minus-pressed-2x,26149,2727,62,62,725,787,1615,1677,26461,0,0,0,0
glues-characterselect-icon-plus-2x,26150,2727,62,62,725,787,1679,1741,26462,0,0,0,0
glues-characterselect-icon-search-2x,26151,2727,28,28,1887,1915,849,877,26463,0,0,0,0
glues-characterselect-plus-pressed-2x,26152,2727,62,62,725,787,1871,1933,26464,0,0,0,0
glues-characterselect-scroll-arrow-down-2x,26153,2727,32,22,1917,1949,849,871,26465,0,0,0,0
glues-characterselect-scroll-arrow-up-2x,26154,2727,32,22,1951,1983,849,871,26466,0,0,0,0
glues-characterselect-button-card-down-disabled,26155,2726,32,32,989,1021,314,346,26440,0,0,0,0
glues-characterselect-button-card-up-disabled,26159,2726,32,32,794,826,537,569,26444,0,0,0,0
glues-characterselect-card-camp,26163,2726,316,95,675,991,128,223,26447,0,0,0,0
glues-characterselect-card-drag,26164,2726,316,95,319,635,252,347,26448,0,0,0,0
glues-characterselect-card-empty,26165,2726,316,95,637,953,252,347,26449,0,0,0,0
glues-characterselect-card-glow-swap,26166,2726,328,107,345,673,128,235,26451,0,0,0,0
glues-characterselect-card-glow,26167,2726,328,107,693,1021,1,108,26450,0,0,0,0
glues-characterselect-card-singles,26168,2726,310,89,1,311,446,535,26452,0,0,0,0
glues-characterselect-divider,26169,2726,392,10,625,1017,499,509,26453,0,0,0,0
glues-characterselect-icon-addcard-glow,26170,2726,78,78,192,270,772,850,26455,0,0,0,0
glues-characterselect-icon-addcard,26171,2726,78,78,192,270,692,770,26454,0,0,0,0
glues-characterselect-icon-faction-alliance-selected,26172,2726,43,56,272,315,692,748,26457,0,0,0,0
glues-characterselect-icon-faction-alliance,26173,2726,36,46,154,190,860,906,26456,0,0,0,0
glues-characterselect-icon-faction-horde-selected,26174,2726,43,56,272,315,750,806,26459,0,0,0,0
glues-characterselect-icon-faction-horde,26175,2726,36,46,658,694,639,685,26458,0,0,0,0
glues-characterselect-icon-minus-pressed,26176,2726,31,31,317,348,791,822,26461,0,0,0,0
glues-characterselect-icon-minus,26177,2726,31,31,317,348,692,723,26460,0,0,0,0
glues-characterselect-icon-plus-pressed,26178,2726,31,31,317,348,923,954,26467,0,0,0,0
glues-characterselect-icon-plus,26179,2726,31,31,317,348,824,855,26462,0,0,0,0
glues-characterselect-icon-search,26180,2726,14,14,1007,1021,371,385,26463,0,0,0,0
glues-characterselect-scroll-arrow-down,26181,2726,16,12,1007,1023,387,399,26465,0,0,0,0
glues-characterselect-scroll-arrow-up,26182,2726,16,12,625,641,519,531,26466,0,0,0,0
plunderstorm-icon-fullyupgraded,26183,2683,56,64,1989,2045,561,625,26468,0,0,0,0
glues-characterselect-tophud-bg-2x,26185,2727,660,102,1245,1905,883,985,26470,0,0,0,0
glues-characterselect-tophud-selected-left-2x,26186,2727,362,94,1,363,1509,1603,26471,0,0,0,0
glues-characterselect-tophud-selected-right-2x,26189,2727,362,94,1,363,1605,1699,26474,0,0,0,0
glues-characterselect-tophud-bg,26190,2726,330,51,625,955,446,497,26470,0,0,0,0
glues-characterselect-tophud-selected-left,26191,2726,181,47,1,182,762,809,26471,0,0,0,0
glues-characterselect-tophud-selected-right,26194,2726,181,47,1,182,811,858,26474,0,0,0,0
plunderstorm-icon-small-fullyupgraded,26195,2683,28,32,1347,1375,625,657,26475,21,24,0,0
plunderstorm-icon-small-item,26196,2683,28,32,1869,1897,994,1026,26476,21,24,0,0
plunderstorm-icon-small-offensive,26197,2683,28,32,1994,2022,998,1030,26477,21,24,0,0
plunderstorm-icon-small-upgrade,26198,2683,28,32,1,29,2006,2038,26478,21,24,0,0
plunderstorm-icon-small-utility,26199,2683,28,32,31,59,2006,2038,26479,21,24,0,0
glues-characterselect-button-collapseexpand,26200,2726,34,34,947,981,409,443,26480,0,0,0,0
glues-characterselect-card-all-bg,26201,2726,60,60,955,1015,252,312,26481,0,0,0,0
glues-characterselect-card-camp-bg,26202,2726,40,40,734,774,639,679,26482,0,0,0,0
glues-characterselect-scrollbar-bg,26203,2726,10,20,1007,1017,349,369,26483,0,0,0,0
glues-characterselect-scrollbar,26204,2726,10,20,1010,1020,225,245,26484,0,0,0,0
glues-characterselect-searchbar,26205,2726,24,24,998,1022,537,561,26485,0,0,0,0
glues-characterselect-button-collapseexpand-2x,26206,2727,68,68,1903,1971,621,689,26480,0,0,0,0
glues-characterselect-card-all-bg-2x,26207,2727,120,120,1903,2023,499,619,26481,0,0,0,0
glues-characterselect-card-camp-bg-2x,26208,2727,80,80,989,1069,1209,1289,26482,0,0,0,0
glues-characterselect-scrollbar-2x,26209,2727,20,40,2007,2027,445,485,26484,0,0,0,0
glues-characterselect-scrollbar-bg-2x,26210,2727,20,40,2025,2045,499,539,26483,0,0,0,0
glues-characterselect-searchbar-2x,26211,2727,48,48,1909,1957,445,493,26485,0,0,0,0
plunderstorm-stormbar-bgcenter,26212,2683,352,56,1569,1921,1331,1387,26486,176,28,0,0
plunderstorm-stormbar-bgleft,26213,2683,56,56,1411,1467,1215,1271,26487,28,28,0,0
plunderstorm-stormbar-bgright,26214,2683,56,56,1923,1979,1331,1387,26488,28,28,0,0
plunderstorm-stormbar-bordercenter,26215,2683,352,56,1039,1391,1424,1480,26489,176,28,0,0
plunderstorm-stormbar-borderleft,26216,2683,56,56,1981,2037,1331,1387,26490,28,28,0,0
plunderstorm-stormbar-borderright,26217,2683,56,56,1393,1449,1424,1480,26491,28,28,0,0
plunderstorm-stormbar-fill-filling,26218,2683,464,56,945,1409,1215,1271,26492,232,28,0,0
plunderstorm-toast-finish-matchend,26219,2683,548,222,395,943,1050,1272,26493,0,0,0,0
plunderstorm-ui-hud-unitframe-party-portraiton,26220,2683,120,49,1597,1717,994,1043,26494,0,0,0,0
glues-characterselect-carddivider-2x,26221,2727,649,5,687,1336,483,488,26497,0,0,0,0
glues-characterselect-listlauncher-bg-2x,26222,2727,740,74,1245,1985,987,1061,26498,0,0,0,0
glues-characterselect-carddivider,26223,2726,325,3,693,1018,110,113,26497,0,0,0,0
glues-characterselect-listlauncher-bg,26224,2726,370,37,192,562,537,574,26498,0,0,0,0
plunderstorm-scenariotracker-active-decoration,26225,2683,90,53,237,327,1981,2034,26499,0,0,0,0
plunderstorm-scenariotracker-waiting-decoration,26226,2683,90,53,1936,2026,1205,1258,26500,0,0,0,0
glues-characterselect-tophud-selected-line-left,26227,2726,175,6,693,868,115,121,26501,0,0,0,0
glues-characterselect-tophud-selected-line-middle,26228,2726,174,6,625,799,511,517,26502,0,0,0,0
glues-characterselect-tophud-selected-line-right,26229,2726,175,6,345,520,237,243,26503,0,0,0,0
glues-characterselect-tophud-selected-middle,26230,2726,24,47,986,1010,639,686,26504,0,0,0,0
glues-characterselect-tophud-bg-divider,26231,2726,2,44,1017,1019,252,296,26505,0,0,0,0
glues-characterselect-tophud-bg-divider-2x,26232,2727,4,88,2039,2043,1,89,26505,0,0,0,0
glues-characterselect-tophud-selected-line-left-2x,26233,2727,350,12,1381,1731,217,229,26501,0,0,0,0
glues-characterselect-tophud-selected-line-middle-2x,26234,2727,348,12,687,1035,469,481,26502,0,0,0,0
glues-characterselect-tophud-selected-line-right-2x,26235,2727,350,12,1381,1731,231,243,26503,0,0,0,0
glues-characterselect-tophud-selected-middle-2x,26236,2727,48,94,609,657,1291,1385,26504,0,0,0,0
glues-characterselect-card-selected-2x,26238,2727,684,244,695,1379,1,245,26507,0,0,0,0
glues-characterselect-card-selected,26239,2726,342,122,349,691,1,123,26507,0,0,0,0
glues-characterselect-button-collapseexpand-pressed-2x,26243,2727,68,68,1727,1795,1209,1277,26510,0,0,0,0
glues-characterselect-button-collapseexpand-pressed,26244,2726,34,34,656,690,537,571,26510,0,0,0,0
glues-characterselect-button-collapseexpand-hover,26259,2726,90,34,564,654,537,571,26525,0,0,0,0
glues-characterselect-card-camp-hover,26260,2726,316,95,1,317,252,347,26526,0,0,0,0
glues-characterselect-card-empty-hover,26261,2726,316,95,1,317,349,444,26527,0,0,0,0
glues-characterselect-card-selected-hover,26262,2726,342,122,1,343,128,250,26528,0,0,0,0
glues-characterselect-card-singles-hover,26263,2726,310,89,313,623,446,535,26529,0,0,0,0
glues-characterselect-icon-faction-alliance-hover,26264,2726,36,46,620,656,639,685,26530,0,0,0,0
glues-characterselect-icon-faction-horde-hover,26265,2726,36,46,696,732,639,685,26531,0,0,0,0
glues-characterselect-icon-minus-hover,26266,2726,31,31,317,348,758,789,26532,0,0,0,0
glues-characterselect-icon-plus-hover,26267,2726,31,31,317,348,890,921,26533,0,0,0,0
glues-characterselect-button-collapseexpand-hover-2x,26268,2727,180,68,807,987,1209,1277,26525,0,0,0,0
glues-characterselect-card-camp-hover-2x,26269,2727,632,190,1,633,499,689,26526,0,0,0,0
glues-characterselect-card-empty-hover-2x,26270,2727,632,190,1,633,691,881,26527,0,0,0,0
glues-characterselect-card-selected-hover-2x,26271,2727,684,244,1,685,253,497,26528,0,0,0,0
glues-characterselect-card-singles-hover-2x,26272,2727,620,178,623,1243,883,1061,26529,0,0,0,0
glues-characterselect-icon-faction-alliance-hover-2x,26273,2727,72,92,499,571,1629,1721,26530,0,0,0,0
glues-characterselect-icon-faction-horde-hover-2x,26274,2727,72,92,499,571,1817,1909,26531,0,0,0,0
glues-characterselect-icon-minus-hover-2x,26275,2727,62,62,725,787,1551,1613,26532,0,0,0,0
glues-characterselect-icon-plus-hover-2x,26276,2727,62,62,725,787,1807,1869,26533,0,0,0,0
plunderstorm-ui-hud-unitframe-player-portraiton-2x,26277,2683,396,142,799,1195,527,669,26534,0,0,0,2
plunderstorm-ui-hud-unitframe-player-portraiton,26278,2683,198,71,1435,1633,1482,1553,26535,0,0,0,0
glues-characterselect-button-card-hover,26282,2726,32,32,726,758,537,569,26538,0,0,0,0
glues-characterselect-button-card-hover-2x,26284,2727,64,64,659,723,1291,1355,26538,0,0,0,0
glues-characterselect-button-card-down-disabled-hover,26328,2726,32,32,692,724,537,569,26576,0,0,0,0
glues-characterselect-button-card-pressed,26329,2726,32,32,760,792,537,569,26577,0,0,0,0
glues-characterselect-button-card-up-disabled-hover,26330,2726,32,32,828,860,537,569,26578,0,0,0,0
glues-characterselect-button-card,26331,2726,32,32,955,987,314,346,26579,0,0,0,0
glues-characterselect-icon-arrowdown-hover,26332,2726,32,32,896,928,537,569,26580,0,0,0,0
glues-characterselect-icon-arrowdown-pressed,26334,2726,32,32,930,962,537,569,26582,0,0,0,0
glues-characterselect-icon-arrowdown,26335,2726,32,32,862,894,537,569,26583,0,0,0,0
glues-characterselect-icon-arrowup-hover,26336,2726,32,32,272,304,884,916,26584,0,0,0,0
glues-characterselect-icon-arrowup-pressed,26338,2726,32,32,272,304,918,950,26586,0,0,0,0
glues-characterselect-icon-arrowup,26339,2726,32,32,272,304,850,882,26587,0,0,0,0
glues-characterselect-button-card-2x,26340,2727,64,64,1797,1861,1209,1273,26579,0,0,0,0
glues-characterselect-button-card-down-disabled-hover-2x,26341,2727,64,64,1929,1993,1209,1273,26576,0,0,0,0
glues-characterselect-button-card-pressed-2x,26342,2727,64,64,659,723,1357,1421,26577,0,0,0,0
glues-characterselect-button-card-up-disabled-hover-2x,26343,2727,64,64,659,723,1489,1553,26578,0,0,0,0
glues-characterselect-icon-arrowdown-2x,26344,2727,64,64,659,723,1555,1619,26583,0,0,0,0
glues-characterselect-icon-arrowdown-hover-2x,26345,2727,64,64,659,723,1621,1685,26580,0,0,0,0
glues-characterselect-icon-arrowdown-pressed-2x,26346,2727,64,64,659,723,1687,1751,26582,0,0,0,0
glues-characterselect-icon-arrowup-2x,26348,2727,64,64,659,723,1819,1883,26587,0,0,0,0
glues-characterselect-icon-arrowup-hover-2x,26349,2727,64,64,659,723,1885,1949,26584,0,0,0,0
glues-characterselect-icon-arrowup-pressed-2x,26350,2727,64,64,659,723,1951,2015,26586,0,0,0,0
glues-characterselect-card-fx-spreada,26371,2726,312,91,319,631,349,440,26602,0,0,0,0
glues-characterselect-card-fx-spreadb,26372,2726,312,91,633,945,349,440,26603,0,0,0,0
glues-characterselect-card-glow-fx,26373,2726,346,125,1,347,1,126,26604,0,0,0,0
glues-characterselect-icon-arrowdown-pressed-hover,26374,2726,32,32,964,996,537,569,26581,0,0,0,0
glues-characterselect-icon-arrowup-pressed-hover,26375,2726,32,32,272,304,952,984,26585,0,0,0,0
glues-characterselect-icon-fx-plus,26376,2726,125,125,1,126,635,760,26605,0,0,0,0
glues-characterselect-card-fx-spreada-2x,26378,2727,624,182,635,1259,691,873,26602,0,0,0,0
glues-characterselect-card-fx-spreadb-2x,26379,2727,624,182,1261,1885,691,873,26603,0,0,0,0
glues-characterselect-card-glow-fx-2x,26380,2727,692,250,1,693,1,251,26604,0,0,0,0
glues-characterselect-icon-arrowdown-pressed-hover-2x,26381,2727,64,64,659,723,1753,1817,26581,0,0,0,0
glues-characterselect-icon-arrowup-pressed-hover-2x,26382,2727,64,64,725,789,1291,1355,26585,0,0,0,0
glues-characterselect-icon-fx-plus-2x,26383,2727,250,250,1,251,1257,1507,26605,0,0,0,0
glues-characterselect-card-camp-bg-glow,26387,2726,54,54,936,990,576,630,26609,0,0,0,0
glues-characterselect-card-camp-bg-glow-2x,26388,2727,108,108,499,607,1291,1399,26609,0,0,0,0
plunderstorm-icon-key,26409,2683,108,96,1920,2028,1050,1146,26629,54,48,0,0
plunderstorm-waypoint-ring,26421,2683,52,52,1561,1613,1274,1326,26641,0,0,0,0
plunderstorm-nameplates-icon-ring,26432,2683,54,54,1505,1559,1274,1328,26648,36,36,0,0
plunderstorm-ui-hud-unitframe-player-portraiton-incombat-2x,26493,2683,384,142,1,385,1755,1897,26663,0,0,0,2
plunderstorm-ui-hud-unitframe-player-portraiton-incombat,26494,2683,192,71,1635,1827,1482,1553,26664,0,0,0,0
glues-characterselect-namebg,26597,2726,194,61,192,386,576,637,26739,0,0,0,0
glues-characterselect-iconshop-dis,26598,2726,24,24,984,1008,225,249,26740,0,0,0,0
glues-characterselect-iconshop-hover,26599,2726,24,24,166,190,915,939,26741,0,0,0,0
glues-characterselect-iconshop,26600,2726,24,24,958,982,225,249,26742,0,0,0,0
glues-characterselect-namebg-2x,26601,2727,388,122,381,769,1063,1185,26739,0,0,0,0
glues-characterselect-iconshop-2x,26602,2727,46,46,1959,2005,445,491,26742,0,0,0,0
glues-characterselect-iconshop-dis-2x,26603,2727,46,46,329,375,1809,1855,26740,0,0,0,0
glues-characterselect-iconshop-hover-2x,26604,2727,46,46,315,361,1991,2037,26741,0,0,0,0
lang-alert-dede,26760,2672,1014,44,1,1015,1,45,26884,0,0,0,0
lang-alert-encn,26761,2672,394,44,585,979,415,459,26885,0,0,0,0
lang-alert-engb,26762,2672,582,44,1,583,415,459,26886,0,0,0,0
lang-alert-entw,26763,2672,395,44,627,1022,323,367,26887,0,0,0,0
lang-alert-enus,26764,2672,582,44,1,583,461,505,26888,0,0,0,0
lang-alert-eses,26765,2672,624,44,1,625,323,367,26889,0,0,0,0
lang-alert-esmx,26766,2672,624,44,1,625,369,413,26890,0,0,0,0
lang-alert-frfr,26767,2672,749,44,1,750,185,229,26891,0,0,0,0
lang-alert-itit,26768,2672,699,44,1,700,231,275,26892,0,0,0,0
lang-alert-kokr,26769,2672,694,44,1,695,277,321,26893,0,0,0,0
lang-alert-ptbr,26770,2672,1002,44,1,1003,47,91,26894,0,0,0,0
lang-alert-ptpt,26771,2672,1002,44,1,1003,93,137,26895,0,0,0,0
lang-alert-ruru,26772,2672,783,44,1,784,139,183,26896,0,0,0,0
lang-alert-zhcn,26773,2672,394,44,585,979,461,505,26897,0,0,0,0
lang-alert-zhtw,26774,2672,395,44,627,1022,369,413,26898,0,0,0,0
lang-regions-dede,26775,2672,99,44,1,100,553,597,26899,45,22,0,0
lang-regions-encn,26776,2672,246,44,752,998,185,229,26900,123,22,0,0
lang-regions-engb,26777,2672,153,44,218,371,507,551,26901,76,22,0,0
lang-regions-entw,26778,2672,233,44,786,1019,139,183,26902,116,22,0,0
lang-regions-enus,26779,2672,90,44,926,1016,507,551,26903,45,22,0,0
lang-regions-eses,26780,2672,215,44,1,216,507,551,26904,107,22,0,0
lang-regions-esmx,26781,2672,304,44,702,1006,231,275,26905,152,22,0,0
lang-regions-frfr,26782,2672,105,44,501,606,507,551,26906,52,22,0,0
lang-regions-itit,26783,2672,90,44,102,192,553,597,26907,45,22,0,0
lang-regions-kokr,26784,2672,78,44,194,272,553,597,26908,39,22,0,0
lang-regions-ptbr,26785,2672,126,44,373,499,507,551,26909,63,22,0,0
lang-regions-ptpt,26786,2672,285,44,697,982,277,321,26910,142,22,0,0
lang-regions-ruru,26787,2672,102,44,822,924,507,551,26911,51,22,0,0
lang-regions-zhcn,26788,2672,105,44,608,713,507,551,26912,52,22,0,0
lang-regions-zhtw,26789,2672,105,44,715,820,507,551,26913,52,22,0,0
common-dropdown-classic-a-buttondown-2x,26839,2808,60,60,1,61,1,61,26946,0,0,0,0
common-dropdown-classic-a-buttondown-disabled-2x,26840,2808,60,60,57,117,125,185,26942,0,0,0,0
common-dropdown-classic-a-buttondown-hover-2x,26841,2808,60,60,229,289,1,61,26943,0,0,0,0
common-dropdown-classic-a-buttondown-pressed-2x,26842,2808,60,60,347,407,1,61,26944,0,0,0,0
common-dropdown-classic-a-buttondown-pressedhover-2x,26843,2808,60,60,57,117,187,247,26945,0,0,0,0
common-dropdown-classic-a-buttonup-2x,26844,2808,60,60,57,117,63,123,26951,0,0,0,0
common-dropdown-classic-a-buttonup-disabled-2x,26845,2808,60,60,57,117,311,371,26947,0,0,0,0
common-dropdown-classic-a-buttonup-hover-2x,26846,2808,60,60,57,117,373,433,26948,0,0,0,0
common-dropdown-classic-a-buttonup-pressed-2x,26847,2808,60,60,57,117,249,309,26949,0,0,0,0
common-dropdown-classic-a-buttonup-pressedhover-2x,26848,2808,60,60,57,117,435,495,26950,0,0,0,0
common-dropdown-classic-b-button-2x,26849,2808,164,56,63,227,1,57,26956,0,0,0,0
common-dropdown-classic-b-button-disabled-2x,26850,2808,164,56,285,449,63,119,26952,0,0,0,0
common-dropdown-classic-b-button-hover-2x,26851,2808,164,56,119,283,121,177,26953,0,0,0,0
common-dropdown-classic-b-button-pressed-2x,26852,2808,164,56,119,283,63,119,26954,0,0,0,0
common-dropdown-classic-b-button-pressedhover-2x,26853,2808,164,56,331,495,121,177,26955,0,0,0,0
common-dropdown-classic-bg-2x,26854,2808,240,240,119,359,265,505,26957,0,0,0,0
common-dropdown-classic-textholder-2x,26855,2808,318,84,119,437,179,263,26958,0,0,0,0
common-dropdown-classic-a-buttondown-disabled-small-2x,26870,2808,54,54,291,345,1,55,26976,0,0,0,0
common-dropdown-classic-a-buttondown-hover-small-2x,26871,2808,54,54,409,463,1,55,26977,0,0,0,0
common-dropdown-classic-a-buttondown-pressed-small-2x,26872,2808,54,54,1,55,119,173,26978,0,0,0,0
common-dropdown-classic-a-buttondown-pressedhover-small-2x,26873,2808,54,54,1,55,175,229,26979,0,0,0,0
common-dropdown-classic-a-buttondown-small-2x,26874,2808,54,54,1,55,63,117,26980,0,0,0,0
common-dropdown-classic-a-buttonup-disabled-small-2x,26875,2808,54,54,1,55,231,285,26981,0,0,0,0
common-dropdown-classic-a-buttonup-hover-small-2x,26876,2808,54,54,1,55,287,341,26982,0,0,0,0
common-dropdown-classic-a-buttonup-pressed-small-2x,26877,2808,54,54,1,55,455,509,26983,0,0,0,0
common-dropdown-classic-a-buttonup-pressedhover-small-2x,26878,2808,54,54,1,55,343,397,26984,0,0,0,0
common-dropdown-classic-a-buttonup-small-2x,26879,2808,54,54,1,55,399,453,26985,0,0,0,0
common-dropdown-icon-checkmark-yellow-classic-2x,26880,2808,52,44,451,503,63,107,26986,0,0,0,0
common-dropdown-icon-radialtick-yellow-classic-2x,26881,2808,44,44,465,509,1,45,26987,0,0,0,0
common-dropdown-tickradial-classic-2x,26882,2808,44,44,285,329,121,165,26988,0,0,0,0
common-dropdown-ticksquare-classic-2x,26883,2808,40,40,439,479,179,219,26989,0,0,0,0
common-dropdown-classic-textholder-small-2x,26887,2808,120,72,361,481,265,337,26992,0,0,0,0
common-dropdown-classic-bg-b-2x,26890,2808,96,96,361,457,401,497,26995,0,0,0,0
common-dropdown-classic-darkbg-2x,26891,2808,60,60,361,421,339,399,26994,0,0,0,0
common-dropdown-classic-a-buttondown-disabled,26962,2807,23,22,149,172,72,94,26942,0,0,0,0
common-dropdown-classic-a-buttondown-hover,26963,2807,23,22,174,197,72,94,26943,0,0,0,0
common-dropdown-classic-a-buttondown-pressed,26964,2807,23,22,199,222,72,94,26944,0,0,0,0
common-dropdown-classic-a-buttondown-pressedhover,26965,2807,23,22,224,247,72,94,26945,0,0,0,0
common-dropdown-classic-a-buttondown,26966,2807,23,22,231,254,44,66,26946,0,0,0,0
common-dropdown-classic-b-bg,26967,2807,48,48,99,147,44,92,26993,0,0,0,0
common-dropdown-classic-b-button-disabled,26968,2807,80,26,1,81,99,125,26952,0,0,0,0
common-dropdown-classic-b-button-hover,26969,2807,80,26,83,163,99,125,26953,0,0,0,0
common-dropdown-classic-b-button-pressed,26970,2807,80,26,165,245,99,125,26954,0,0,0,0
common-dropdown-classic-b-button-pressedhover,26971,2807,80,26,1,81,127,153,26955,0,0,0,0
common-dropdown-classic-b-button,26972,2807,80,26,149,229,44,70,26956,0,0,0,0
common-dropdown-classic-bg,26973,2807,96,96,1,97,1,97,26957,0,0,0,0
common-dropdown-classic-textholder,26975,2807,110,41,99,209,1,42,26958,0,0,0,0
common-dropdown-icon-checkmark-yellow-classic,26976,2807,16,16,83,99,127,143,26986,0,0,0,0
common-dropdown-icon-radialtick-yellow-classic,26977,2807,16,16,101,117,127,143,26987,0,0,0,0
common-dropdown-tickradial-classic,26978,2807,16,16,119,135,127,143,26988,0,0,0,0
common-dropdown-ticksquare-classic,26979,2807,16,16,137,153,127,143,26989,0,0,0,0
glues-characterselect-icon-notify-bg-2x,27139,2727,80,80,1071,1151,1209,1289,27171,0,0,0,0
glues-characterselect-icon-notify-bg-hover-2x,27140,2727,80,80,1153,1233,1209,1289,27172,0,0,0,0
glues-characterselect-icon-notify-inprogress-2x,27141,2727,80,80,1235,1315,1209,1289,27173,0,0,0,0
glues-characterselect-icon-notify-inprogress-hover-2x,27142,2727,80,80,1317,1397,1209,1289,27174,0,0,0,0
glues-characterselect-icon-notify-lock-2x,27143,2727,80,80,1399,1479,1209,1289,27175,0,0,0,0
glues-characterselect-icon-notify-lock-hover-2x,27144,2727,80,80,1481,1561,1209,1289,27176,0,0,0,0
glues-characterselect-icon-notify-mail-2x,27145,2727,80,80,1563,1643,1209,1289,27177,0,0,0,0
glues-characterselect-icon-notify-mail-hover-2x,27146,2727,80,80,1645,1725,1209,1289,27178,0,0,0,0
glues-characterselect-icon-restorecharacter-2x,27147,2727,116,116,381,497,1763,1879,27179,0,0,0,0
glues-characterselect-icon-restorecharacter-hover-2x,27148,2727,116,116,381,497,1881,1997,27180,0,0,0,0
glues-characterselect-icon-restorecharacter-pointer-2x,27149,2727,68,172,1979,2047,253,425,27181,0,0,0,0
glues-characterselect-icon-notify-bg-hover,27150,2726,40,40,818,858,639,679,27172,0,0,0,0
glues-characterselect-icon-notify-bg,27151,2726,40,40,776,816,639,679,27171,0,0,0,0
glues-characterselect-icon-notify-inprogress-hover,27152,2726,40,40,902,942,639,679,27174,0,0,0,0
glues-characterselect-icon-notify-inprogress,27153,2726,40,40,860,900,639,679,27173,0,0,0,0
glues-characterselect-icon-notify-lock-hover,27154,2726,40,40,228,268,931,971,27176,0,0,0,0
glues-characterselect-icon-notify-lock,27155,2726,40,40,944,984,639,679,27175,0,0,0,0
glues-characterselect-icon-notify-mail-hover,27156,2726,40,40,272,312,808,848,27178,0,0,0,0
glues-characterselect-icon-notify-mail,27157,2726,40,40,228,268,973,1013,27177,0,0,0,0
glues-characterselect-icon-restorecharacter-hover,27158,2726,58,58,876,934,576,634,27180,0,0,0,0
glues-characterselect-icon-restorecharacter-pointer,27159,2726,34,86,192,226,931,1017,27181,0,0,0,0
glues-characterselect-icon-restorecharacter,27160,2726,58,58,816,874,576,634,27179,0,0,0,0
shop-card-full-gametimebundle-90day,27428,2865,568,463,1,569,1,464,27338,0,0,0,0
glues-characterselect-button-collapseexpand-disabled,27435,2726,34,34,983,1017,409,443,27345,0,0,0,0
glues-characterselect-icon-minus-disabled,27436,2726,31,31,317,348,725,756,27346,0,0,0,0
glues-characterselect-icon-plus-disabled,27437,2726,31,31,317,348,857,888,27347,0,0,0,0
glues-characterselect-button-collapseexpand-disabled-2x,27438,2727,68,68,1973,2041,621,689,27345,0,0,0,0
glues-characterselect-icon-minus-disabled-2x,27439,2727,62,62,725,787,1487,1549,27346,0,0,0,0
glues-characterselect-icon-plus-disabled-2x,27440,2727,62,62,725,787,1743,1805,27347,0,0,0,0
photosensitivitywarning-questbang-icon,27442,2872,64,72,1,65,147,219,27349,0,0,0,0
photosensitivitywarning-vignette,27443,2872,256,144,1,257,1,145,27350,0,0,0,0
photosensitivitywarning-parchment-background,27463,2876,512,512,0,512,0,512,27348,0,0,6,0
glues-characterselect-tophud-bg-divider-dis,27524,2726,2,44,1021,1023,252,296,27391,0,0,0,0
glues-characterselect-tophud-left-bg,27525,2726,212,51,388,600,576,627,27392,0,0,0,0
glues-characterselect-tophud-left-dis-bg,27526,2726,212,51,602,814,576,627,27393,0,0,0,0
glues-characterselect-tophud-middle-bg,27527,2726,30,51,993,1023,128,179,27394,0,0,0,0
glues-characterselect-tophud-middle-dis-bg,27528,2726,30,51,992,1022,576,627,27395,0,0,0,0
glues-characterselect-tophud-right-bg,27529,2726,212,51,192,404,639,690,27396,0,0,0,0
glues-characterselect-tophud-right-dis-bg,27530,2726,212,51,406,618,639,690,27397,0,0,0,0
glues-characterselect-tophud-bg-divider-dis-2x,27531,2727,4,88,2039,2043,91,179,27391,0,0,0,0
glues-characterselect-tophud-left-bg-2x,27532,2727,424,102,771,1195,1063,1165,27392,0,0,0,0
glues-characterselect-tophud-left-dis-bg-2x,27533,2727,424,102,1197,1621,1063,1165,27393,0,0,0,0
glues-characterselect-tophud-middle-bg-2x,27534,2727,60,102,315,375,1887,1989,27394,0,0,0,0
glues-characterselect-tophud-middle-dis-bg-2x,27535,2727,60,102,499,559,1911,2013,27395,0,0,0,0
glues-characterselect-tophud-right-bg-2x,27536,2727,424,102,1623,2047,1063,1165,27396,0,0,0,0
glues-characterselect-tophud-right-dis-bg-2x,27537,2727,424,102,381,805,1187,1289,27397,0,0,0,0
glues-characterselect-listrealm-bg-2x,27610,2727,562,46,1345,1907,445,491,27457,0,0,0,0
glues-characterselect-listrealm-bg,27618,2726,281,23,675,956,225,248,27457,0,0,0,0
plunderstorm-pickup-arrow,28657,2683,42,74,660,702,1918,1992,28330,0,0,0,0
plunderstorm-pickup-bg,28658,2683,424,90,1401,1825,561,651,28331,0,0,0,0
plunderstorm-pickup-mouseclick-left,28659,2683,82,92,1951,2033,1,93,28332,0,0,0,0
plunderstorm-pickup-mouseclick-right,28660,2683,82,92,1951,2033,95,187,28333,0,0,0,0
glues-characterselect-button-collapseexpand-down-small-disabled,28731,2726,29,29,993,1022,181,210,28374,0,0,0,0
glues-characterselect-button-collapseexpand-small-hover,28732,2726,29,29,317,346,987,1016,28375,0,0,0,0
glues-characterselect-button-collapseexpand-small-pressed,28733,2726,29,29,350,379,692,721,28376,0,0,0,0
glues-characterselect-button-collapseexpand-small,28734,2726,29,29,317,346,956,985,28377,0,0,0,0
glues-characterselect-button-collapseexpand-up-small-disabled,28735,2726,29,29,350,379,723,752,28378,0,0,0,0
glues-characterselect-icon-arrowdown-small-hover,28736,2726,29,29,350,379,785,814,28379,0,0,0,0
glues-characterselect-icon-arrowdown-small-pressed,28737,2726,29,29,350,379,816,845,28380,0,0,0,0
glues-characterselect-icon-arrowdown-small,28738,2726,29,29,350,379,754,783,28381,0,0,0,0
glues-characterselect-icon-arrowup-small-hover,28739,2726,29,29,350,379,878,907,28382,0,0,0,0
glues-characterselect-icon-arrowup-small-pressed,28740,2726,29,29,350,379,909,938,28383,0,0,0,0
glues-characterselect-icon-arrowup-small,28741,2726,29,29,350,379,847,876,28384,0,0,0,0
glues-characterselect-button-collapseexpand-down-small-disabled-2x,28742,2727,58,58,1987,2045,987,1045,28374,0,0,0,0
glues-characterselect-button-collapseexpand-small-2x,28743,2727,58,58,725,783,1935,1993,28377,0,0,0,0
glues-characterselect-button-collapseexpand-small-hover-2x,28744,2727,58,58,791,849,1291,1349,28375,0,0,0,0
glues-characterselect-button-collapseexpand-small-pressed-2x,28745,2727,58,58,791,849,1351,1409,28376,0,0,0,0
glues-characterselect-button-collapseexpand-up-small-disabled-2x,28746,2727,58,58,791,849,1411,1469,28378,0,0,0,0
glues-characterselect-icon-arrowdown-small-2x,28747,2727,58,58,791,849,1471,1529,28381,0,0,0,0
glues-characterselect-icon-arrowdown-small-hover-2x,28748,2727,58,58,791,849,1531,1589,28379,0,0,0,0
glues-characterselect-icon-arrowdown-small-pressed-2x,28749,2727,58,58,791,849,1591,1649,28380,0,0,0,0
glues-characterselect-icon-arrowup-small-2x,28750,2727,58,58,791,849,1651,1709,28384,0,0,0,0
glues-characterselect-icon-arrowup-small-hover-2x,28751,2727,58,58,791,849,1711,1769,28382,0,0,0,0
glues-characterselect-icon-arrowup-small-pressed-2x,28752,2727,58,58,791,849,1771,1829,28383,0,0,0,0
glues-characterselect-icon-appearancechange-hover,28759,2726,58,58,128,186,635,693,28387,0,0,0,0
glues-characterselect-icon-appearancechange,28760,2726,58,58,947,1005,349,407,28388,0,0,0,0
glues-characterselect-icon-factionchange-hover,28761,2726,58,58,1,59,955,1013,28389,0,0,0,0
glues-characterselect-icon-factionchange,28762,2726,58,58,128,186,695,753,28390,0,0,0,0
glues-characterselect-icon-racechange-hover,28763,2726,58,58,121,179,955,1013,28391,0,0,0,0
glues-characterselect-icon-racechange,28764,2726,58,58,61,119,955,1013,28392,0,0,0,0
glues-characterselect-icon-appearancechange-2x,28765,2727,116,116,253,369,1257,1373,28388,0,0,0,0
glues-characterselect-icon-appearancechange-hover-2x,28766,2727,116,116,253,369,1375,1491,28387,0,0,0,0
glues-characterselect-icon-factionchange-2x,28767,2727,116,116,381,497,1291,1407,28390,0,0,0,0
glues-characterselect-icon-factionchange-hover-2x,28768,2727,116,116,381,497,1409,1525,28389,0,0,0,0
glues-characterselect-icon-racechange-2x,28769,2727,116,116,381,497,1527,1643,28392,0,0,0,0
glues-characterselect-icon-racechange-hover-2x,28770,2727,116,116,381,497,1645,1761,28391,0,0,0,0
newplayerchat-chaticon-guide,29001,924,30,26,63,93,66,92,28576,15,13,0,0
newplayerchat-chaticon-newcomer,29002,924,30,30,37,67,1,31,28577,15,15,0,0
groupfinder-background-classic,29003,236,324,282,1,325,437,719,28578,0,0,0,0
plunderstorm-icon-kills,29189,2683,65,65,323,388,1505,1570,28901,0,0,0,0
plunderstorm-icon-plundercoins,29190,2683,65,65,323,388,1572,1637,28902,0,0,0,0
plunderstorm-icon-trophy,29191,2683,65,65,323,388,1639,1704,28903,0,0,0,0
plunderstorm-toast-bg-matchcomplete,29192,2683,796,376,1,797,672,1048,28904,0,0,0,0
plunderstorm-toast-bg-queue,29193,2683,796,359,799,1595,672,1031,28905,0,0,0,0
plunderstorm-toast-bg-statdetails,29194,2683,796,669,1,797,1,670,28906,0,0,0,0
plunderstorm-toast-bottomdecal-line,29195,2683,638,2,799,1437,1037,1039,28907,0,0,0,0
plunderstorm-toast-bottomdecal,29196,2683,73,29,1919,1992,998,1027,28908,0,0,0,0
plunderstorm-toast-divider,29197,2683,503,1,799,1302,1041,1042,28909,0,0,0,0
plunderstorm-toast-swords-line,29198,2683,662,2,799,1461,1033,1035,28910,0,0,0,0
plunderstorm-toast-swords,29199,2683,234,105,1,235,1899,2004,28911,0,0,0,0
plunderstorm-icon-plundercoins-big,29319,2683,70,70,323,393,1433,1503,29015,0,0,0,0
plunderstorm-pvpqueue-background,29320,2683,392,381,1,393,1050,1431,29016,0,0,0,0
plunderstorm-pvpqueue-catergory-icon,29321,2683,104,104,1919,2023,892,996,29017,0,0,0,0
plunderstorm-pvpqueue-sidebar-background,29322,2683,160,375,717,877,1596,1971,29018,0,0,0,0
groupfinder-icon-role-micro-dps,29351,236,16,16,541,557,78,94,29044,0,0,0,0
groupfinder-icon-role-micro-heal,29352,236,16,16,523,539,78,94,29045,0,0,0,0
groupfinder-icon-role-micro-tank,29353,236,16,16,580,596,78,94,29046,0,0,0,0
common-dropdown-icon-checkmark-yellow-classic-2,29745,2807,32,32,211,243,1,33,29314,0,0,0,0
glues-gamemode-bg,29795,2726,77,77,192,269,852,929,29335,0,0,0,0
glues-gamemode-glw-bottom,29796,2726,189,96,1,190,537,633,29336,0,0,0,0
glues-gamemode-glw-top,29797,2726,151,53,1,152,860,913,29337,0,0,0,0
glues-gamemode-selectarrow,29798,2726,50,50,957,1007,446,496,29338,0,0,0,0
glues-gamemode-bg-2x,29799,2727,154,154,159,313,1887,2041,29335,0,0,0,0
glues-gamemode-glw-bottom-2x,29800,2727,378,192,1,379,1063,1255,29336,0,0,0,0
glues-gamemode-glw-top-2x,29801,2727,302,106,1,303,1701,1807,29337,0,0,0,0
glues-gamemode-selectarrow-2x,29802,2727,100,100,1907,2007,883,983,29338,0,0,0,0
glues-gamemode-txtbg,29887,2726,163,38,1,164,915,953,29409,0,0,0,0
glues-gamemode-txtbg-2x,29888,2727,326,76,1,327,1809,1885,29409,0,0,0,0
glues-characterselect-icon-arrowdown-disabled-2x,29938,2727,64,64,725,789,1357,1421,29461,0,0,0,0
glues-characterselect-icon-arrowdown-disabled,29939,2726,32,32,272,304,986,1018,29461,0,0,0,0
plunderstorm-new-dot-lg,29941,2683,40,40,1359,1399,527,567,29463,0,0,0,0
plunderstorm-new-dot-sm,29942,2683,34,34,1359,1393,569,603,29464,0,0,0,0
ui-diamonddialogbox-classicborder,31530,3195,70,70,1,71,1,71,30481,0,0,0,0
ui-diamonddialogbox-border,31531,3196,70,70,1,71,1,71,30482,0,0,0,0
ui-dialogbox-background-dark,31560,3201,64,64,0,64,0,64,30506,0,0,6,0
ui-diamonddialogbox-border-2x,31568,3204,140,140,1,141,1,141,30482,0,0,0,0
